--------------------------------------------------------------------------------------------------------------------------------------------------------------------------------------------------------
--------------------------------------------------------------------------------------------------------------------------------------------------------------------------------------------------------
--------------------------------------------------------------------------------------------------------------------------------------------------------------------------------------------------------
--------------------------------------------------------------------------------------------------------------------------------------------------------------------------------------------------------
-------------------------------------------------------Xo-----------------------------------------------------------------------------------------------------------------------------------------------
--------------------------------------------------------X-----------------------------------------------------------------------------------------------------------------------------------------------
--------------------------------------------------------------------------------------------------------------------------------------------------------------------------------------------------------
---------------------------XX-------------------------------------------------------------------------------------S-------------------------------------------------------------------------------------
-----------------------------------------------------------------------------------------------------------S-----S------------E-------------------------------------------------------------------------
-----------------------------------------------------------------------------------------------------------E---X-------------->-------------------------------------------------------------------------
-----------------------E------------------------------------------------------------------------------------------------------]----------------------------------------S---------------------------E----
----------o------------>--X--------SS---------E-----------X-------S---------------------------------------<E----------------E<X-----------------------------------------SS-----E------------------<>----
-------------E--X-----<]--X------------X-----<>-----------XX----------------------------------------------[>---------E-------[---------E--------------------->----E-----------<>-------------E----[]----
------------<>--------[]--X------------X-----[]-----------XX-----X----------------------------------------[]--<>----<>-------[--------<>--------------------<>----------------[]------------<>----[]----
---------E--[]--------[]--X-----------XX-----[]-----------XX-----XX--E-E------------------X---------------[]--[]---E[]-------[---E----[]---------E----------[]-----E----------[]------------[]----[]----
XXXXXXXXXXXXXX-----0XXXXXXXXXXXXXXXXXXX0XXXXXXXXXXXXXXX---X0XXXXXXXXXXXXXXXXXXX0XXXXXXXXXXXXXXXXXXX0XXXXXXXXXXXXXXXXXXX0XXXXXXXXXXXXXXXXXXX0XXXXXXXXXXXXXXXXXXX0XXXXXXXXXXXXXXXXXXX0XX-XXXXXXXXXXXXX--XX