000000000000000000000000000000000000000000000000000000000000000000000000000000000000000000000000000000000000000000000000000000000000------------------------------------------------------------00000000
000000000000000000000000000000000000000000000000000000000000000000000000000000000000000000000000000000000000000000000000000000000000------------------------------------------------------------00000000
000000000000000000000000000000000000000000000000000000000000000000000000000000000000000000000000000000000000000000000000000000000000------------------------------------------------------------00000000
000000000000000000000000000000000000000000000000000000000000000000000000000000000000000000000000000000000000000000000000000000000000------------------------------------------------------------00000000
000000000000000000000000000000000000000000000000000000000000000000000000000000000000000000000000000000000000000000000000000000000000------------------------------------------------------------00000000
000000000000000000000000000000000000000000000000000000000000000000000000000000000000000000000000000000000000000000000000000000000000------------------------------------------------------------00000000
000000000000000000000000000000000000000000000000000000000000000000000000000000000000000000000000000000000000000000000000000000000000------------------------------------------------------------00000000
000000000000000000000000000000000000000000000000000000000000000000000000000000000000000000000000000000000000000000000000000000000000------------------------------------------------------------00000000
000000000000000000000000000000000000000000000000000000000000000000000000000000000000000000000000000000000000000000000000000000000000------------------------------------------------------------00000000
000000000000000000000000000000000000000000000000000000000000000000000000000000000000000000000000000000000000000000000000000000000000-----------------------------------------------------X-X-XXX00000000
000000000000000000000000000000000000000000000000000000000000000000000000000000000000000000000000000000000000000000000000000000000000--------------------------------------------------->--X-X---00000000
000000000000000000000000000000000000000000000000000000000000000000000000000000000000000000000000000000000000000000000000000000000000--------------------------------------------------<>--------00000000
000000000000000000000000000000000000000000000000000000000000000000000000000000000000000000000000000000000000000000000000000000000000--------------------------------------------------[]--------00000000
000000000000000000000000000000000000000000000000000000000000000000000000000000000000000000000000000000000000000000000000000000000000-------------X-X----------------------------------[]--------00000000
000000000000000000000000000000000000000000000000000000000000000000000000000000000000000000000000000000000000000000000000000000000000---E----------X----------X-------------------o----[]-------000000000
00000000000000000000000000000000000000000000000000000000000000000000000000000000000000000000000000000000000000000000MMMMMMMMMMMMMMM0XXXXXXXXXXX-------X0XXXX----X--XXXXXXXX0XXXXXX-XX-XX-------000000000
00000000000000000000000000000000000000000000000000000000000000000000000000000000000000000000000000000000000000000000----------------0000000000000000000000000000000000000000000000X000000000000000000000
00000000000000000000000000000000000000000000000000000000000000000000000000000000000000000000000000000000000000000000------------####00000000000000000000000000000000000000000000000000000000000000000000
00000000000000000000000000000000000000000000000000000000000000000000000000000000000000000000000000000000000000000000----------------00000000000000000000000000000000000000000000000000000000000000000000
000000000000000000000000000000000000000000000000000000000000000000000000000000000000000000000000-----------------------------TTT##--00000000000000000000000000000000000000000000000000000000000000000000
000000000000000000000000000000000000000000000000000000000000000000000000000000000000000000000000------------------------------------00000000000000000000000000000000000000000000000000000000000000000000
000000000000000000000000000000000000000000000000000000000000000000000000000000000000000000000000--------------------MMMMMMMMMMMMMMMM00000000000000000000000000000000000000000000000000000000000000000000
000000000000000000000000000000000000000000000000000000000000000000000000000000000000000000000000------------------------------------00000000000000000000000000000000000000000000000000000000000000000000
000000000000000000000000000000000000000000000000000000000000000000000000000000000000000000000000------------------------------------00000000000000000000000000000000000000000000000000000000000000000000
000000000000000000000000000000000000000000000000000000000000000000000000000000000000000000000000--------------------#MMMMMMMMMMMMMM#00000000000000000000000000000000000000000000000000000000000000000000
000000000000000000000000000000000000000000000000000000000000000000000000000000000000000000000000--------------------#T-------------#00000000000000000000000000000000000000000000000000000000000000000000
000000000000000000000000000000000000000000000000000000000000000000000000000000000000000000000000--------------------#--------------#00000000000000000000000000000000000000000000000000000000000000000000
000000000000000000000000000000000000000000000000000000000000000000000000000000000000000000000000--------------------#########------#00000000000000000000000000000000000000000000000000000000000000000000
000000000000000000000000000000000000000000000000000000000000000000000000000000000000000000000000-----------------------------------#00000000000000000000000000000000000000000000000000000000000000000000
000000000000000000000000000000000000000000000000000000000000000000000000000000000000000000000000-------X-------------#-------------#00000000000000000000000000000000000000000000000000000000000000000000
000000000000000000000000000000000000000000000000000000000000000000000000000000000000000000000000---X----------------##-----------###00000000000000000000000000000000000000000000000000000000000000000000
000000000000000000000000000000000000000000000000000000000000000000000000000000000000000000000000---X----------------##----------####00000000000000000000000000000000000000000000000000000000000000000000
000000000000000000000000000000000000000000000000000000000000000000000000000000000000000000000000---X----------------TTTT############00000000000000000000000000000000000000000000000000000000000000000000
000000000000000000000000000000000000000000000000000000000000000000000000000000000000000000000000---X------------------TTTTTTTT-----#00000000000000000000000000000000000000000000000000000000000000000000
00000000000000000000000000000000000000000000000000000000000000000000000000000000---------------0XXXXXXX-----XXXXXXX0---------TTTTTTT00000000000000000000000000000000000000000000000000000000000000000000
00000000000000000000000000000000000000000000000000000000000000000000000000000000----------------00000000000000000000000000000000000000000000000000000000000000000000000000000000000000000000000000000000
00000000000000000000000000000000000000000000000000000000000000000000000000000000------------TTTT00000000000000000000000000000000000000000000000000000000000000000000000000000000000000000000000000000000
00000000000000000000000000000000000000000000000000000000000000000000000000000000-----TTTT-TTTT--00000000000000000000000000000000000000000000000000000000000000000000000000000000000000000000000000000000
------------------------------------------------------------------------------------------------00000000000000000000000000000000000000000000000000000000000000000000000000000000000000000000000000000000
------------------------------------------------------------------------------------------------00000000000000000000000000000000000000000000000000000000000000000000000000000000000000000000000000000000
--------------------------------------------------------------------------------#------------###00000000000000000000000000000000000000000000000000000000000000000000000000000000000000000000000000000000
----------------------------------------------------------------------------------##------------00000000000000000000000000000000000000000000000000000000000000000000000000000000000000000000000000000000
-----------------------------------------------------------------------------------#####--------00000000000000000000000000000000000000000000000000000000000000000000000000000000000000000000000000000000
-----------------------------------------------------------------------------------####---------00000000000000000000000000000000000000000000000000000000000000000000000000000000000000000000000000000000
-----------------------------------------------------------X--------------------####----------##00000000000000000000000000000000000000000000000000000000000000000000000000000000000000000000000000000000
-----------------S--------------------------------------------------------------####-----------#00000000000000000000000000000000000000000000000000000000000000000000000000000000000000000000000000000000
--------------------------------------------------------------------------------####-----------#00000000000000000000000000000000000000000000000000000000000000000000000000000000000000000000000000000000
--------------------------------------------------------------------------------##-------------#00000000000000000000000000000000000000000000000000000000000000000000000000000000000000000000000000000000
---------------E------------------------------------------<E----X--------------Q##--------TTTTTT00000000000000000000000000000000000000000000000000000000000000000000000000000000000000000000000000000000
--------------<>------------------------------------------[>--------------------#D-------------#00000000000000000000000000000000000000000000000000000000000000000000000000000000000000000000000000000000
--------------[]------------------------------------------[]------E---E---------#D-------------#00000000000000000000000000000000000000000000000000000000000000000000000000000000000000000000000000000000
--------------[]------------------------------------------[]-----<>--<>---------TTTT########---#00000000000000000000000000000000000000000000000000000000000000000000000000000000000000000000000000000000
-----E-E------[]---------E-X----------E---------EE--E-----[]--E--[]--[]-----------TTTTTTTT-----#00000000000000000000000000000000000000000000000000000000000000000000000000000000000000000000000000000000
XXXXXXXXXXXXXXXX-XX0XXXXXXXXXXXXXXXXXXX0XXXXXXXXXXXXXXXXXXX0XXXXXXXXXXXXXXXXXXX0---------TTTTTTT00000000000000000000000000000000000000000000000000000000000000000000000000000000000000000000000000000000