00000000000000000000000000000000000000000000000000000000000000000000000000000000000000000000XXXX----------XX
00000000000000000000000000000000000000000000000000000000000000000000000000000000000000000000XXXX----------XX
00000000000000000000000000000000000000000000000000000000000000000000000000000000000000000000XXXX----------XX
00000000000000000000000000000000000000000000000000000000000000000000000000000000000000000000XXXX----------X-
00000000000000000000000000000000000000000000000000000000000000000000000000000000000000000000XXXX------------
00000000000000000000000000000000000000000000000000000000000000000000000000000000000000000000XXXX------------
00000000000000000000000000000000000000000000000000000000000000000000000000000000000000000000XXXXXXXX--------
00000000000000000000000000000000000000000000000000000000000000000000000000000000000000000000X---XXXXXXXX----
00000000000000000000000000000000000000000000000000000000000000000000000000000000000000000000X-------XXXXXXXX
00000000000000000000000000000000000000000000000000000000000000000000000000000000000000000000X-----------XXXX
00000000000000000000000000000000000000000000000000000000000000000000000000000000000000000000X-------------XX
00000000000000000000000000000000000000000000000000000000000000000000000000000000000000000000X-------------XX
00000000000000000000000000000000000000000000000000000000000000000000000000000000000000000000XXXXXXXX-------X
00000000000000000000000000000000000000000000000000000000000000000000000000000000000000000000XX-------------X
00000000000000000000000000000000000000000000000000000000000000000000000000000000000000000000XX--------TTTTTT
00000000000000000000000000000000000000000000000000000000000000000000000000000000000000000000XD-------------X
00000000000000000000000000000000000000000000000000000000000000000000000000000000000000000000XD-------------X
00000000000000000000000000000000000000000000000000000000000000000000000000000000000000000000TTTTXXXXXXXX--DX
00000000000000000000000000000000000000000000000000000000000000000000000000000000000000000000--TTTTTTTT-----X
00000000000000000000000000000000000000000000000000000000000000000000000000000000000000000000---------TTTTTTT
00000000000000000000000000000000000000000000000000000000000000000000000000000000000000000000XXXXEEEX--------
00000000000000000000000000000000000000000000000000000000000000000000000000000000000000000000XXXXXX-XX-------
00000000000000000000000000000000000000000000000000000000000000000000000000000000000000000000----------------
00000000000000000000000000000000000000000000000000000000000000000000000000000000000000000000----------------
000000000000000000000000000000000000000000000000000000000000000000000000-----------------------------TTT----
000000000000000000000000000000000000000000000000000000000000000000000000------------------------------------
000000000000000000000000000000000000000000000000000000000000000000000000--------------------X-----------TTTT
000000000000000000000000000000000000000000000000000000000000000000000000--------------------X--------------X
000000000000000000000000000000000000000000000000000000000000000000000000--------------------X--------------X
000000000000000000000000000000000000000000000000000000000000000000000000--------------------X--------------X
000000000000000000000000000000000000000000000000000000000000000000000000--------------------XXXXXXXXXX-----X
000000000000000000000000000000000000000000000000000000000000000000000000----------------XX--XXXX-----------X
000000000000000000000000000000000000000000000000000000000000000000000000----------------XX--XXX------------X
000000000000000000000000000000000000000000000000000000000000000000000000---------------XXX--XXXXXX---------X
000000000000000000000000000000000000000000000000000000000000000000000000---------------XXX--XXXXXXXXXXXX---X
000000000000000000000000000000000000000000000000000000000000000000000000-----XX--------XXX--XD-------------X
000000000000000000000000000000000000000000000000000000000000000000000000----XXX-------XXXX--XD-------------X
000000000000000000000000000000000000000000000000000000000000000000000000---XXXXX------XXXX--TTTTXXXXXXXX---X
000000000000000000000000000000000000000000000000000000000000000000000000--XXXX-XX-----XXXX----TTTTTTTT-----X
00000000000000000000000000000000000000000000000000000000----------------XXXXXX-XXXXXXXXXXXXX---------TTTTTTT
00000000000000000000000000000000000000000000000000000000XXXX------------000000000000000000000000000000000000
00000000000000000000000000000000000000000000000000000000XXXX------------000000000000000000000000000000000000
00000000000000000000000000000000000000000000000000000000XXXXEEEX--------000000000000000000000000000000000000
00000000000000000000000000000000000000000000000000000000XXXXXX-XX-------000000000000000000000000000000000000
00000000000000000000000000000000000000000000000000000000----------------000000000000000000000000000000000000
00000000000000000000000000000000000000000000000000000000----------------000000000000000000000000000000000000
00000000000000000000000000000000000000000000000000000000---------TTT----000000000000000000000000000000000000
00000000000000000000000000000000000000000000000000000000----------------000000000000000000000000000000000000
00000000000000000000000000000000000000000000000000000000X-----------TTTT000000000000000000000000000000000000
00000000000000000000000000000000000000000000000000000000X--------------X000000000000000000000000000000000000
00000000000000000000000000000000000000000000000000000000X--------------X000000000000000000000000000000000000
00000000000000000000000000000000000000000000000000000000XXXXXXXXX------X000000000000000000000000000000000000
00000000000000000000000000000000000000000000000000000000XX-------------X000000000000000000000000000000000000
00000000000000000000000000000000000000000000000000000000XX--------TTTTTT000000000000000000000000000000000000
00000000000000000000000000000000000000000000000000000000XD-------------X000000000000000000000000000000000000
00000000000000000000000000000000000000000000000000000000XD-------------X000000000000000000000000000000000000
00000000000000000000000000000000000000000000000000000000TTTTXXXXXXXX---X000000000000000000000000000000000000
00000000000000000000000000000000000000000000000000000000--TTTTTTTT-----X000000000000000000000000000000000000
00000000000000000000000000000000000000000000000000000000---------TTTTTTT000000000000000000000000000000000000
00000000000000000000000000000000000000000000000000000000----------------000000000000000000000000000000000000
00000000000000000000000000000000000000000000000000000000-------------TT-000000000000000000000000000000000000
00000000000000000000000000000000000000000000000000000000XXXXXXX---------000000000000000000000000000000000000
00000000000000000000000000000000000000000000000000000000----------------000000000000000000000000000000000000
00000000000000000000000000000000000000000000000000000000-----TTTT-------000000000000000000000000000000000000
00000000000000000000000000000000000000000000000000000000----------------000000000000000000000000000000000000
00000000000000000000000000000000000000000000000000000000----------------000000000000000000000000000000000000
00000000000000000000000000000000000000000000000000000000---------TTT----000000000000000000000000000000000000
00000000000000000000000000000000000000000000000000000000----------------000000000000000000000000000000000000
00000000000000000000000000000000000000000000000000000000X-----------TTTT000000000000000000000000000000000000
00000000000000000000000000000000000000000000000000000000X--------------X000000000000000000000000000000000000
00000000000000000000000000000000000000000000000000000000X--------------X000000000000000000000000000000000000
00000000000000000000000000000000000000000000000000000000XXXXXXXXXXXX---X000000000000000000000000000000000000
00000000000000000000000000000000000000000000000000000000XX-------------X000000000000000000000000000000000000
00000000000000000000000000000000000000000000000000000000XX--------TTTTTT000000000000000000000000000000000000
00000000000000000000000000000000000000000000000000000000XD-------------X000000000000000000000000000000000000
00000000000000000000000000000000000000000000000000000000XD-------------X000000000000000000000000000000000000
00000000000000000000000000000000000000000000000000000000TTTTXXXXXXXX---X000000000000000000000000000000000000
00000000000000000000000000000000000000000000000000000000--TTTTTTTT-----X000000000000000000000000000000000000
00000000000000000000000000000000000000000000000000000000---------TTTTTTT000000000000000000000000000000000000
00000000000000000000000000000000000000000000000000000000----------------000000000000000000000000000000000000
00000000000000000000000000000000000000000000000000000000X-----------XXXX000000000000000000000000000000000000
00000000000000000000000000000000000000000000000000000000X-----------XXXX000000000000000000000000000000000000
00000000000000000000000000000000000000000000000000000000X-------------XX000000000000000000000000000000000000
0000000000000000----------------------------------------X-------------XX000000000000000000000000000000000000
0000000000000000----------------------------------------X-------------XX000000000000000000000000000000000000
0000000000000000----------------------------------------X-------------XX000000000000000000000000000000000000
0000000000000000----------------------------------------X-------------XX000000000000000000000000000000000000
0000000000000000----------------------------------------X-------------XX000000000000000000000000000000000000
0000000000000000----------------------------------------X-------------XX000000000000000000000000000000000000
0000000000000000----------------------------------------X---XXXXXXXX--DX000000000000000000000000000000000000
0000000000000000----------------------------------------X-------------XX000000000000000000000000000000000000
0000000000000000----------------------------------------XX------------XX000000000000000000000000000000000000
0000000000000000----------------------------------------XXXXXXXXX-----XX000000000000000000000000000000000000
0000000000000000----------------------------------------XD-------TTTT--X000000000000000000000000000000000000
0000000000000000-------------------<--------------------XD-------------X000000000000000000000000000000000000
0000000000000000-----------E-------[--------------------XD-------------X000000000000000000000000000000000000
0000000000000000----------<>-------[--------------------TTTTXXXXXXXX--XX000000000000000000000000000000000000
0000000000000000----------[]-------[----------------------TTTTTTTT-----X000000000000000000000000000000000000
----XXXX--XXXX--XXXXXXXXXXXXXXXXXXXXXXXXXXXXXXXXXXXXXXXX---------TTTTTTT000000000000000000000000000000000000
----XXXX-TTTTTTT00000000000000000000000000000000000000000000000000000000000000000000000000000000000000000000
----XXXX--XXXX--00000000000000000000000000000000000000000000000000000000000000000000000000000000000000000000
----XXXX--XXXX--00000000000000000000000000000000000000000000000000000000000000000000000000000000000000000000
----XTTTT-XXXX--00000000000000000000000000000000000000000000000000000000000000000000000000000000000000000000
----------XXXX--00000000000000000000000000000000000000000000000000000000000000000000000000000000000000000000
----------XXXX--00000000000000000000000000000000000000000000000000000000000000000000000000000000000000000000
---------TTTXX--00000000000000000000000000000000000000000000000000000000000000000000000000000000000000000000
----------------00000000000000000000000000000000000000000000000000000000000000000000000000000000000000000000
X-----------TTTT00000000000000000000000000000000000000000000000000000000000000000000000000000000000000000000
X--------------X00000000000000000000000000000000000000000000000000000000000000000000000000000000000000000000
X--------------X00000000000000000000000000000000000000000000000000000000000000000000000000000000000000000000
XXXXXXXXX------X00000000000000000000000000000000000000000000000000000000000000000000000000000000000000000000
XX-------------X00000000000000000000000000000000000000000000000000000000000000000000000000000000000000000000
XX--------TTTTTT00000000000000000000000000000000000000000000000000000000000000000000000000000000000000000000
XD-------------X00000000000000000000000000000000000000000000000000000000000000000000000000000000000000000000
XD-------------X00000000000000000000000000000000000000000000000000000000000000000000000000000000000000000000
TTTTXXXXXXXX--DX00000000000000000000000000000000000000000000000000000000000000000000000000000000000000000000
--TTTTTTTT-----X00000000000000000000000000000000000000000000000000000000000000000000000000000000000000000000
---------TTTTTTT00000000000000000000000000000000000000000000000000000000000000000000000000000000000000000000
----------------00000000000000000000000000000000000000000000000000000000000000000000000000000000000000000000
XXXX------------00000000000000000000000000000000000000000000000000000000000000000000000000000000000000000000
XXXX------------00000000000000000000000000000000000000000000000000000000000000000000000000000000000000000000
XXXXEEEX--------00000000000000000000000000000000000000000000000000000000000000000000000000000000000000000000
XXXXXX-XX-------00000000000000000000000000000000000000000000000000000000000000000000000000000000000000000000
----------------00000000000000000000000000000000000000000000000000000000000000000000000000000000000000000000
----------------00000000000000000000000000000000000000000000000000000000000000000000000000000000000000000000
---------TTT----00000000000000000000000000000000000000000000000000000000000000000000000000000000000000000000
----------------00000000000000000000000000000000000000000000000000000000000000000000000000000000000000000000
X-----------TTTT00000000000000000000000000000000000000000000000000000000000000000000000000000000000000000000
X--------------X00000000000000000000000000000000000000000000000000000000000000000000000000000000000000000000
X--------------X00000000000000000000000000000000000000000000000000000000000000000000000000000000000000000000
XXXXXXXXX------X00000000000000000000000000000000000000000000000000000000000000000000000000000000000000000000
XX-------------X00000000000000000000000000000000000000000000000000000000000000000000000000000000000000000000
XX--------TTTTTT00000000000000000000000000000000000000000000000000000000000000000000000000000000000000000000
XD-------------X00000000000000000000000000000000000000000000000000000000000000000000000000000000000000000000
XD-------------X00000000000000000000000000000000000000000000000000000000000000000000000000000000000000000000
TTTTXXXXXXXX--DX00000000000000000000000000000000000000000000000000000000000000000000000000000000000000000000
--TTTTTTTT-----X00000000000000000000000000000000000000000000000000000000000000000000000000000000000000000000
---------TTTTTTT00000000000000000000000000000000000000000000000000000000000000000000000000000000000000000000