--------------------------------------------------------------------------------------------------------------------------------------------------------------------------------------------------------000000000000000
--------------------------------------------------------------------------------------------------------------------------------------------------------------------------------------------------------000000000000000
--------------------------------------------------------------------------------------------------------------------------------------------------------------------------------------------------------000000000000000
--------------------------------------------------------------------------------------------------------------------------------------------------------------------------------------------------------000000000000000
--------------------------------------------------------------------------------------------------------------------------------------------------------------------------------------------------------000000000000000
--------------------------------------------------------------------------------------------------------------------------------------------------------------------------------------------------------000000000000000
--------------------------------------E-----------------------------------------------------------------------------------------------------------------------------------------------------------------000000000000000
--------------------------------------X------------------SS---------------------------------------------------------------------------------------------------------------------------------------------000000000000000
--------------------------------------E-----------------------------------------------------------------------------------------------------------------------------------------------------------------000000000000000
------------------------------------E-------------------------------------------------------------------------------------------------------------------------------------------------------------------000000000000000
-----------------------------------<>---------------------E---------------------------------------------------------------------------------------------------------------------------------------------000000000000000
--------------------------------E--[]-----------SX--------SSSSS------------------------------------------------------------------------------------X--------------------------S---------------E---------000000000000000
-------------------------------<>--[]------------------------------E------------------------------------------------------------------------------------------------------------------------------------000000000000000
-------------------------------[]--[]-------------------------------------------------------------------------------------------------------------------------------------------------------------------000000000000000
----------------------------E--[]-E[]------------------E--------E------------------------------EE----------------E----------EE-----------------------------------------------EE----E---E-E--------E-----000000000000000
XXXXXXXXXXXXXXXXXXXXXXXXXXXXXXXXXXXXXXXXXXXXXXXXXXXXXXXXXXXXXXXXXXXXXXXXXXXXXXXXXXXXXXXXXXXXXXXXXXXXXXXXXXXXXXXXXXXXXXXXXXXXXXXXXXXXXXXXXXXXXXXXXXXXXXXXXXXXXXXXXXXXXXXXXXXXXXXXXXXXXXXXXXXXXXXXXXXXXXXX000000000000000
00000000000000000000000000000000000000000000000000000000000000000000000000000000000000000000000000000000000000000000000000000000000000000000000000000000000000000000000000000000000000000000000000000000000000000000000