00000000000000000000000000000000000000000000000000000000000000000000000000000000000000000000000000000000000000000000000000000000000000000000000000000000000000000000000000000000----------------
00000000000000000000000000000000000000000000000000000000000000000000000000000000000000000000000000000000000000000000000000000000000000000000000000000000000000000000000000000000--TTTTTTTT------
00000000000000000000000000000000000000000000000000000000000000000000000000000000000000000000000000000000000000000000000000000000000000000000000000000000000000000000000000000000----------------
00000000000000000000000000000000000000000000000000000000000000000000000000000000000000000000000000000000000000000000000000000000000000000000000000000000000000000000000000000000----------------
00000000000000000000000000000000000000000000000000000000000000000000000000000000000000000000000000000000000000000000000000000000000000000000000000000000000000000000000000000000-----TT---------
00000000000000000000000000000000000000000000000000000000000000000000000000000000000000000000000000000000000000000000000000000000000000000000000000000000000000000000000000000000----------------
00000000000000000000000000000000000000000000000000000000000000000000000000000000000000000000000000000000000000000000000000000000000000000000000000000000000000000000000000000000---E-----E------
00000000000000000000000000000000000000000000000000000000000000000000000000000000000000000000000000000000000000000000000000000000000000000000000000000000000000000000000000000000MMMMMMMMMMMMMMMX
0000000000000000000000000000000000000000000000000000000000000000000000000000000000000000000000000000000000000000000000000000000000000000--------------------------------------------------------
0000000000000000000000000000000000000000000000000000000000000000000000000000000000000000000000000000000000000000000000000000000000000000------------------------------------------E--------E----
000000000000000000000000000000000000000000000000000000000000000000000000000000000000000000000000000000000000000000000000---XXXX-------------------------------------------------MMMMMMMMMMMMMMMM
000000000000000000000000000000000000000000000000000000000000000000000000000000000000000000000000000000000000000000000000------------------------------------------------------------------------
000000000000000000000000000000000000000000000000000000000000000000000000000000000000000000000000000000000000000000000000----------------S-------------------S-----------------------------------
000000000000000000000000000000000000000000000000000000000000000000000000000000000000000000000000000000000000000000000000---E---E--------S-------------------S-------------------XX----------XXXX
------------------------------------------------------------------------------------------------------------------------MMMMMMMMMMMMMMMMS-------------------S-----------------E-XX--------------
----------------------------------------------------------------------------------------------------------------------------------------S-------------------S-------------------XX----------XXXX
----------------------------------------------------------------------------------------------------------------------------------------S-------------------S-------ooo---------XD--------------
---------------------------------------------------------------------------------------------------------------------------------TTTT---S-------------------S-------------------XD-------------X
S-------------------S-------------------S-------------------S-------------------S-------------------S-----------------------------------S-------------------S-----E-------------XXXXX-------XXXX
S-------------------S-------------------S-------------------S-------------------S-------------------S----------------------------XXXX---S-------------?SS---S----->---XXXXXXXXXXXXXXXXXXXXXXXXXX
S-------------------S-------------------S-------------------S-------------------S-------------------S-------------------X-----------TTTTS------------------ES----<]-------------0000000000000000
S-------------------S-------------------S-----------------S-S-------------------S-------------------S-------------------X--------------XS-----------------<>S----[]-------------0000000000000000
S-------------------S-------------------S-------------------S-------------------S-------------------S-------------------X--------------XS-----------------[]S----[]-------------0000000000000000
S-------------------S-------------------S--E----------------S-------------------S-------------------S-------------------XXXX-----------XXXXXXXXXXXXXXXXXXXXXXXEXXXXXX-----------0000000000000000
S----oo-------------S-----E-------------S-<>----------------S-------------------S-------------------S-------------------XXXXXXXX-------X00000000000000000000000000000000000000000000000000000000
S---X--oXXXXXXXXXXXXS----<>-------------S-[]--------------SES-------------------S----------S-------ES-------------------XXXXXXXX------XX00000000000000000000000000000000000000000000000000000000
S-------------------S----[]-------------S-[]----------------S-----E-------------S-----------------<>S--------------E----XD-------------X00000000000000000000000000000000000000000000000000000000
S-------------------S----[]-------------S-[]----------------S---------------E---S-----------------[]S-------------<>----XD-------------X00000000000000000000000000000000000000000000000000000000
S-------------------S----[]-------------S-[]---------------ES-------------------S-------E-E-------[]S---E-EE-EE-E-[]----XXXXX-------XXXX00000000000000000000000000000000000000000000000000000000
XXXX----------------XXXXXXXXXXXXXXXXXXXXXXXXXXXXXXXXXXXXXXXXXXXXXXXXXXXXXXXXXXXXXXXXXXXXXXXXXXXXXXXXXXXXXXXXXXXXXXXXXXXXXXXXXXXXXXXXXXXX00000000000000000000000000000000000000000000000000000000
000000000000000000000000000000000000000000000000000000000000000000000000000000000000000000000000000000000000000000000000000000000000000000000000000000000000000000000000000000000000000000000000