00000000000000000000000000000000000000000000000000000000000000000000000000000000000000000--------------------000000000000000
00000000000000000000000000000000000000000000000000000000000000000000000000000000000000000--------------------000000000000000
00000000000000000000000000000000000000000000000000000000000000000000000000000000000000000--------------------000000000000000
00000000000000000000000000000000000000000000000000000000000000000000000000000000000000000--------------------000000000000000
00000000000000000000000000000000000000000000000000000000000000000000000000000000000000000--------------------000000000000000
00000000000000000000000000000000000000000000000000000000000000000000000000000000000000000--------------------000000000000000
00000000000000000000000000000000000000000000000000000000000000000000000000000000000000000--------------------000000000000000
00000000000000000000000000000000000000000000000000000000000000000000000000000000000000000--------------------000000000000000
00000000000000000000000000000000000000000000000000000000000000000000000000000000000000000--------------------000000000000000
0000000000000000000000000000000000000000000000000000000000000000000000000------------------------------------000000000000000
0000000000000000000000000000000000000000000000000000000000000000000000000--------D-------X-------------------000000000000000
0000000000000000000000000000000000000000000000000000000000000000000000000------XXXX--------------------------000000000000000
0000000000000000000000000000000000000000000000000000000000000000000000000------------------------------------000000000000000
0000000000000000000000000000000000000000000000000000000000000000000000000---XXXX-----------------------------000000000000000
0000000000000000000000000000000000000000000000000000000000000000000000000------------------E-E---------------000000000000000
0000000000000000000000000000000000000000000000000000000000000000000000000----------------XXXXXXXXXXXXXXXXXXXX000000000000000
0000000000000000000000000000000000000000000000000000000000000000000000000TTTTTTTT--------00000000000000000000000000000000000
0000000000000000000000000000000000000000000000000000000000000000000000000---------TTTT---00000000000000000000000000000000000
0000000000000000000000000000000000000000000000000000000000000000000000000----------------00000000000000000000000000000000000
0000000000000000000000000000000000000000000000000000000000000000000000000XXXXE-------XXXX00000000000000000000000000000000000
0000000000000000000000000000000000000000000000000000000000000000000000000XX--------------00000000000000000000000000000000000
0000000000000000000000000000000000000000000000000000000000000000000000000XX--------------00000000000000000000000000000000000
0000000000000000000000000000000000000000000000000000000000000000000000000XXXX--------XXXX00000000000000000000000000000000000
0000000000000000000000000000000000000000000000000000000000000000000000000XXXX--------XXXX00000000000000000000000000000000000
0000000000000000000000000000000000000000000000000000000000000000000000000XXXXXXX-----XXXX00000000000000000000000000000000000
0000000000000000000000000000000000000000000000000000000000000000000000000XXXX--------XXXX00000000000000000000000000000000000
0000000000000000000000000000000000000000000000000000000000000000000000000XX------------XX00000000000000000000000000000000000
0000000000000000000000000000000000000000000000000000000000000000000000000XX-----XXXXX--DX00000000000000000000000000000000000
0000000000000000000000000000000000000000000000000000000000000000000000000XX----------XXXX00000000000000000000000000000000000
0000000000000000000000000000000000000000000000000000000000000000000000000XX----------XXXX00000000000000000000000000000000000
0000000000000000000000000000000000000000000000000000000000000000000000000XX----------XXXX00000000000000000000000000000000000
0000000000000000000000000000000000000000000000000000000000000000000000000XXXXXXX-----XXXX00000000000000000000000000000000000
0000000000000000000000000000000000000000000000000000000000000000000000000XX--------T-XXXX00000000000000000000000000000000000
0000000000000000000000000000000000000000000000000000000000000000000000000XX------------XX00000000000000000000000000000000000
0000000000000000000000000000000000000000000000000000000000000000000000000XX------------XX00000000000000000000000000000000000
0000000000000000000000000000000000000000000000000000000000000000000000000XXXX-----------X00000000000000000000000000000000000
0000000000000000000000000000000000000000000000000000000000000000000000000XXXX-----------X00000000000000000000000000000000000
0000000000000000000000000000000000000000000000000000000000000000000000000XXXXXXXX-------X00000000000000000000000000000000000
0000000000000000000000000000000000000000000000000000000000000000000000000XXXXXXXX-------X00000000000000000000000000000000000
0000000000000000000000000000000000000000000000000000000000000000000000000XXXX----------XX00000000000000000000000000000000000
0000000000000000000000000000000000000000000000000000000000000000000000000XXXX-----------X00000000000000000000000000000000000
0000000000000000000000000000000000000000000000000000000000000000000000000XXXX--------XXXX00000000000000000000000000000000000
0000000000000000000000000000000000000000000000000000000000000000000000000XXXX--XXXXXXXXXX00000000000000000000000000000000000
0000000000000000000000000000000000000000000000000000000000000000000000000XXXX--------XXXX00000000000000000000000000000000000
0000000000000000000000000000000000000000000000000000000000000000000000000XXXX--------XXXX00000000000000000000000000000000000
0000000000000000000000000000000000000000000000000000000000000000000000000XXXX--XXXX--XXXX00000000000000000000000000000000000
0000000000000000000000000000000000000000000000000000000000000000000000000XXXX--------XXXX00000000000000000000000000000000000
0000000000000000000000000000000000000000000000000000000000000000000000000XXXX--------XXXX00000000000000000000000000000000000
0000000000000000000000000000000000000000000000000000000000000000000000000XXXX--XXXX--XXXX00000000000000000000000000000000000
0000000000000000000000000000000000000000000000000000000000000000000000000XXXX--------XXXX00000000000000000000000000000000000
0000000000000000000000000000000000000000000000000000000000000000000000000XXXX--------XXXX00000000000000000000000000000000000
0000000000000000000000000000000000000000000000000000000000000000000000000XTTTTTTTT---XXXX00000000000000000000000000000000000
0000000000000000000000000000000000000000000000000000000000000000000000000XXXX--------XXXX00000000000000000000000000000000000
0000000000000000000000000000000000000000000000000000000000000000000000000XXXX--------XXXX00000000000000000000000000000000000
0000000000000000000000000000000000000000000000000000000000000000000000000XXXX-----TTTTXXX00000000000000000000000000000000000
0000000000000000000000000000000000000000000000000000000000000000000000000XXXX--------XXXX00000000000000000000000000000000000
0000000000000000000000000000000000000000000000000000000000000000000000000XXXX--------XXXX00000000000000000000000000000000000
0000000000000000000000000000000000000000000000000000000000000000000000000XXXX--XXXXXXXXXX00000000000000000000000000000000000
0000000000000000000000000000000000000000000000000000000000000000000000000XXXX--------XXXX00000000000000000000000000000000000
0000000000000000000000000000000000000000000000000000000000000000000000000XXXX--------XXXX00000000000000000000000000000000000
0000000000000000000000000000000000000000000000000000000000000000000000000XXXXXXXXE---XXXX00000000000000000000000000000000000
0000000000000000000000000000000000000000000000000000000000000000000000000XXXX------XXXXXX00000000000000000000000000000000000
0000000000000000000000000000000000000000000000000000000000000000000000000XXXX------XXXX--00000000000000000000000000000000000
0000000000000000000000000000000000000000000000000000000000000000000000000XXXXE-EXXXXXXX--00000000000000000000000000000000000
0000000000000000000000000000000000000000000000000000000000000000000000000XX-------XXXX---00000000000000000000000000000000000
0000000000000000000000000000000000000000000000000000000000000000000000000XX--------XXXX--00000000000000000000000000000000000
0000000000000000000000000000000000000000000000000000000000000000000000000XX----------XXXX00000000000000000000000000000000000
0000000000000000000000000000000000000000000000000000000000000000000000000XX----------XXXX00000000000000000000000000000000000
0000000000000000000000000000000000000000000000000000000000000000000000000XX----------XXXX00000000000000000000000000000000000
0000000000000000000000000000000000000000000000000000000000000000000000000XX--TT------XXXX00000000000000000000000000000000000
0000000000000000000000000000000000000000000000000000000000000000000000000XX----------XXXX00000000000000000000000000000000000
0000000000000000000000000000000000000000000000000000000000000000000000000XX----------XXXX00000000000000000000000000000000000
0000000000000000000000000000000000000000000000000000000000000000000000000XXXXXXXXE--XXXX-00000000000000000000000000000000000
0000000000000000000000000000000000000000000000000000000000000000000000000XXXX------XXXX--00000000000000000000000000000000000
0000000000000000000000000000000000000000000000000000000000000000000000000XXXX------XXXX--00000000000000000000000000000000000
0000000000000000000000000000000000000000000000000000000000000000000000000XXXXE-EXXXXXXX--00000000000000000000000000000000000
0000000000000000000000000000000000000000000000000000000000000000000000000XXXX------XXXX--00000000000000000000000000000000000
0000000000000000000000000000000000000000000000000000000000000000000000000XX-----------XXX00000000000000000000000000000000000
0000000000000000000000000000000000000000000000000000000000000000000000000XX--TT-------XXX00000000000000000000000000000000000
0000000000000000000000000000000000000000000000000000000000000000000000000XX-----------XXX00000000000000000000000000000000000
0000000000000000000000000000000000000000000000000000000000000000000000000XX-----------XXX00000000000000000000000000000000000
0000000000000000000000000000000000000000000000000000000000000000000000000-XXXXXXXE--XXXX-00000000000000000000000000000000000
0000000000000000000000000000000000000000000000000000000000000000000000000-XXXX------XXXX-00000000000000000000000000000000000
0000000000000000000000000000000000000000000000000000000000000000000000000-XXXX------XXXX-00000000000000000000000000000000000
0000000000000000000000000000000000000000000000000000000000000000000000000-XXXX----EXXXXX-00000000000000000000000000000000000
0000000000000000000000000000000000000000000000000000000000000000000000000XX----------XXXX00000000000000000000000000000000000
0000000000000000000000000000000000000000000000000000000000000000000000000XX--------------00000000000000000000000000000000000
0000000000000000000000000000000000000000000000000000000000000000000000000XX----------XXXX00000000000000000000000000000000000
0000000000000000000000000000000000000000000000000000000000000000000000000XD--------------00000000000000000000000000000000000
0000000000000000000000000000000000000000000000000000000000000000000000000XD--------------00000000000000000000000000000000000
0000000000000000000000000000000000000000000000000000000000000000000000000XD--------------00000000000000000000000000000000000
0000000000000000000000000000000000000000000000000000000000000000000000000XMMMMMMMMMMMMMMM00000000000000000000000000000000000
0000000000000000000000000000000000000000000000000000000000000000000000000----------------00000000000000000000000000000000000
0000000000000000000000000000000000000000000000000000000000000000000000000----E--------E--00000000000000000000000000000000000
0000000000000000000000000000000000000000000000000000000000000000000000000MMMMMMMMMMMMMMMM00000000000000000000000000000000000
0000000000000000000000000000000000000000000000000000000000000000000000000----------------00000000000000000000000000000000000
0000000000000000000000000000000000000000000000000000000000000000000000000----------------00000000000000000000000000000000000
0000000000000000000000000000000000000000000000000000000000000000000000000TTTTTTTT--------00000000000000000000000000000000000
0000000000000000000000000000000000000000000000000000000000000000000000000---------TTTT---00000000000000000000000000000000000
0000000000000000000000000000000000000000000000000000000000000000000000000----------------00000000000000000000000000000000000
0000000000000000000000000000000000000000000000000000000000000000000000000XXXXE-------XXXX00000000000000000000000000000000000
0000000000000000000000000000000000000000000000000000000000000000000000000XX--------------00000000000000000000000000000000000
0000000000000000000000000000000000000000000000000000000000000000000000000XX--------------00000000000000000000000000000000000
0000000000000000000000000000000000000000000000000000000000000000000000000XXXX--------XXXX00000000000000000000000000000000000
0000000000000000000000000000000000000000000000000000000000000000000000000XXXX--------XXXX00000000000000000000000000000000000
0000000000000000000000000000000000000000000000000000000000000000000000000XX------------XX00000000000000000000000000000000000
0000000000000000000000000000000000000000000000000000000000000000000000000XX-----XXXX---DX00000000000000000000000000000000000
0000000000000000000000000000000000000000000000000000000000000000000000000XX------------DX00000000000000000000000000000000000
0000000000000000000000000000000000000000000000000000000000000000000000000XXXX--------XXXX00000000000000000000000000000000000
0000000000000000000000000000000000000000000000000000000000000000000000000XXXXX-------XXXX00000000000000000000000000000000000
0000000000000000000000000000000000000000000000000000000000000000000000000X---------------00000000000000000000000000000000000
0000000000000000000000000000000000000000000000000000000000000000000000000X---------------00000000000000000000000000000000000
00000000000000000000000000000000000000000000000000000000-----------------XXXX--------XXXX00000000000000000000000000000000000
00000000000000000000000000000000000000000000000000000000-----------------XXXX--------XXXX00000000000000000000000000000000000
00000000000000000000000000000000000000000000000000000000-----------------XXXX---XX---XXXX00000000000000000000000000000000000
00000000000000000000000000000000000000000000000000000000-----------------XXXX---XX---XXXX00000000000000000000000000000000000
000000000000000000000000000000000000000-0000000000000000-----------------XXXX---XX---T-XX00000000000000000000000000000000000
000000000000000000000000000000000000000-------------------------------XXXXXXXE--XX-----XX00000000000000000000000000000000000
000000000000000000000000000000000000000------------------o--------oo-XXXX000000000000000000000000000000000000000000000000000
000000000000000000000000000000000000000-----------------o-----XXXXXXXX---000000000000000000000000000000000000000000000000000
000000000000000000000000000000000000000--TTTTTTTT------------------------000000000000000000000000000000000000000000000000000
000000000000000000000000000000000000000----------------------------------000000000000000000000000000000000000000000000000000
000000000000000000000000000000000000000---E--------E---------------------000000000000000000000000000000000000000000000000000
000000000000000000000000000000000000000-MMMMMMMMMMMMMMMM-XXX-------------000000000000000000000000000000000000000000000000000
000000000000000000000000000000000000000----------------------------------000000000000000000000000000000000000000000000000000
000000000000000000000000000000000000000----------------------------------000000000000000000000000000000000000000000000000000
000000000000000000000000000000000000000-MMMMMMMMMMMMMMMM----------XX-----000000000000000000000000000000000000000000000000000
000000000000000000000000000000000000000-----------------------XXXXXXXXXXX000000000000000000000000000000000000000000000000000
000000000000000000000000000000000000000--X--------------00000000000000000000000000000000000000000000000000000000000000000000
000000000000000000000000000000000000000-XX---------XXXX-00000000000000000000000000000000000000000000000000000000000000000000
00000000000000000000000---XXXX-------XXXXXXXX---XXXXXXXX00000000000000000000000000000000000000000000000000000000000000000000
00000000000000000000000-----XX-------XXX000000000000000000000000000000000000000000000000000000000000000000000000000000000000
00000000000000000000000-----XXXXX----XX0000000000000000000000000000000000000000000000000000000000000000000000000000000000000
00000000000000000000000----------------0000000000000000000000000000000000000000000000000000000000000000000000000000000000000
---------------------------------------0000000000000000000000000000000000000000000000000000000000000000000000000000000000000
--------------------------------XXXXX--0000000000000000000000000000000000000000000000000000000000000000000000000000000000000
--------------------------------XX-----0000000000000000000000000000000000000000000000000000000000000000000000000000000000000
---------------------------------------0000000000000000000000000000000000000000000000000000000000000000000000000000000000000
--------------------------E---E---X----0000000000000000000000000000000000000000000000000000000000000000000000000000000000000
-----------------------MMMMMMMMMMMMMMMM0000000000000000000000000000000000000000000000000000000000000000000000000000000000000
---------------------------E-----------0000000000000000000000000000000000000000000000000000000000000000000000000000000000000
-------------------------E--------E----0000000000000000000000000000000000000000000000000000000000000000000000000000000000000
-----------------------MMMMMMMMMMMMMMMM0000000000000000000000000000000000000000000000000000000000000000000000000000000000000
---------------------------------------0000000000000000000000000000000000000000000000000000000000000000000000000000000000000
--------E---E--------------------------0000000000000000000000000000000000000000000000000000000000000000000000000000000000000
-------<>--->--------XX----------XXXXX-0000000000000000000000000000000000000000000000000000000000000000000000000000000000000
-------[]--<]-------XXX00000000000000000000000000000000000000000000000000000000000000000000000000000000000000000000000000000
-------[]--[]------XXXX00000000000000000000000000000000000000000000000000000000000000000000000000000000000000000000000000000
-------[]--[]-----XXXXX00000000000000000000000000000000000000000000000000000000000000000000000000000000000000000000000000000
XXXXXXXXXXXXXXXXXXXXXXX00000000000000000000000000000000000000000000000000000000000000000000000000000000000000000000000000000
0000000000000000000000000000000000000000000000000000000000000000000000000000000000000000000000000000000000000000000000000000