00000000000000000000000000000000000000000000000000000000000000000000000000000000000000000000---TTTT--TTTT---
00000000000000000000000000000000000000000000000000000000000000000000000000000000000000000000----------------
00000000000000000000000000000000000000000000000000000000000000000000000000000000000000000000----------------
00000000000000000000000000000000000000000000000000000000000000000000000000000000000000000000------TTTT------
00000000000000000000000000000000000000000000000000000000000000000000000000000000000000000000----------------
00000000000000000000000000000000000000000000000000000000000000000000000000000000000000000000---------TTTT---
00000000000000000000000000000000000000000000000000000000000000000000000000000000000000000000----------------
00000000000000000000000000000000000000000000000000000000000000000000000000000000000000000000------XXXX------
00000000000000000000000000000000000000000000000000000000000000000000000000000000000000000000----------------
00000000000000000000000000000000000000000000000000000000000000000000000000000000000000000000---------XXXX---
00000000000000000000000000000000000000000000000000000000000000000000000000000000000000000000----------------
00000000000000000000000000000000000000000000000000000000000000000000000000000000000000000000------XXXX------
00000000000000000000000000000000000000000000000000000000000000000000000000000000000000000000----XX----------
00000000000000000000000000000000000000000000000000000000000000000000000000000000000000000000----XX----------
0000000000000000000000000000000000000000000000000000000000000000000000000000000000000000000-----XX----------
0000000000000000000000000000000000000000000000000000000000000000000000000000000000000000000-XXXXXX-------XXX
0000000000000000000000000000000000000000000000000000000000000000000000000000000000000000000-------------XX--
0000000000000000000000000000000000000000000000000000000000000000000000000000000000000000000-------XXXX--XX--
0000000000000000000000000000000000000000000000000000000000000000000000000000000000000000000-------------XX--
0000000000000000000000000000000000000000000000000000000000000000000000000000000000000000000-------------XX--
0000000000000000000000000000000000000000000000000000000000000000000000000000000000000000000-----------XXXX--
0000000000000000000000000000000000000000000000000000000000000000000000000000000000000000000---------DX------
0000000000000000000000000000000000000000000000000000000000000000000000000000000000000000000-------XXXXXX----
000000000000000000000000000000000000000000000000000000000000000000000000000----------------X------XX--------
000000000000000000000000000000000000000000000000000000000000000000000000000------XXXX------X0000000000000000
000000000000000000000000000000000000000000000000000000000000000000000000000----------------X0000000000000000
000000000000000000000000000000000000000000000000000000000000000000000000000---------XXXX---X0000000000000000
000000000000000000000000000000000000000000000000000000000000000000000000000----------------X0000000000000000
000000000000000000000000000000000000000000000000000000000000000000000000000----------------X0000000000000000
000000000000000000000000000000000000000000000000000000000000000000000000000XMMMMMMMMMMMMMMMX0000000000000000
000000000000000000000000000000000000000000000000000000000000000000000000000----------------00000000000000000
000000000000000000000000000000000000000000000000000000000000000000000000000----------------00000000000000000
00000000000000000000000000000000000000000000000000000000000000000000000----XMMMMMMMMMMMMMMM00000000000000000
00000000000000000000000000000000000000000000000000000000000000000000000--------------------00000000000000000
00000000000000000000000000000000000000000000000000000000000000000000000--------E--------E--00000000000000000
00000000000000000000000000000000000000000000000000000000000000000000000----MMMMMMMMMMMMMMMM00000000000000000
00000000000000000000000000000000000000000000000000000000000000000000000--------------------00000000000000000
00000000000000000000000000000000000000000000000000000000000000000000000--------------------00000000000000000
00000000000000000000000000000000000000000000000000000000000000000000000-------------X------00000000000000000
0000000000000000000000000000000000000000000000000000000-----------------------------X------00000000000000000
0000000000000000000000000000000000000000000000000000000----------------XXXX---------X------00000000000000000
0000000000000000000000000000000000000000000000000000000----------X---------000000000000000000000000000000000
0000000000000000000000000000000000000000000000000000000----------X---------000000000000000000000000000000000
0000000000000000000000000000000000000000000000000000000--------------------000000000000000000000000000000000
0000000000000000000000000000000000000000000000000000000---------X----------000000000000000000000000000000000
0000000000000000000000000000000000000000000000000000000---------X----------000000000000000000000000000000000
0000000000000000000000000000000000000000000000000000000---------X----------000000000000000000000000000000000
0000000000000000000000000000000000000000000000000000000--------------------000000000000000000000000000000000
0000000000000000000000000000000000000000000000000000000---X------------0000000000000000000000000000000000000
0000000000000000000000000000000000000000000000000000000-TTTT-----------0000000000000000000000000000000000000
0000000000000000000000000000000000000000000000000000000----------------0000000000000000000000000000000000000
0000000000000000000000000000000000000000000000000000000----------------0000000000000000000000000000000000000
0000000000000000000000000000000000000000000000000000000----------------0000000000000000000000000000000000000
0000000000000000000000000000000000000000000000000000000TTTTTTTT-------X0000000000000000000000000000000000000
0000000000000000000000000000000000000000000000000000000---------TTTT---0000000000000000000000000000000000000
0000000000000000000000000000000000000000000000000000000----------------0000000000000000000000000000000000000
0000000000000000000000000000000000000000000000000000000XXXX--------XXXX0000000000000000000000000000000000000
0000000000000000000000000000000000000000000000000000000----------------0000000000000000000000000000000000000
0000000000000000000000000000000000000000000000000000000----------------0000000000000000000000000000000000000
0000000000000000000000000000000000000000000000000000-----------TTTT----0000000000000000000000000000000000000
0000000000000000000000000000000000000000000000000000---00000000000000000000000000000000000000000000000000000
0000000000000000000000000000000000000000000000000000---00000000000000000000000000000000000000000000000000000
0000000000000000000000000000000000000000000000000000---00000000000000000000000000000000000000000000000000000
0000000000000000000000000000000000000000000000000000---00000000000000000000000000000000000000000000000000000
0000000000000000000000000000000000000000000000000000---00000000000000000000000000000000000000000000000000000
000000000000000000000000000000000---0000000000000000---00000000000000000000000000000000000000000000000000000
000000000000000000000000000000000---0000000000000000---00000000000000000000000000000000000000000000000000000
000000000000000000000000000000000---0000000000000000---00000000000000000000000000000000000000000000000000000
000000000000000000000000000000000------------X---------00000000000000000000000000000000000000000000000000000
00000000000000000------TTTTTTTTTT----------------------00000000000000000000000000000000000000000000000000000
00000000000000000-----------------------------------X--00000000000000000000000000000000000000000000000000000
00000000000000000-------------------MMMMMMMMMMMMMMMM---00000000000000000000000000000000000000000000000000000
00000000000000000----------------X---------------------00000000000000000000000000000000000000000000000000000
00000000000000000-----TTTTTTT----X---------------------00000000000000000000000000000000000000000000000000000
00000000000000000----------------X---------------------00000000000000000000000000000000000000000000000000000
00000000000000000----------------X-------TTTT-------00000000000000000000000000000000000000000000000000000000
00000000000000000--------TTTT----XX-----------------00000000000000000000000000000000000000000000000000000000
00000000000000000----------------XXXXXXX--------XXXX00000000000000000000000000000000000000000000000000000000
00000000000000000----------------XXX000000000000000000000000000000000000000000000000000000000000000000000000
00000000000000000------TTTT------XXX000000000000000000000000000000000000000000000000000000000000000000000000
00000000000000000---XXXX--TTT----XXX000000000000000000000000000000000000000000000000000000000000000000000000
00000000000000000---XXXX---XXXX--000000000000000000000000000000000000000000000000000000000000000000000000000
00000000000000000-TTTXXD---XXXX--000000000000000000000000000000000000000000000000000000000000000000000000000
00000000000000000---XXXXX--XXXX--000000000000000000000000000000000000000000000000000000000000000000000000000
00000000000000000----XXXX--XXXX--000000000000000000000000000000000000000000000000000000000000000000000000000
00000000000000000----XXXX--XXXX--000000000000000000000000000000000000000000000000000000000000000000000000000
00000000000000000----XXXX-TTTTTTT000000000000000000000000000000000000000000000000000000000000000000000000000
00000000000000000----XXXX--XXXX--000000000000000000000000000000000000000000000000000000000000000000000000000
00000000000000000----XXXX--XXXX--000000000000000000000000000000000000000000000000000000000000000000000000000
00000000000000000----XTTTT-XXXX--000000000000000000000000000000000000000000000000000000000000000000000000000
00000000000000000----------XXXX--000000000000000000000000000000000000000000000000000000000000000000000000000
00000000000000000----------XXXX--000000000000000000000000000000000000000000000000000000000000000000000000000
00000000000000000---------TTTXX--000000000000000000000000000000000000000000000000000000000000000000000000000
00000000000000000-------E--------000000000000000000000000000000000000000000000000000000000000000000000000000
00000000000000000MMMMMMMMMMMMMMMM000000000000000000000000000000000000000000000000000000000000000000000000000
00000000000000000----------------000000000000000000000000000000000000000000000000000000000000000000000000000
00000000000000000----------------000000000000000000000000000000000000000000000000000000000000000000000000000
00000000000000000---TTTT---------000000000000000000000000000000000000000000000000000000000000000000000000000
00000000000000000----------------000000000000000000000000000000000000000000000000000000000000000000000000000
00000000000000000----------------000000000000000000000000000000000000000000000000000000000000000000000000000
00000000000000000-------TT--TTTT-000000000000000000000000000000000000000000000000000000000000000000000000000
00000000000000000----------------000000000000000000000000000000000000000000000000000000000000000000000000000
00000000000000000----------------000000000000000000000000000000000000000000000000000000000000000000000000000
00000000000000000-------TT--TTTT-000000000000000000000000000000000000000000000000000000000000000000000000000
00000000000000000----------------000000000000000000000000000000000000000000000000000000000000000000000000000
00000000000000000----------------000000000000000000000000000000000000000000000000000000000000000000000000000
00000000000000000-----------TTTT-000000000000000000000000000000000000000000000000000000000000000000000000000
00000000000000000----------------000000000000000000000000000000000000000000000000000000000000000000000000000
00000000000000000----------------000000000000000000000000000000000000000000000000000000000000000000000000000
00000000000000000------TTTT------000000000000000000000000000000000000000000000000000000000000000000000000000
00000000000000000----------------000000000000000000000000000000000000000000000000000000000000000000000000000
00000000000000000---------XXXX---000000000000000000000000000000000000000000000000000000000000000000000000000
00000000000000000----------------000000000000000000000000000000000000000000000000000000000000000000000000000
00000000000000000---E---E--------000000000000000000000000000000000000000000000000000000000000000000000000000
00000000000000000MMMMMMMMMMMMMMMM000000000000000000000000000000000000000000000000000000000000000000000000000
00000000000000000----------------000000000000000000000000000000000000000000000000000000000000000000000000000
00000000000000000----------------000000000000000000000000000000000000000000000000000000000000000000000000000
00000000000000000----------------000000000000000000000000000000000000000000000000000000000000000000000000000
00000000000000000------TTTT------000000000000000000000000000000000000000000000000000000000000000000000000000
00000000000000000----------------000000000000000000000000000000000000000000000000000000000000000000000000000
00000000000000000---------TTTT---000000000000000000000000000000000000000000000000000000000000000000000000000
00000000000000000----------------000000000000000000000000000000000000000000000000000000000000000000000000000
00000000000000000----------------000000000000000000000000000000000000000000000000000000000000000000000000000
00000000000000000TTTTTTTT--------000000000000000000000000000000000000000000000000000000000000000000000000000
00000000000000000---------TTTT---000000000000000000000000000000000000000000000000000000000000000000000000000
00000000000000000----------------000000000000000000000000000000000000000000000000000000000000000000000000000
00000000000000000XXXX--------XXXX000000000000000000000000000000000000000000000000000000000000000000000000000
00000000000000000-----E----------000000000000000000000000000000000000000000000000000000000000000000000000000
00000000000000000----TTT---------000000000000000000000000000000000000000000000000000000000000000000000000000
00000000000000000----------------000000000000000000000000000000000000000000000000000000000000000000000000000
00000000000000000------XXXX------000000000000000000000000000000000000000000000000000000000000000000000000000
00000000000000000------XX--------000000000000000000000000000000000000000000000000000000000000000000000000000
00000000000000000---XXXXX--------000000000000000000000000000000000000000000000000000000000000000000000000000
00000000000000000---XX-----------000000000000000000000000000000000000000000000000000000000000000000000000000
00000000000000000---XX-----------000000000000000000000000000000000000000000000000000000000000000000000000000
00000000000000000XXXX----------XX000000000000000000000000000000000000000000000000000000000000000000000000000
00000000000000000XXXX----------DX000000000000000000000000000000000000000000000000000000000000000000000000000
00000000000000000XXXX----------DX000000000000000000000000000000000000000000000000000000000000000000000000000
00000000000000000XXXX----XXXXXXXX000000000000000000000000000000000000000000000000000000000000000000000000000
00000000000000000---X-X----------000000000000000000000000000000000000000000000000000000000000000000000000000
00000000000000000---X------------000000000000000000000000000000000000000000000000000000000000000000000000000
00000000000000000XXXX----------XX000000000000000000000000000000000000000000000000000000000000000000000000000
00000000000000000XXXX----------XX000000000000000000000000000000000000000000000000000000000000000000000000000
00000000000000000XXXX----------XX000000000000000000000000000000000000000000000000000000000000000000000000000
00000000000000000XXXX----------X-000000000000000000000000000000000000000000000000000000000000000000000000000
00000000000000000XXXX------------000000000000000000000000000000000000000000000000000000000000000000000000000
00000000000000000XXXX------------000000000000000000000000000000000000000000000000000000000000000000000000000
00000000000000000XXXX----------X-000000000000000000000000000000000000000000000000000000000000000000000000000
00000000000000000XXXX----------X-000000000000000000000000000000000000000000000000000000000000000000000000000
00000000000000000XXXX------------000000000000000000000000000000000000000000000000000000000000000000000000000
00000000000000000XXXX------------000000000000000000000000000000000000000000000000000000000000000000000000000
00000000000000000----------------000000000000000000000000000000000000000000000000000000000000000000000000000
00000000000000000----------------000000000000000000000000000000000000000000000000000000000000000000000000000
00000000000000000---------TT-----000000000000000000000000000000000000000000000000000000000000000000000000000
00000000000000000----------------000000000000000000000000000000000000000000000000000000000000000000000000000
---------------------------------000000000000000000000000000000000000000000000000000000000000000000000000000
-----------------TTTTTTTT----XXXX000000000000000000000000000000000000000000000000000000000000000000000000000
---------------------------------000000000000000000000000000000000000000000000000000000000000000000000000000
-----------------------------TTTT000000000000000000000000000000000000000000000000000000000000000000000000000
--------------------XXXX-------XX000000000000000000000000000000000000000000000000000000000000000000000000000
----------------------XX-------XX000000000000000000000000000000000000000000000000000000000000000000000000000
----------------------XXXXX----XX000000000000000000000000000000000000000000000000000000000000000000000000000
---------------------------------000000000000000000000000000000000000000000000000000000000000000000000000000
---------------------------------000000000000000000000000000000000000000000000000000000000000000000000000000
--------------------------XXXX---000000000000000000000000000000000000000000000000000000000000000000000000000
-----------------------------X---000000000000000000000000000000000000000000000000000000000000000000000000000
----E-----X------------------XX--000000000000000000000000000000000000000000000000000000000000000000000000000
----E----XX----XX------------XX--000000000000000000000000000000000000000000000000000000000000000000000000000
--------XXX---XXX0000000000000000000000000000000000000000000000000000000000000000000000000000000000000000000
-------XXXX--XXXX0000000000000000000000000000000000000000000000000000000000000000000000000000000000000000000
XXXXXXXXXXXXXXXXX0000000000000000000000000000000000000000000000000000000000000000000000000000000000000000000
000000000000000000000000000000000000000000000000000000000000000000000000000000000000000000000000000000000000