000000000000000000000000000000000000000000000000000000000000000000000000000000000000000000000000000000000000000000000000000000000000----------------
000000000000000000000000000000000000000000000000000000000000000000000000000000000000000000000000000000000000000000000000000000000000---TTTT--TTTT---
000000000000000000000000000000000000000000000000000000000000000000000000000000000000000000000000000000000000000000000000000000000000----------------
000000000000000000000000000000000000000000000000000000000000000000000000000000000000000000000000000000000000000000000000000000000000----------------
000000000000000000000000000000000000000000000000000000000000000000000000-----------------------------------------------------------------TT--TT-----
000000000000000000000000000000000000000000000000000000000000000000000000----------------------------------------------------------------------------
000000000000000000000000000000000000000000000000000000000000000000000000----------------------------------------------------------------------------
000000000000000000000000000000000000000000000000000000000000000000000000---------------------------------------------------------------------TTT----
000000000000000000000000000000000000000000000000000000000000000000000000----------------------------------------------------------------------------
000000000000000000000000000000000000000000000000000000000000000000000000------------------------------------------------------------X-----------TTTT
000000000000000000000000000000000000000000000000000000000000000000000000------------------------------------ooo---------------------X--------------X
000000000000000000000000000000000000000000000000000000000000000000000000-----------------------------------oXXXX--------------------X--------------X
000000000000000000000000000000000000000000000000000000000000000000000000----------------------------XXXXXX--------------------------XXXXXXXXX------X
000000000000000000000000000000000000000000000000000000000000000000000000----------------------------------X-------------------------XX-------------X
000000000000000000000000000000000000000000000000000000000000000000000000------------------------E----------X------------------------XX--------TTTTTT
000000000000000000000000000000000000000000000000000000000000000000000000-----------E-----------<>------------------------M------S---XD-------------X
000000000000000000000000000000000000000000000000000000000000000000000000----------<>-----------[]-----------------------------------XD-------------X
00000000000000000000000000000000000000000000000000000000---------XXXX-------------[]-----------[]-----------------------------------TTTTXXXXXXXX---X
00000000000000000000000000000000000000000000000000000000-------------------EE-E---[]-----------[]----------X--------------------E-E---TTTTTTTT-----X
00000000000000000000000000000000000000000000000000000000----------------XXXXXXXXXXXXXXXXXXXXXXXXXXXX-----XXXXXXXXXXXXXXXXXXXXXXXXXXX---------TTTTTTT
00000000000000000000000000000000000000000000000000000000XMMMMMMMMMMMMMMM0000000000000000000000000000000000000000000000000000000000000000000000000000
000000000000000000000000000000000000------------------------------------0000000000000000000000000000000000000000000000000000000000000000000000000000
000000000000000000000000000000000000------------------------E--------E--0000000000000000000000000000000000000000000000000000000000000000000000000000
000000000000000000000000000000000000--------------------MMMMMMMMMMMMMMMM0000000000000000000000000000000000000000000000000000000000000000000000000000
000000000000000000000000000000000000------------------------------------0000000000000000000000000000000000000000000000000000000000000000000000000000
000000000000000000000000000000000000------------------------------------0000000000000000000000000000000000000000000000000000000000000000000000000000
000000000000000000000000000000000000------------------------XXXX---XXXX-0000000000000000000000000000000000000000000000000000000000000000000000000000
000000000000000000000000000000000000---------------------XXXX----XXXX---0000000000000000000000000000000000000000000000000000000000000000000000000000
000000000000000000000000000000000000--------------------XXXX-----TTTTTTT0000000000000000000000000000000000000000000000000000000000000000000000000000
000000000000000000000000000000000000--------------------XXXX--------XXXX0000000000000000000000000000000000000000000000000000000000000000000000000000
000000000000000000000000000000000000--------------------XXXX--------XXXX0000000000000000000000000000000000000000000000000000000000000000000000000000
000000000000000000000000000000000000----------o---------XXXX--------XXXX0000000000000000000000000000000000000000000000000000000000000000000000000000
000000000000000000000000000000000000---------XX---------XD--------------0000000000000000000000000000000000000000000000000000000000000000000000000000
000000000000000000000000000000000000--------------------XD-------------X0000000000000000000000000000000000000000000000000000000000000000000000000000
000000000000000000000000000000000000--------------------TTTTXXXXXXXX--XX0000000000000000000000000000000000000000000000000000000000000000000000000000
000000000000000000000000000000000000----------------------TTTTTTTT-----X0000000000000000000000000000000000000000000000000000000000000000000000000000
00000000000000000000----------------XXXXXXXXX-XXXXXXXXXX---------TTTTTTT0000000000000000000000000000000000000000000000000000000000000000000000000000
00000000000000000000XXXX------------0000000000000000000000000000000000000000000000000000000000000000000000000000000000000000000000000000000000000000
00000000000000000000XXXX------------0000000000000000000000000000000000000000000000000000000000000000000000000000000000000000000000000000000000000000
00000000000000000000XXXXEEEX--------0000000000000000000000000000000000000000000000000000000000000000000000000000000000000000000000000000000000000000
00000000000000000000XXXXXX-XX-------0000000000000000000000000000000000000000000000000000000000000000000000000000000000000000000000000000000000000000
00000000000000000000----------------0000000000000000000000000000000000000000000000000000000000000000000000000000000000000000000000000000000000000000
00000000000000000000----------------0000000000000000000000000000000000000000000000000000000000000000000000000000000000000000000000000000000000000000
00000000000000000000---------TTT----0000000000000000000000000000000000000000000000000000000000000000000000000000000000000000000000000000000000000000
00000000000000000000----------------0000000000000000000000000000000000000000000000000000000000000000000000000000000000000000000000000000000000000000
00000000000000000000X-----------TTTT0000000000000000000000000000000000000000000000000000000000000000000000000000000000000000000000000000000000000000
00000000000000000000X--------------X0000000000000000000000000000000000000000000000000000000000000000000000000000000000000000000000000000000000000000
00000000000000000000X--------------X0000000000000000000000000000000000000000000000000000000000000000000000000000000000000000000000000000000000000000
00000000000000000000XXXXXXXXX------X0000000000000000000000000000000000000000000000000000000000000000000000000000000000000000000000000000000000000000
00000000000000000000XX-------------X0000000000000000000000000000000000000000000000000000000000000000000000000000000000000000000000000000000000000000
00000000000000000000XX--------TTTTTT0000000000000000000000000000000000000000000000000000000000000000000000000000000000000000000000000000000000000000
00000000000000000000XD-------------X0000000000000000000000000000000000000000000000000000000000000000000000000000000000000000000000000000000000000000
00000000000000000000XD-------------X0000000000000000000000000000000000000000000000000000000000000000000000000000000000000000000000000000000000000000
00000000000000000000TTTTXXXXXXXX---X0000000000000000000000000000000000000000000000000000000000000000000000000000000000000000000000000000000000000000
00000000000000000000--TTTTTTTT-----X0000000000000000000000000000000000000000000000000000000000000000000000000000000000000000000000000000000000000000
00000000000000000000---------TTTTTTT0000000000000000000000000000000000000000000000000000000000000000000000000000000000000000000000000000000000000000
00000000000000000000X--------------X0000000000000000000000000000000000000000000000000000000000000000000000000000000000000000000000000000000000000000
00000000000000000000X--------------X0000000000000000000000000000000000000000000000000000000000000000000000000000000000000000000000000000000000000000
00000000000000000000XD-------------X0000000000000000000000000000000000000000000000000000000000000000000000000000000000000000000000000000000000000000
00000000000000000000X---XXXXXXXXXXXX0000000000000000000000000000000000000000000000000000000000000000000000000000000000000000000000000000000000000000
00000000000000000000--TTT--------XXX0000000000000000000000000000000000000000000000000000000000000000000000000000000000000000000000000000000000000000
00000000000000000000XX-----------XXX0000000000000000000000000000000000000000000000000000000000000000000000000000000000000000000000000000000000000000
00000000000000000000----------------0000000000000000000000000000000000000000000000000000000000000000000000000000000000000000000000000000000000000000
00000000000000000000---------TTT----0000000000000000000000000000000000000000000000000000000000000000000000000000000000000000000000000000000000000000
00000000000000000000----------------0000000000000000000000000000000000000000000000000000000000000000000000000000000000000000000000000000000000000000
00000000000000000000X-----------TTTT0000000000000000000000000000000000000000000000000000000000000000000000000000000000000000000000000000000000000000
00000000000000000000X--------------X0000000000000000000000000000000000000000000000000000000000000000000000000000000000000000000000000000000000000000
00000000000000000000X--------------X0000000000000000000000000000000000000000000000000000000000000000000000000000000000000000000000000000000000000000
00000000000000000000XXXXXXXXX------X0000000000000000000000000000000000000000000000000000000000000000000000000000000000000000000000000000000000000000
00000000000000000000XX-------------X0000000000000000000000000000000000000000000000000000000000000000000000000000000000000000000000000000000000000000
00000000000000000000XX--------TTTTTT0000000000000000000000000000000000000000000000000000000000000000000000000000000000000000000000000000000000000000
00000000000000000000XD-------------X0000000000000000000000000000000000000000000000000000000000000000000000000000000000000000000000000000000000000000
00000000000000000000XD-------------X0000000000000000000000000000000000000000000000000000000000000000000000000000000000000000000000000000000000000000
00000000000000000000TTTTXXXXXXXX--DX0000000000000000000000000000000000000000000000000000000000000000000000000000000000000000000000000000000000000000
00000000000000000000--TTTTTTTT-----X0000000000000000000000000000000000000000000000000000000000000000000000000000000000000000000000000000000000000000
00000000000000000000---------TTTTTTT0000000000000000000000000000000000000000000000000000000000000000000000000000000000000000000000000000000000000000
00000000000000000000XXXXXX------XXXX0000000000000000000000000000000000000000000000000000000000000000000000000000000000000000000000000000000000000000
00000000000000000000XXXX--------XXXX0000000000000000000000000000000000000000000000000000000000000000000000000000000000000000000000000000000000000000
00000000000000000000XXXX--------XXXX0000000000000000000000000000000000000000000000000000000000000000000000000000000000000000000000000000000000000000
00000000000000000000XX----TTTTTTTTXX0000000000000000000000000000000000000000000000000000000000000000000000000000000000000000000000000000000000000000
00000000000000000000XX------------XX0000000000000000000000000000000000000000000000000000000000000000000000000000000000000000000000000000000000000000
00000000000000000000XX------------XX0000000000000000000000000000000000000000000000000000000000000000000000000000000000000000000000000000000000000000
00000000000000000000XXXXXXXX------XX0000000000000000000000000000000000000000000000000000000000000000000000000000000000000000000000000000000000000000
00000000000000000000XXXX----------XX0000000000000000000000000000000000000000000000000000000000000000000000000000000000000000000000000000000000000000
00000000000000000000XXXX----------XX0000000000000000000000000000000000000000000000000000000000000000000000000000000000000000000000000000000000000000
00000000000000000000XXXX---------XXX0000000000000000000000000000000000000000000000000000000000000000000000000000000000000000000000000000000000000000
00000000000000000000XXXX----------X-0000000000000000000000000000000000000000000000000000000000000000000000000000000000000000000000000000000000000000
00000000000000000000XXXX------------0000000000000000000000000000000000000000000000000000000000000000000000000000000000000000000000000000000000000000
--------------------XXXX------------0000000000000000000000000000000000000000000000000000000000000000000000000000000000000000000000000000000000000000
--------------------XX--------------0000000000000000000000000000000000000000000000000000000000000000000000000000000000000000000000000000000000000000
--------------------XD--------TTTTTT0000000000000000000000000000000000000000000000000000000000000000000000000000000000000000000000000000000000000000
--------------------XD-------------X0000000000000000000000000000000000000000000000000000000000000000000000000000000000000000000000000000000000000000
--------------------XD-------------X0000000000000000000000000000000000000000000000000000000000000000000000000000000000000000000000000000000000000000
--------------------TTTTXXXXXXXX--XX0000000000000000000000000000000000000000000000000000000000000000000000000000000000000000000000000000000000000000
----------oo-Xooooo---TTTTTTTT-----X0000000000000000000000000000000000000000000000000000000000000000000000000000000000000000000000000000000000000000
-----SS---XXX-XXXXXX---------TTTTTTT0000000000000000000000000000000000000000000000000000000000000000000000000000000000000000000000000000000000000000
---------X----------00000000000000000000000000000000000000000000000000000000000000000000000000000000000000000000000000000000000000000000000000000000
--------------------00000000000000000000000000000000000000000000000000000000000000000000000000000000000000000000000000000000000000000000000000000000
--------o-----------00000000000000000000000000000000000000000000000000000000000000000000000000000000000000000000000000000000000000000000000000000000
----XXXX------------00000000000000000000000000000000000000000000000000000000000000000000000000000000000000000000000000000000000000000000000000000000
----X---------------00000000000000000000000000000000000000000000000000000000000000000000000000000000000000000000000000000000000000000000000000000000
----X---------------00000000000000000000000000000000000000000000000000000000000000000000000000000000000000000000000000000000000000000000000000000000
----X----------E----00000000000000000000000000000000000000000000000000000000000000000000000000000000000000000000000000000000000000000000000000000000
XXXXXXX--XXXXXXXXXXX00000000000000000000000000000000000000000000000000000000000000000000000000000000000000000000000000000000000000000000000000000000
0000000000000000000000000000000000000000000000000000000000000000000000000000000000000000000000000000000000000000000000000000000000000000000000000000