0000000000000000000000000000000000000000000000000000--------------------000000000000000
0000000000000000000000000000000000000000000000000000--------------------000000000000000
0000000000000000000000000000000000000000000000000000--------------------000000000000000
0000000000000000000000000000000000000000000000000000--------------------000000000000000
0000000000000000000000000000000000000000000000000000--------------------000000000000000
0000000000000000000000000000000000000000000000000000--------------------000000000000000
0000000000000000000000000000000000000000000000000000--------------------000000000000000
0000000000000000000000000000000000000000000000000000--------------------000000000000000
0000000000000000000000000000000000000000000000000000--------------------000000000000000
0000000000000000000000000000000000000000000000000000--------------------000000000000000
0000000000000000000000000000000000000000000000000000--------------------000000000000000
0000000000000000000000000000000000000000000000000000-----QS-------------000000000000000
0000000000000000000000000000000000000000000000000000-----------E--------000000000000000
0000000000000000000000000000000000000000000000000000----------<>--------000000000000000
0000000000000000000000000000000000000000000000000000---X------[]--------000000000000000
000000000000000000000000000000000000--X---XXXXXXXXXXXXXXXXXXXXXXXXXXXXX-000000000000000
000000000000000000000000000000000000X-------------XX00000000000000000000000000000000000
000000000000000000000000000000000000X-------------XX00000000000000000000000000000000000
000000000000000000000000000000000000X--------------X00000000000000000000000000000000000
000000000000000000000000000000000000-XMMMMMMMMMMXMMX00000000000000000000000000000000000
000000000000000000000000000000000000XX--------------00000000000000000000000000000000000
000000000000000000000000000000000000XX--------------00000000000000000000000000000000000
000000000000000000000000000000000000XXXX--------XXXX00000000000000000000000000000000000
000000000000000000000000000000000000XXXX--------XXXX00000000000000000000000000000000000
000000000000000000000000000000000000XXXX--------XXXX00000000000000000000000000000000000
000000000000000000000000000000000000XXXX--------XXXX00000000000000000000000000000000000
000000000000000000000000000000000000XXXX--------XXXX00000000000000000000000000000000000
000000000000000000000000000000000000XX----TTTTTTTTXX00000000000000000000000000000000000
000000000000000000000000000000000000XX------------XX00000000000000000000000000000000000
000000000000000000000000000000000000XX------------XX00000000000000000000000000000000000
000000000000000000000000000000000000XD------------XX00000000000000000000000000000000000
000000000000000000000000000000000000XD-------------X00000000000000000000000000000000000
000000000000000000000000000000000000TTTTXXXXXXXX--DX00000000000000000000000000000000000
000000000000000000000000000000000000--TTTTTTTT----DX00000000000000000000000000000000000
000000000000000000000000000000000000---------TTTTTTT00000000000000000000000000000000000
000000000000000000000000000000000000--X------TTTT---00000000000000000000000000000000000
000000000000000000000000000000000000X---------------00000000000000000000000000000000000
000000000000000000000000000000000000XX--------------00000000000000000000000000000000000
000000000000000000000000000000000000XD--TTTT--------00000000000000000000000000000000000
000000000000000000000000000000000000XD--------------00000000000000000000000000000000000
000000000000000000000000000000000000XTTTT-----------00000000000000000000000000000000000
000000000000000000000000000000000000----------------00000000000000000000000000000000000
000000000000000000000000000000000000---TTTT---------00000000000000000000000000000000000
000000000000000000000000000000000000----------------00000000000000000000000000000000000
000000000000000000000000000000000000----------------00000000000000000000000000000000000
000000000000000000000000000000000000XX-----TTTT---XX00000000000000000000000000000000000
000000000000000000000000000000000000XX------------XX00000000000000000000000000000000000
000000000000000000000000000000000000XX------------XX00000000000000000000000000000000000
000000000000000000000000000000000000XX--------XXXXXX00000000000000000000000000000000000
000000000000000000000000000000000000XX------------XX00000000000000000000000000000000000
000000000000000000000000000000000000XD------------XX00000000000000000000000000000000000
000000000000000000000000000000000000XD-------------X00000000000000000000000000000000000
000000000000000000000000000000000000TTTTXXXXXXXX--DX00000000000000000000000000000000000
000000000000000000000000000000000000--TTTTTTTT----DX00000000000000000000000000000000000
000000000000000000000000000000000000---------TTTTTTT00000000000000000000000000000000000
000000000000000000000000000000000000---------------X00000000000000000000000000000000000
000000000000000000000000000000000000----------------00000000000000000000000000000000000
000000000000000000000000000000000000----------------00000000000000000000000000000000000
000000000000000000000000000000000000---------XXXXXXX00000000000000000000000000000000000
000000000000000000000000000000000000----------------00000000000000000000000000000000000
000000000000000000000000000000000000------XXXX------00000000000000000000000000000000000
000000000000000000000000000000000000----------------00000000000000000000000000000000000
000000000000000000000000000000000000---------TTT----00000000000000000000000000000000000
000000000000000000000000000000000000----------------00000000000000000000000000000000000
000000000000000000000000000000000000X-----------TTTT00000000000000000000000000000000000
000000000000000000000000000000000000X--------------X00000000000000000000000000000000000
000000000000000000000000000000000000X--------------X00000000000000000000000000000000000
000000000000000000000000000000000000XXXXXXXXX------X00000000000000000000000000000000000
000000000000000000000000000000000000XX-------------X00000000000000000000000000000000000
000000000000000000000000000000000000XX---------TTTTT00000000000000000000000000000000000
000000000000000000000000000000000000XD-------------X00000000000000000000000000000000000
000000000000000000000000000000000000XD-------------X00000000000000000000000000000000000
000000000000000000000000000000000000TTTTXXXXXXXX--DX00000000000000000000000000000000000
000000000000000000000000000000000000--TTTTTTTT----DX00000000000000000000000000000000000
000000000000000000000000000000000000---------TTTTTTT00000000000000000000000000000000000
000000000000000000000000000000000000-----X----------00000000000000000000000000000000000
000000000000000000000000000000000000TTTT------------00000000000000000000000000000000000
000000000000000000000000000000000000----------------00000000000000000000000000000000000
000000000000000000000000000000000000----------------00000000000000000000000000000000000
000000000000000000000000000000000000------TTT-------00000000000000000000000000000000000
000000000000000000000000000000000000----------------00000000000000000000000000000000000
000000000000000000000000000000000000---------TTT----00000000000000000000000000000000000
000000000000000000000000000000000000----------------00000000000000000000000000000000000
000000000000000000000000000000000000X-----------TTTT00000000000000000000000000000000000
000000000000000000000000000000000000X--------------X00000000000000000000000000000000000
000000000000000000000000000000000000X--------------X00000000000000000000000000000000000
000000000000000000000000000000000000XXXXXXXXX------X00000000000000000000000000000000000
000000000000000000000000000000000000XX-------------X00000000000000000000000000000000000
000000000000000000000000000000000000XX--------TTTTTT00000000000000000000000000000000000
000000000000000000000000000000000000XD-------------X00000000000000000000000000000000000
000000000000000000000000000000000000XD-------------X00000000000000000000000000000000000
000000000000000000000000000000000000XD-------------X00000000000000000000000000000000000
000000000000000000000000000000000000TTTTXXXXXXXX--DX00000000000000000000000000000000000
000000000000000000000000000000000000--TTTTTTTT----DX00000000000000000000000000000000000
000000000000000000000000000000000000---------TTTTTTT00000000000000000000000000000000000
000000000000000000000000000000000000--XX------------00000000000000000000000000000000000
000000000000000000000000000000000000XXXXMMMMMMMMMMMM00000000000000000000000000000000000
000000000000000000000000000000000000XXXX------------00000000000000000000000000000000000
000000000000000000000000000000000000----------------00000000000000000000000000000000000
000000000000000000000000000000000000---TTTT---------00000000000000000000000000000000000
000000000000000000000000000000000000----------------00000000000000000000000000000000000
000000000000000000000000000000000000----------------00000000000000000000000000000000000
000000000000000000000000000000000000XX-----TTTT---XX00000000000000000000000000000000000
000000000000000000000000000000000000XX------------XX00000000000000000000000000000000000
000000000000000000000000000000000000XX------------XX00000000000000000000000000000000000
000000000000000000000000000000000000XXXXXX----XXXXXX00000000000000000000000000000000000
000000000000000000000000000000000000XX------------XX00000000000000000000000000000000000
000000000000000000000000000000000000XX------------XX00000000000000000000000000000000000
000000000000000000000000000000000000XX----XXXXX---XX00000000000000000000000000000000000
000000000000000000000000000000000000XX------------XX00000000000000000000000000000000000
000000000000000000000000000000000000XD------------XX00000000000000000000000000000000000
000000000000000000000000000000000000XD-------------X00000000000000000000000000000000000
000000000000000000000000000000000000TTTTXXXXXXXX--DX00000000000000000000000000000000000
000000000000000000000000000000000000--TTTTTTTT----DX00000000000000000000000000000000000
000000000000000000000000000000000000---------TTTTTTT00000000000000000000000000000000000
000000000000000000000000000000000000-------X--------00000000000000000000000000000000000
000000000000000000000000000000000000---------------T00000000000000000000000000000000000
000000000000000000000000000000000000----------------00000000000000000000000000000000000
000000000000000000000000000000000000----------------00000000000000000000000000000000000
000000000000000000000000000000000000--------TTTT----00000000000000000000000000000000000
000000000000000000000000000000000000----------------00000000000000000000000000000000000
000000000000000000000000000000000000--TTTTTTTT------00000000000000000000000000000000000
000000000000000000000000000000000000----------------00000000000000000000000000000000000
000000000000000000000000000000000000----------------00000000000000000000000000000000000
000000000000000000000000000000000000XXXX------------00000000000000000000000000000000000
000000000000000000000000000000000000XXXX------------00000000000000000000000000000000000
000000000000000000000000000000000000XXXX--TTTT------00000000000000000000000000000000000
000000000000000000000000000000000000XXXX------------00000000000000000000000000000000000
000000000000000000000000000000000000XX-------------X00000000000000000000000000000000000
000000000000000000000000000000000000XX----------TTTT00000000000000000000000000000000000
000000000000000000000000000000000000XD-------------X00000000000000000000000000000000000
000000000000000000000000000000000000XD-------------X00000000000000000000000000000000000
000000000000000000000000000000000000TTTTXXXXXXXX--DX00000000000000000000000000000000000
000000000000000000000000000000000000--TTTTTTTT----DX00000000000000000000000000000000000
000000000000000000000000000000000000---------TTTTTTT00000000000000000000000000000000000
000000000000000000000000000000000000---------------X00000000000000000000000000000000000
000000000000000000000000000000000000----------------00000000000000000000000000000000000
000000000000000000000000000000000000----------------00000000000000000000000000000000000
000000000000000000000000000000000000------------X---00000000000000000000000000000000000
000000000000000000000000000000000000------------XXXX00000000000000000000000000000000000
000000000000000000000000000000000000------------XXXX00000000000000000000000000000000000
000000000000000000000000000000000000X--------XXXXX--00000000000000000000000000000000000
000000000000000000000000000000000000---------TTTTTTT00000000000000000000000000000000000
000000000000000000000000000000000000X-----------TTTT00000000000000000000000000000000000
000000000000000000000000000000000000X--------------X00000000000000000000000000000000000
000000000000000000000000000000000000X--------------X00000000000000000000000000000000000
000000000000000000000000000000000000XXXXXXXXX------X00000000000000000000000000000000000
000000000000000000000000000000000000XX-------------X00000000000000000000000000000000000
000000000000000000000000000000000000XX--------TTTTTT00000000000000000000000000000000000
000000000000000000000000000000000000XD-------------X00000000000000000000000000000000000
000000000000000000000000000000000000XD-------------X00000000000000000000000000000000000
000000000000000000000000000000000000XD-------------X00000000000000000000000000000000000
000000000000000000000000000000000000TTTTXXXXXXXX--DX00000000000000000000000000000000000
000000000000000000000000000000000000--TTTTTTTT----DX00000000000000000000000000000000000
0000000000000000-----------------------------TTTTTTT00000000000000000000000000000000000
0000000000000000--------------------000000000000000000000000000000000000000000000000000
0000000000000000--------------------000000000000000000000000000000000000000000000000000
0000000000000000--------------------000000000000000000000000000000000000000000000000000
0000000000000000--------------------000000000000000000000000000000000000000000000000000
0000000000000000--------------------000000000000000000000000000000000000000000000000000
0000000000000000--------------------000000000000000000000000000000000000000000000000000
0000000000000000--------------------000000000000000000000000000000000000000000000000000
0000000000000000--------------------000000000000000000000000000000000000000000000000000
0000000000000000--------------------000000000000000000000000000000000000000000000000000
0000000000000000--------------------000000000000000000000000000000000000000000000000000
0000000000000000--------------------000000000000000000000000000000000000000000000000000
0000000000000000--------------------000000000000000000000000000000000000000000000000000
0000000000000000--------------------000000000000000000000000000000000000000000000000000
0000000000000000-----------E--------000000000000000000000000000000000000000000000000000
--XXXX------XXXXXXXXXXXXXXXXXXXXXXX-000000000000000000000000000000000000000000000000000
XXXXE-EXXXXXXX--00000000000000000000000000000000000000000000000000000000000000000000000
XXXX------XXXX--00000000000000000000000000000000000000000000000000000000000000000000000
XX-----------XXX00000000000000000000000000000000000000000000000000000000000000000000000
XX--TT-------XXX00000000000000000000000000000000000000000000000000000000000000000000000
XX-----------XXX00000000000000000000000000000000000000000000000000000000000000000000000
XX-----------XXX00000000000000000000000000000000000000000000000000000000000000000000000
-XXXXXXXE--XXXX-00000000000000000000000000000000000000000000000000000000000000000000000
-XXXX------XXXX-00000000000000000000000000000000000000000000000000000000000000000000000
-XXXX------XXXX-00000000000000000000000000000000000000000000000000000000000000000000000
-XXXX----EXXXXX-00000000000000000000000000000000000000000000000000000000000000000000000
XX----------XXXX00000000000000000000000000000000000000000000000000000000000000000000000
XXXXXXXX----XXXX00000000000000000000000000000000000000000000000000000000000000000000000
XX-----------XXX00000000000000000000000000000000000000000000000000000000000000000000000
XX----------TTTT00000000000000000000000000000000000000000000000000000000000000000000000
XD-------------X00000000000000000000000000000000000000000000000000000000000000000000000
XD-------------X00000000000000000000000000000000000000000000000000000000000000000000000
TTTTXXXXXXXX--DX00000000000000000000000000000000000000000000000000000000000000000000000
--TTTTTTTT----DX00000000000000000000000000000000000000000000000000000000000000000000000
---------TTTTTTT00000000000000000000000000000000000000000000000000000000000000000000000