0000000000000000000000000000000000000000000000000000000000000000000000000000000000000000000000000000000000000000--------------------000000000000000
0000000000000000000000000000000000000000000000000000000000000000000000000000000000000000000000000000000000000000--------------------000000000000000
0000000000000000000000000000000000000000000000000000000000000000000000000000000000000000000000000000000000000000--------------------000000000000000
0000000000000000000000000000000000000000000000000000000000000000000000000000000000000000000000000000000000000000--------------------000000000000000
0000000000000000000000000000000000000000000000000000000000000000000000000000000000000000000000000000000000000000--------------------000000000000000
0000000000000000000000000000000000000000000000000000000000000000000000000000000000000000000000000000000000000000--------------------000000000000000
0000000000000000000000000000000000000000000000000000000000000000000000000000000000000000000000000000000000000000--------------------000000000000000
0000000000000000000000000000000000000000000000000000000000000000000000000000000000000000000000000000000000000000--------------------000000000000000
0000000000000000000000000000000000000000000000000000000000000000000000000000000000000000000000000000000000000000--------------------000000000000000
0000000000000000000000000000000000000000000000000000000000000000000000000000000000000000000000000000000000000000--------------------000000000000000
0000000000000000000000000000000000000000000000000000000000000000000000000000000000000000000000000000000000000000--------------E-----000000000000000
0000000000000000000000000000000000000000000000000000000000000000000000000000000000000000000000000000000000000000-------------<>-----000000000000000
0000000000000000000000000000000000000000000000000000000000000000000000000000000000000000000000000000000000000000-------------[]-----000000000000000
0000000000000000000000000000000000000000000000000000000000000000000000000000000000000000000000000000000000000000-------------[]-----000000000000000
0000000000000000000000000000000000000000000000000000000000000000000000000000000000000000000000000000000000000000-------------[]-----000000000000000
000000000000000000000000000000000000000000000000000000000000000000000000000000000000000000000000X-------------XXXXXXXXXXXXXXXXXXXXXX000000000000000
000000000000000000000000000000000000000000000000000000000000000000000000000000000000000000000000X-------------XX00000000000000000000000000000000000
000000000000000000000000000000000000000000000000000000000000000000000000000000000000000000000000X-------------XX00000000000000000000000000000000000
000000000000000000000000000000000000000000000000000000000000000000000000000000000000000000000000X-------------DX00000000000000000000000000000000000
000000000000000000000000000000000000000000000000000000000000000000000000000000000000000000000000X-------------XX00000000000000000000000000000000000
000000000000000000000000000000000000000000000000000000000000000000000000000000000000000000000000X-----XXXX----XX00000000000000000000000000000000000
000000000000000000000000000000000000000000000000000000000000000000000000000000000000000000000000X-------------XX00000000000000000000000000000000000
000000000000000000000000000000000000000000000000000000000000000000000000000000000000000000000000X-------------XX00000000000000000000000000000000000
000000000000000000000000000000000000000000000000000000000000000000000000000000000000000000000000X-------------XX00000000000000000000000000000000000
000000000000000000000000000000000000000000000000000000000000000000000000000000000000000000000000X-----XXXX----XX00000000000000000000000000000000000
000000000000000000000000000000000000000000000000000000000000000000000000000000000000000000000000X-------------XX00000000000000000000000000000000000
000000000000000000000000000000000000000000000000000000000000000000000000000000000000000000000000X-------------XX00000000000000000000000000000000000
000000000000000000000000000000000000000000000000000000000000000000000000000000000000000000000000XXXXXXXX------XX00000000000000000000000000000000000
000000000000000000000000000000000000000000000000000000000000000000000000000000000000000000000000XX------------XX00000000000000000000000000000000000
000000000000000000000000000000000000000000000000000000000000000000000000000000000000000000000000XX--------TTTTXX00000000000000000000000000000000000
000000000000000000000000000000000000000000000000000000000000000000000000000000000000000000000000XX------------XX00000000000000000000000000000000000
000000000000000000000000000000000000000000000000000000000000000000000000000000000000000000000000XD------------XX00000000000000000000000000000000000
000000000000000000000000000000000000000000000000000000000000000000000000000000000000000000000000XD------------DX00000000000000000000000000000000000
000000000000000000000000000000000000000000000000000000000000000000000000000000000000000000000000XXXXX-------XXXX00000000000000000000000000000000000
000000000000000000000000000000000000000000000000000000000000000000000000000000000000000000000000XXXXXXXXXXXXXXXX00000000000000000000000000000000000
000000000000000000000000000000000000000000000000000000000000000000000000000000000000000000000000XX------------XX00000000000000000000000000000000000
000000000000000000000000000000000000000000000000000000000000000000000000000000000000000000000000XTTTT---E-----XX00000000000000000000000000000000000
000000000000000000000000000000000000000000000000000000000000000000000000000000000000000000000000XMMMMMMMMMMMMMMM00000000000000000000000000000000000
000000000000000000000000000000000000000000000000000000000000000000000000000000000000000000000000----------------00000000000000000000000000000000000
000000000000000000000000000000000000----------------------------------------------------------------E--------E--00000000000000000000000000000000000
000000000000000000000000000000000000------------------------------------------------------------MMMMMMMMMMMMMMMM00000000000000000000000000000000000
000000000000000000000000000000000000----------------------------------------------------------------------------00000000000000000000000000000000000
000000000000000000000000000000000000----------------------------------------------------------------------------00000000000000000000000000000000000
000000000000000000000000000000000000----------------------------------------------------------------------------00000000000000000000000000000000000
000000000000000000000000000000000000------------------------------------------------------------TTTTTTTT--------00000000000000000000000000000000000
000000000000000000000000000000000000---------------------------------------------------------------------TTTT---00000000000000000000000000000000000
000000000000000000000000000000000000--------------------------------------------------XXX-----------------------00000000000000000000000000000000000
000000000000000000000000000000000000-------------------------------------------------XXXX-------XXXXX-------XXXX00000000000000000000000000000000000
000000000000000000000000000000000000-------------------------------------------------XXXX-------XX--------------00000000000000000000000000000000000
000000000000000000000000000000000000------------------------------------------------XXXXX-------XX--------------00000000000000000000000000000000000
000000000000000000000000000000000000-----------E------------------------X----------XXXXXX-------XX--------TTT---00000000000000000000000000000000000
000000000000000000000000000000000000----------<>------------------------X---------XXXXXXX-------XD--------------00000000000000000000000000000000000
000000000000000000000000000000000000----------[]------------------------X--------XXXXXXXX-------XD-------------X00000000000000000000000000000000000
000000000000000000000000000000000000----------[]--------------------EE-EXXX-----XXXXXXXXX---XX--XXXXX-------XXXX00000000000000000000000000000000000
00000000000000000000-----------TTTTTXXXXXXXXXXXXXXXXXXX-XXXXXXXXXXXXXXXXXXXXXXXXXXXXXXXXXXXXXXXXXXXXXXXXXXXXXXXX00000000000000000000000000000000000
00000000000000000000---XXXXXX----XXX000000000000000000000000000000000000000000000000000000000000000000000000000000000000000000000000000000000000000
00000000000000000000XXXXXXXXXXXXXXXX000000000000000000000000000000000000000000000000000000000000000000000000000000000000000000000000000000000000000
00000000000000000000XXXXXXXXXXXXXXXX000000000000000000000000000000000000000000000000000000000000000000000000000000000000000000000000000000000000000
00000000000000000000XXXX----------XX000000000000000000000000000000000000000000000000000000000000000000000000000000000000000000000000000000000000000
00000000000000000000XXXX----------XX000000000000000000000000000000000000000000000000000000000000000000000000000000000000000000000000000000000000000
00000000000000000000XXXX----------X-000000000000000000000000000000000000000000000000000000000000000000000000000000000000000000000000000000000000000
00000000000000000000XXXX------------000000000000000000000000000000000000000000000000000000000000000000000000000000000000000000000000000000000000000
00000000000000000000XXXX------------000000000000000000000000000000000000000000000000000000000000000000000000000000000000000000000000000000000000000
00000000000000000000XX-X------------000000000000000000000000000000000000000000000000000000000000000000000000000000000000000000000000000000000000000
00000000000000000000X---TT-----TTTTT000000000000000000000000000000000000000000000000000000000000000000000000000000000000000000000000000000000000000
00000000000000000000X--------------X000000000000000000000000000000000000000000000000000000000000000000000000000000000000000000000000000000000000000
00000000000000000000X--------------X000000000000000000000000000000000000000000000000000000000000000000000000000000000000000000000000000000000000000
00000000000000000000XXXXXXXXX------X000000000000000000000000000000000000000000000000000000000000000000000000000000000000000000000000000000000000000
00000000000000000000XX-------------X000000000000000000000000000000000000000000000000000000000000000000000000000000000000000000000000000000000000000
00000000000000000000XX--------TTTTTT000000000000000000000000000000000000000000000000000000000000000000000000000000000000000000000000000000000000000
00000000000000000000XD-------------X000000000000000000000000000000000000000000000000000000000000000000000000000000000000000000000000000000000000000
00000000000000000000XD-------------X000000000000000000000000000000000000000000000000000000000000000000000000000000000000000000000000000000000000000
00000000000000000000XXXXX-------XXXX000000000000000000000000000000000000000000000000000000000000000000000000000000000000000000000000000000000000000
00000000000000000000XXXXXXXXXXXXXXXX000000000000000000000000000000000000000000000000000000000000000000000000000000000000000000000000000000000000000
00000000000000000000-------TTT------000000000000000000000000000000000000000000000000000000000000000000000000000000000000000000000000000000000000000
00000000000000000000----------------000000000000000000000000000000000000000000000000000000000000000000000000000000000000000000000000000000000000000
00000000000000000000----------------000000000000000000000000000000000000000000000000000000000000000000000000000000000000000000000000000000000000000
00000000000000000000--------TTTT----000000000000000000000000000000000000000000000000000000000000000000000000000000000000000000000000000000000000000
00000000000000000000----------------000000000000000000000000000000000000000000000000000000000000000000000000000000000000000000000000000000000000000
00000000000000000000X--------------X000000000000000000000000000000000000000000000000000000000000000000000000000000000000000000000000000000000000000
00000000000000000000X--------------X000000000000000000000000000000000000000000000000000000000000000000000000000000000000000000000000000000000000000
00000000000000000000X----------XXXXX000000000000000000000000000000000000000000000000000000000000000000000000000000000000000000000000000000000000000
00000000000000000000X--------XXXXXXX000000000000000000000000000000000000000000000000000000000000000000000000000000000000000000000000000000000000000
00000000000000000000XXXX-----TTTTTTT000000000000000000000000000000000000000000000000000000000000000000000000000000000000000000000000000000000000000
00000000000000000000XXXX--------XXXX000000000000000000000000000000000000000000000000000000000000000000000000000000000000000000000000000000000000000
00000000000000000000XXXX--------XXXX000000000000000000000000000000000000000000000000000000000000000000000000000000000000000000000000000000000000000
00000000000000000000XXXXXXX-----XXXX000000000000000000000000000000000000000000000000000000000000000000000000000000000000000000000000000000000000000
00000000000000000000XXXX--------XXXX000000000000000000000000000000000000000000000000000000000000000000000000000000000000000000000000000000000000000
00000000000000000000XX------------XX000000000000000000000000000000000000000000000000000000000000000000000000000000000000000000000000000000000000000
00000000000000000000XX----XXXXX---XX000000000000000000000000000000000000000000000000000000000000000000000000000000000000000000000000000000000000000
00000000000000000000XD------------XX000000000000000000000000000000000000000000000000000000000000000000000000000000000000000000000000000000000000000
00000000000000000000XD------------XX000000000000000000000000000000000000000000000000000000000000000000000000000000000000000000000000000000000000000
00000000000000000000XXXXX-------XXXX000000000000000000000000000000000000000000000000000000000000000000000000000000000000000000000000000000000000000
00000000000000000000XXXXXXXXXXXXXXXX000000000000000000000000000000000000000000000000000000000000000000000000000000000000000000000000000000000000000
00000000000000000000----------------000000000000000000000000000000000000000000000000000000000000000000000000000000000000000000000000000000000000000
00000000000000000000----------------000000000000000000000000000000000000000000000000000000000000000000000000000000000000000000000000000000000000000
00000000000000000000----------X-----000000000000000000000000000000000000000000000000000000000000000000000000000000000000000000000000000000000000000
00000000000000000000---------X------000000000000000000000000000000000000000000000000000000000000000000000000000000000000000000000000000000000000000
00000000000000000000---------X------000000000000000000000000000000000000000000000000000000000000000000000000000000000000000000000000000000000000000
00000000000000000000----------------000000000000000000000000000000000000000000000000000000000000000000000000000000000000000000000000000000000000000
00000000000000000000-------X---X----000000000000000000000000000000000000000000000000000000000000000000000000000000000000000000000000000000000000000
00000000000000000000----------------000000000000000000000000000000000000000000000000000000000000000000000000000000000000000000000000000000000000000
00000000000000000000----X-----------000000000000000000000000000000000000000000000000000000000000000000000000000000000000000000000000000000000000000
------------------------------------000000000000000000000000000000000000000000000000000000000000000000000000000000000000000000000000000000000000000
------------------------------------000000000000000000000000000000000000000000000000000000000000000000000000000000000000000000000000000000000000000
------------------------------------000000000000000000000000000000000000000000000000000000000000000000000000000000000000000000000000000000000000000
------------------------XXXXXXXX----000000000000000000000000000000000000000000000000000000000000000000000000000000000000000000000000000000000000000
-----------------------------XXXX---000000000000000000000000000000000000000000000000000000000000000000000000000000000000000000000000000000000000000
--------------------XXXX-----TTTTTTT000000000000000000000000000000000000000000000000000000000000000000000000000000000000000000000000000000000000000
--------------------XXXX--------XXXX000000000000000000000000000000000000000000000000000000000000000000000000000000000000000000000000000000000000000
--------------------XD--------------000000000000000000000000000000000000000000000000000000000000000000000000000000000000000000000000000000000000000
--------------------XD-------------X000000000000000000000000000000000000000000000000000000000000000000000000000000000000000000000000000000000000000
--------------------XXXXX-------XXXX000000000000000000000000000000000000000000000000000000000000000000000000000000000000000000000000000000000000000
-------------------EXXXXXXXXXXXXXXXX000000000000000000000000000000000000000000000000000000000000000000000000000000000000000000000000000000000000000
--------XX--------<>0000000000000000000000000000000000000000000000000000000000000000000000000000000000000000000000000000000000000000000000000000000
-------XXX--------[]0000000000000000000000000000000000000000000000000000000000000000000000000000000000000000000000000000000000000000000000000000000
------XXXXX-------[]0000000000000000000000000000000000000000000000000000000000000000000000000000000000000000000000000000000000000000000000000000000
------XXX-X-------[]0000000000000000000000000000000000000000000000000000000000000000000000000000000000000000000000000000000000000000000000000000000
XXXXXXXXX-XXXXXXXXXX0000000000000000000000000000000000000000000000000000000000000000000000000000000000000000000000000000000000000000000000000000000
000000000000000000000000000000000000000000000000000000000000000000000000000000000000000000000000000000000000000000000000000000000000000000000000000