-------------------------------------------------------------00000000000000000000000000000000000000000000000000000000000000000000000000000000000000000000000000000000000000000000000000000000000000000000000000000000000000000000
-------------------------------------------------------------0000000000000000-------------------------------------------------------------------------------------------------------------------------------------000000000000000
-------------------------------------------------------------0000000000000000-------------------------------------------------------------------------------------------------------------------------------------000000000000000
-------------------------------------------------------------0000000000000000-------------------------------------------------------------------------------------------------------------------------------------000000000000000
-------------------------------------------------------------0000000000000000-------------------------------------------------------------------------------------------------------------------------------------000000000000000
-------------------------------------------------------------0000000000000000--------------------------------------------------------------------------------------------------------------------------------E----000000000000000
-------------------------------------------------------------0000000000000000-------------------------------------------------------------------------------------------------------------------------------------000000000000000
-------------------------------------------------------------------XX--------X------------------------------------------------------------------------------------------------------------------------------------000000000000000
-------------------------------------------------------------------XX--------X------------------------------------------------------------------------------------------------------------------------------------000000000000000
-------------------------------------------------------------XXXXXXXX----XXXXX------------------------------------------------------------------------------------------------------------XX----------------------000000000000000
-------------------E---------------------------------------------------------X------------------------------------------------------------------------------------------------------------------------------------000000000000000
------------------<>-------------------------------------E-------------------X------------------------------------------------------------------------------------------------------------------------------------000000000000000
------------------[]----------------------------------------X------------XXX-X---------------------E----------------------------------------------ESS------------SS---------------------X-------------------------000000000000000
------------------[]----------------------------------------X0000000000000000X---------------------------------------------------------------------------------------------------------XX--X---------------------X000000000000000
------------------[]------------------E------------E------XXX0000000000000000X--------------------------------------------------------------------------------------------------------XXX-----------------------XX000000000000000
XXXXXXXXXXXXXXXXXXXXXXXXXXXXXXXXXXXXXXXXXXXXXXXXXXXXXXXXXXXXX0000000000000000X-----E--------------------------------EE-----------E--------------------------------------------------XXXXX----------------------XXX000000000000000
00000000000000000000000000000000000000000000000000000000000000000000000000000XXXXXXXXXXXXXXXXXXXXXXXXXXXXXXXXXXXXXXXXXXXXXXXXXXXXXXXXXXXXXXXXXXXXXXXXXXXXXXXXXXXXXXXXXXXXXXXXXXXXXXXXXXXXXXXXXXXXXXXXXXXXXXXXXXXXX000000000000000
000000000000000000000000000000000000000000000000000000000000000000000000000000000000000000000000000000000000000000000000000000000000000000000000000000000000000000000000000000000000000000000000000000000000000000000000000000000