000000000000000000000000000000000000000000000----------------------------------------------------------------------------------------------------------------------------------------------------------------000000000000000
000000000000000000000000000000000000000000000----------------------------------------------------------------------------------------------------------------------------------------------------------------000000000000000
000000000000000000000000000000000000000000000----------------------------------------------------------------------------------------------------------------------------------------------------------------000000000000000
000000000000000000000000000000000000000000000----------------------------------------------------------------------------------------------------------------------------------------------------------------000000000000000
000000000000000000000000000000000000000000000----------------------------------------------------------------------------------------------------------------------------------------------------------------000000000000000
000000000000000000000000000000000000000000000----------------------------------------------------------------------------------------------------------------------------------------------------------------000000000000000
000000000000000000000000000000000000000000000----------------------------------------------------------------------------------------------------------------------------------------------------------------000000000000000
000000000000000000000000000000000000000000000---------------------------------------------------------S------------------------------------------------------------------------------------------------------000000000000000
000000000000000000000000000000000000000000000----------------------------------------------------------------------------------------------------------------------------------------------------------------000000000000000
000000000000000000000000000000000000000000000-------------------------------------------------------------------------------------------------------------------------X---X-----------------------X----------000000000000000
000000000000000000000000000000000000000000000---------------------------------------------------------------------------E-----------------------------E---------------X-----------E--------------XX----------000000000000000
000000000000000000000000000000000000000000000-----------------------------------------------------------------X--------<>----------------------------<>--------------XXX---------<>-------------XXX----------000000000000000
000000000000000000000000000000000000000000000----------------------------------------------------------------->--------[]----------------------------[]-------------XXXXX--------[]------------XXXX----------000000000000000
000000000000000000000000000000000000000000000----------------------------------------------------------------<]--------[]----------------------------[]------------XXXXXX--------[]-----------XXXXX----------000000000000000
00000000000000000000000000000---------------------E-E------------------E--E--------E-----------------------E-[]-EE----X[]----------------------------[]-----------XXXXXXX--------[]----------XXXXXX----------000000000000000
00000000000000000000000000000----------------X--XXXXXXXXXXXXXXXXXXXXXXXXXXXXXXXXXXXXXXXXXXXXXXXXXXXXXXXXXXXXXXXXXXXXXXXXXXXXXXXXXXXXXXXXXXX-XXXXXXXXXXXXXXXXXXXXXXXXXXXXXXXXXXXXXXXXXXXXXXXXXXXXXXXXXXXXXXXXX000000000000000
00000000000000000000000000000-----TTTTT------0000000000000000000000000000000000000000000000000000000000000000000000000000000000000000000000000000000000000000000000000000000000000000000000000000000000000000000000000000000
00000000000000000000000000000----------------0000000000000000000000000000000000000000000000000000000000000000000000000000000000000000000000000000000000000000000000000000000000000000000000000000000000000000000000000000000
00000000000000000000000000000----------------0000000000000000000000000000000000000000000000000000000000000000000000000000000000000000000000000000000000000000000000000000000000000000000000000000000000000000000000000000000
00000000000000000000000000000---TTTT--TTTT---0000000000000000000000000000000000000000000000000000000000000000000000000000000000000000000000000000000000000000000000000000000000000000000000000000000000000000000000000000000
00000000000000000000000000000----------------0000000000000000000000000000000000000000000000000000000000000000000000000000000000000000000000000000000000000000000000000000000000000000000000000000000000000000000000000000000
00000000000000000000000000000----------------0000000000000000000000000000000000000000000000000000000000000000000000000000000000000000000000000000000000000000000000000000000000000000000000000000000000000000000000000000000
00000000000000000000000000000------TTTT------0000000000000000000000000000000000000000000000000000000000000000000000000000000000000000000000000000000000000000000000000000000000000000000000000000000000000000000000000000000
00000000000000000000000000000------------TTTT0000000000000000000000000000000000000000000000000000000000000000000000000000000000000000000000000000000000000000000000000000000000000000000000000000000000000000000000000000000
-------------------------------------------X-0000000000000000000000000000000000000000000000000000000000000000000000000000000000000000000000000000000000000000000000000000000000000000000000000000000000000000000000000000000
-----------------------------00000000000000000000000000000000000000000000000000000000000000000000000000000000000000000000000000000000000000000000000000000000000000000000000000000000000000000000000000000000000000000000000
-----------------------------00000000000000000000000000000000000000000000000000000000000000000000000000000000000000000000000000000000000000000000000000000000000000000000000000000000000000000000000000000000000000000000000
-----------------------------00000000000000000000000000000000000000000000000000000000000000000000000000000000000000000000000000000000000000000000000000000000000000000000000000000000000000000000000000000000000000000000000
-----------------------------00000000000000000000000000000000000000000000000000000000000000000000000000000000000000000000000000000000000000000000000000000000000000000000000000000000000000000000000000000000000000000000000
-----------------------------00000000000000000000000000000000000000000000000000000000000000000000000000000000000000000000000000000000000000000000000000000000000000000000000000000000000000000000000000000000000000000000000
-----------------------------00000000000000000000000000000000000000000000000000000000000000000000000000000000000000000000000000000000000000000000000000000000000000000000000000000000000000000000000000000000000000000000000
-----------------------------00000000000000000000000000000000000000000000000000000000000000000000000000000000000000000000000000000000000000000000000000000000000000000000000000000000000000000000000000000000000000000000000
-----------------------------00000000000000000000000000000000000000000000000000000000000000000000000000000000000000000000000000000000000000000000000000000000000000000000000000000000000000000000000000000000000000000000000
-----------------------------00000000000000000000000000000000000000000000000000000000000000000000000000000000000000000000000000000000000000000000000000000000000000000000000000000000000000000000000000000000000000000000000
--------------------------E--00000000000000000000000000000000000000000000000000000000000000000000000000000000000000000000000000000000000000000000000000000000000000000000000000000000000000000000000000000000000000000000000
----------X--------------<>--00000000000000000000000000000000000000000000000000000000000000000000000000000000000000000000000000000000000000000000000000000000000000000000000000000000000000000000000000000000000000000000000
----------X--------------[]--00000000000000000000000000000000000000000000000000000000000000000000000000000000000000000000000000000000000000000000000000000000000000000000000000000000000000000000000000000000000000000000000
----------X--------------[]--00000000000000000000000000000000000000000000000000000000000000000000000000000000000000000000000000000000000000000000000000000000000000000000000000000000000000000000000000000000000000000000000
-------E--X-----E--------[]--00000000000000000000000000000000000000000000000000000000000000000000000000000000000000000000000000000000000000000000000000000000000000000000000000000000000000000000000000000000000000000000000
XXXXXXXXXXXXXXXXXXXXXXXXXXX--00000000000000000000000000000000000000000000000000000000000000000000000000000000000000000000000000000000000000000000000000000000000000000000000000000000000000000000000000000000000000000000000
0000000000000000000000000000000000000000000000000000000000000000000000000000000000000000000000000000000000000000000000000000000000000000000000000000000000000000000000000000000000000000000000000000000000000000000000000000