00000000000000000000000000000000000000000000000000000000000000000000000000000000000000000000000000000000000000000000000000000000----------------
00000000000000000000000000000000000000000000000000000000000000000000000000000000000000000000000000000000000000000000000000000000--TTTTTTTT------
00000000000000000000000000000000000000000000000000000000000000000000000000000000000000000000000000000000000000000000000000000000----------------
00000000000000000000000000000000000000000000000000000000000000000000000000000000000000000000000000000000000000000000000000000000----------------
00000000000000000000000000000000000000000000000000000000000000000000000000000000000000000000000000000000000000000000000000000000---X------------
00000000000000000000000000000000000000000000000000000000000000000000000000000000000000000000000000000000000000000000000000000000---------X------
00000000000000000000000000000000000000000000000000000000000000000000000000000000000000000000000000000000000000000000000000000000----------------
00000000000000000000000000000000000000000000000000000000000000000000000000000000000000000000000000000000000000000000000000000000-----X----------
00000000000000000000000000000000000000000000000000000000000000000000000000000000000000000000000000000000000000000000000000000000-----------X----
00000000000000000000000000000000000000000000000000000000000000000000000000000000000000000000000000000000000000000000000000000000----------------
00000000000000000000000000000000000000000000000000000000000000000000000000000000000000000000000000000000000000000000000000000000----------------
00000000000000000000000000000000000000000000000000000000000000000000000000000000000000000000000000000000000000000000000000000000XXXX------------
00000000000000000000000000000000000000000000000000000000000000000000000000000000000000000000000000000000000000000000000000000000XXXX------------
00000000000000000000000000000000000000000000000000000000000000000000000000000000000000000000000000000000000000000000000000000000XXXX--TTTT------
00000000000000000000000000000000000000000000000000000000000000000000000000000000000000000000000000000000000000000000000000000000XXXX------------
00000000000000000000000000000000000000000000000000000000000000000000000000000000000000000000000000000000000000000000000000000000XX-------------X
00000000000000000000000000000000000000000000000000000000000000000000000000000000000000000000000000000000000000000000000000000000XX----------TTTT
00000000000000000000000000000000000000000000000000000000000000000000000000000000000000000000000000000000000000000000000000000000XD-------------X
00000000000000000000000000000000000000000000000000000000000000000000000000000000000000000000000000000000000000000000000000000000XD-------------X
00000000000000000000000000000000000000000000000000000000000000000000000000000000000000000000000000000000000000000000000000000000XXXXXXXXXXX-----
00000000000000000000000000000000000000000000000000000000000000000000000000000000000000000000000000000000000000000000000000000000----------------
00000000000000000000000000000000000000000000000000000000000000000000000000000000000000000000000000000000000000000000000000000000--TTTTTTTT------
00000000000000000000000000000000000000000000000000000000000000000000000000000000000000000000000000000000000000000000000000000000----------------
00000000000000000000000000000000000000000000000000000000000000000000000000000000000000000000000000000000000000000000000000000000----------------
00000000000000000000000000000000000000000000000000000000000000000000000000000000000000000000000000000000000000000000000000000000XXXX--------XXXX
00000000000000000000000000000000000000000000000000000000000000000000000000000000000000000000000000000000000000000000000000000000----------------
00000000000000000000000000000000000000000000000000000000000000000000000000000000000000000000000000000000000000000000000000000000----------------
000000000000000000000000000000000000000000000000000000000000000000000000000000000000000000000000000000000000-------------------------TTTT-------
000000000000000000000000000000000000000000000000000000000000000000000000000000000000000000000000000000000000------------------------------------
000000000000000000000000000000000000000000000000000000000000000000000000000000000000000000000000000000000000-----------------------------TTT----
000000000000000000000000000000000000000000000000000000000000000000000000000000000000000000000000000000000000------------------------------------
000000000000000000000000000000000000000000000000000000000000000000000000000000000000000000000000000000000000--------------------X-----------TTTT
000000000000000000000000000000000000000000000000000000000000000000000000000000000000000000000000000000000000--------------------X--------------X
000000000000000000000000000000000000000000000000000000000000000000000000000000000000000000000000000000000000--------------------X--------------X
000000000000000000000000000000000000000000000000000000000000000000000000000000000000000000000000000000000000--------------------XXXXXXXXX------X
000000000000000000000000000000000000000000000000000000000000000000000000000000000000000000000000000000000000--------------------XX-------------X
000000000000000000000000000000000000000000000000000000000000000000000000000000000000000000000000000000000000--------------------XX--------TTTTTT
000000000000000000000000000000000000000000000000000000000000000000000000000000000000000000000000000000000000--------------------XD-------------X
000000000000000000000000000000000000000000000000000000000000000000000000000000000000000000000000000000000000--------------------XD-------------X
000000000000000000000000000000000000000000000000000000000000000000000000000000000000000000000000000000000000-------------------<XXXXXXXXXXX-----
000000000000000000000000000000000000000000000000000000000000000000000000000000000000000000000000000000000000-------------------[0000000000000000
000000000000000000000000000000000000000000000000000000000000000000000000000000000000000000000000000000000000----------------E--[0000000000000000
00000000000000000000000000000000000000000000000000000000000000000000000000000000000000000000-TTTT------TTTTTXXXXXXXXXXXXXXXXXXX[0000000000000000
00000000000000000000000000000000000000000000000000000000000000000000000000000000000000000000X---------------000000000000000000000000000000000000
00000000000000000000000000000000000000000000000000000000000000000000000000000000000000000000X---------------000000000000000000000000000000000000
00000000000000000000000000000000000000000000000000000000000000000000000000000000000000000000X------TTTT-----000000000000000000000000000000000000
00000000000000000000000000000000000000000000000000000000000000000000000000000000000000000000X---------------000000000000000000000000000000000000
00000000000000000000000000000000000000000000000000000000000000000000000000000000000000000000XX--------------000000000000000000000000000000000000
00000000000000000000000000000000000000000000000000000000000000000000000000000000000000000000XD--TTTT--------000000000000000000000000000000000000
00000000000000000000000000000000000000000000000000000000000000000000000000000000000000000000XD--------------000000000000000000000000000000000000
00000000000000000000000000000000000000000000000000000000000000000000000000000000000000000000XTTTT-----------000000000000000000000000000000000000
00000000000000000000000000000000000000000000000000000000000000000000000000000000000000000000----------------000000000000000000000000000000000000
00000000000000000000000000000000000000000000000000000000000000000000000000000000000000000000---TTTT---------000000000000000000000000000000000000
00000000000000000000000000000000000000000000000000000000000000000000000000000000000000000000XX--------------000000000000000000000000000000000000
00000000000000000000000000000000000000000000000000000000000000000000000000000000000000000000XX--------------000000000000000000000000000000000000
00000000000000000000000000000000000000000000000000000000000000000000000000000000000000000000XXXX--TTTT------000000000000000000000000000000000000
0000000000000000000000000000000000000000000000000000----------------------------------------XXXX------------000000000000000000000000000000000000
0000000000000000000000000000000000000000000000000000----------------------------------------XX-------------X000000000000000000000000000000000000
0000000000000000000000000000000000000000000000000000----------------------------------------XX----------TTTT000000000000000000000000000000000000
0000000000000000000000000000000000000000000000000000----------------------------------------XD-------------X000000000000000000000000000000000000
0000000000000000000000000000000000000000000000000000--------------------------SSSSSSSSSSSSS-XD-------------X000000000000000000000000000000000000
0000000000000000000000000000000000000000000000000000---------------------------------------SXXXXXXXXXXX-----000000000000000000000000000000000000
0000000000000000000000000000000000000000000000000000----------------------------------------0000000000000000000000000000000000000000000000000000
0000000000000000000000000000000000000000000000000000------------XX------------o-------------0000000000000000000000000000000000000000000000000000
0000000000000000000000000000000000000000000000000000----------------------------------------0000000000000000000000000000000000000000000000000000
0000000000000000000000000000000000000000000000000000--------------------------SS------------0000000000000000000000000000000000000000000000000000
0000000000000000000000000000000000000000000000000000---------------------------S------------0000000000000000000000000000000000000000000000000000
0000000000000000000000000000000000000000000000000000---------------------------S------------0000000000000000000000000000000000000000000000000000
0000000000000000000000000000000000000000000000000000--------X-------------------------------0000000000000000000000000000000000000000000000000000
000000000000000000000000000000000000-XXXXXX-XX-------------XXX---------X--------------------0000000000000000000000000000000000000000000000000000
000000000000000000000000000000000000----------------------XXXXX----E-E-X--------------------0000000000000000000000000000000000000000000000000000
000000000000000000000000000000000000----------------XXXXXXXXXXXXXXXXXXXXXX----X--XXXXXXX--X-0000000000000000000000000000000000000000000000000000
000000000000000000000000000000000000--------TTTT----00000000000000000000000000000000000000000000000000000000000000000000000000000000000000000000
000000000000000000000000000000000000----------------00000000000000000000000000000000000000000000000000000000000000000000000000000000000000000000
000000000000000000000000000000000000--TTTTTTTT------00000000000000000000000000000000000000000000000000000000000000000000000000000000000000000000
000000000000000000000000000000000000----------------00000000000000000000000000000000000000000000000000000000000000000000000000000000000000000000
000000000000000000000000000000000000----------------00000000000000000000000000000000000000000000000000000000000000000000000000000000000000000000
000000000000000000000000000000000000--X-------------00000000000000000000000000000000000000000000000000000000000000000000000000000000000000000000
000000000000000000000000000000000000--XX------------00000000000000000000000000000000000000000000000000000000000000000000000000000000000000000000
000000000000000000000000000000000000--XXXXX---------00000000000000000000000000000000000000000000000000000000000000000000000000000000000000000000
000000000000000000000000000000000000------XX--------00000000000000000000000000000000000000000000000000000000000000000000000000000000000000000000
000000000000000000000000000000000000-----XXXXX------00000000000000000000000000000000000000000000000000000000000000000000000000000000000000000000
000000000000000000000000000000000000--------XX------00000000000000000000000000000000000000000000000000000000000000000000000000000000000000000000
000000000000000000000000000000000000---------XXXXX--00000000000000000000000000000000000000000000000000000000000000000000000000000000000000000000
000000000000000000000000000000000000-----------XX---00000000000000000000000000000000000000000000000000000000000000000000000000000000000000000000
000000000000000000000000000000000000XX----------XXXX00000000000000000000000000000000000000000000000000000000000000000000000000000000000000000000
000000000000000000000000000000000000XD-------------X00000000000000000000000000000000000000000000000000000000000000000000000000000000000000000000
000000000000000000000000000000000000XD-------------X00000000000000000000000000000000000000000000000000000000000000000000000000000000000000000000
0000000000000000--------------------XXXXXXXXXXX-----00000000000000000000000000000000000000000000000000000000000000000000000000000000000000000000
0000000000000000--------------------000000000000000000000000000000000000000000000000000000000000000000000000000000000000000000000000000000000000
0000000000000000--------------------000000000000000000000000000000000000000000000000000000000000000000000000000000000000000000000000000000000000
0000000000000000--------------------000000000000000000000000000000000000000000000000000000000000000000000000000000000000000000000000000000000000
0000000000000000--------------------000000000000000000000000000000000000000000000000000000000000000000000000000000000000000000000000000000000000
0000000000000000--------------------000000000000000000000000000000000000000000000000000000000000000000000000000000000000000000000000000000000000
0000000000000000--------------------000000000000000000000000000000000000000000000000000000000000000000000000000000000000000000000000000000000000
0000000000000000---S------?----S----000000000000000000000000000000000000000000000000000000000000000000000000000000000000000000000000000000000000
0000000000000000--------------------000000000000000000000000000000000000000000000000000000000000000000000000000000000000000000000000000000000000
0000000000000000--------------------000000000000000000000000000000000000000000000000000000000000000000000000000000000000000000000000000000000000
0000000000000000---E----E-----------000000000000000000000000000000000000000000000000000000000000000000000000000000000000000000000000000000000000
0000000000000000--SSS--<>-----------000000000000000000000000000000000000000000000000000000000000000000000000000000000000000000000000000000000000
0000000000000000-------[]-----------000000000000000000000000000000000000000000000000000000000000000000000000000000000000000000000000000000000000
0000000000000000-------[]-----------000000000000000000000000000000000000000000000000000000000000000000000000000000000000000000000000000000000000
0000000000000000-------[]-----------000000000000000000000000000000000000000000000000000000000000000000000000000000000000000000000000000000000000
-----------XXXX-XXXXXXXXXX----XXXXX-000000000000000000000000000000000000000000000000000000000000000000000000000000000000000000000000000000000000
----------XXXX--00000000000000000000000000000000000000000000000000000000000000000000000000000000000000000000000000000000000000000000000000000000
----------XXXX--00000000000000000000000000000000000000000000000000000000000000000000000000000000000000000000000000000000000000000000000000000000
-------E--------00000000000000000000000000000000000000000000000000000000000000000000000000000000000000000000000000000000000000000000000000000000
MMMMMMMMMMMMMMMM00000000000000000000000000000000000000000000000000000000000000000000000000000000000000000000000000000000000000000000000000000000
----------------00000000000000000000000000000000000000000000000000000000000000000000000000000000000000000000000000000000000000000000000000000000
-X--------------00000000000000000000000000000000000000000000000000000000000000000000000000000000000000000000000000000000000000000000000000000000
XX----------XXXX00000000000000000000000000000000000000000000000000000000000000000000000000000000000000000000000000000000000000000000000000000000
XX--------------00000000000000000000000000000000000000000000000000000000000000000000000000000000000000000000000000000000000000000000000000000000
XX--------------00000000000000000000000000000000000000000000000000000000000000000000000000000000000000000000000000000000000000000000000000000000
XXXXMMMMMMMMMMMM00000000000000000000000000000000000000000000000000000000000000000000000000000000000000000000000000000000000000000000000000000000
XXXX------------00000000000000000000000000000000000000000000000000000000000000000000000000000000000000000000000000000000000000000000000000000000
XXXX------------00000000000000000000000000000000000000000000000000000000000000000000000000000000000000000000000000000000000000000000000000000000
XXXX------------00000000000000000000000000000000000000000000000000000000000000000000000000000000000000000000000000000000000000000000000000000000
XXXX------------00000000000000000000000000000000000000000000000000000000000000000000000000000000000000000000000000000000000000000000000000000000
XX-------------X00000000000000000000000000000000000000000000000000000000000000000000000000000000000000000000000000000000000000000000000000000000
XX----------TTTT00000000000000000000000000000000000000000000000000000000000000000000000000000000000000000000000000000000000000000000000000000000
XD-------------X00000000000000000000000000000000000000000000000000000000000000000000000000000000000000000000000000000000000000000000000000000000
XD-------------X00000000000000000000000000000000000000000000000000000000000000000000000000000000000000000000000000000000000000000000000000000000
XXXXXXXXXXX-----00000000000000000000000000000000000000000000000000000000000000000000000000000000000000000000000000000000000000000000000000000000
-X--------------00000000000000000000000000000000000000000000000000000000000000000000000000000000000000000000000000000000000000000000000000000000
X--------------X00000000000000000000000000000000000000000000000000000000000000000000000000000000000000000000000000000000000000000000000000000000
XXXX--------XXXX00000000000000000000000000000000000000000000000000000000000000000000000000000000000000000000000000000000000000000000000000000000
XMMMMMMMMMMMMMXX00000000000000000000000000000000000000000000000000000000000000000000000000000000000000000000000000000000000000000000000000000000
X--------------X00000000000000000000000000000000000000000000000000000000000000000000000000000000000000000000000000000000000000000000000000000000
----------------00000000000000000000000000000000000000000000000000000000000000000000000000000000000000000000000000000000000000000000000000000000
XMMMMMMMMMMMMMMX00000000000000000000000000000000000000000000000000000000000000000000000000000000000000000000000000000000000000000000000000000000
X--------------X00000000000000000000000000000000000000000000000000000000000000000000000000000000000000000000000000000000000000000000000000000000
XE-----------EXX00000000000000000000000000000000000000000000000000000000000000000000000000000000000000000000000000000000000000000000000000000000
XMMMMMMMMMMMMMMX00000000000000000000000000000000000000000000000000000000000000000000000000000000000000000000000000000000000000000000000000000000
----------------00000000000000000000000000000000000000000000000000000000000000000000000000000000000000000000000000000000000000000000000000000000
----------------00000000000000000000000000000000000000000000000000000000000000000000000000000000000000000000000000000000000000000000000000000000
-XXXXMMMMMMMMMMM00000000000000000000000000000000000000000000000000000000000000000000000000000000000000000000000000000000000000000000000000000000
XX----------XXXX00000000000000000000000000000000000000000000000000000000000000000000000000000000000000000000000000000000000000000000000000000000
XXXXXXXX----XXXX00000000000000000000000000000000000000000000000000000000000000000000000000000000000000000000000000000000000000000000000000000000
XX-----------XXX00000000000000000000000000000000000000000000000000000000000000000000000000000000000000000000000000000000000000000000000000000000
XX----------TTTT00000000000000000000000000000000000000000000000000000000000000000000000000000000000000000000000000000000000000000000000000000000
XD-------------X00000000000000000000000000000000000000000000000000000000000000000000000000000000000000000000000000000000000000000000000000000000
XD-------------X00000000000000000000000000000000000000000000000000000000000000000000000000000000000000000000000000000000000000000000000000000000
XXXXXXXXXXX-----00000000000000000000000000000000000000000000000000000000000000000000000000000000000000000000000000000000000000000000000000000000