000000000000000000000000000000000000------TTTT------
000000000000000000000000000000000000----------------
000000000000000000000000000000000000----------------
000000000000000000000000000000000000-----------TTTT-
000000000000000000000000000000000000----------------
000000000000000000000000000000000000----------------
000000000000000000000000000000000000-------------X--
000000000000000000000000000000000000----------------
000000000000000000000000000000000000---------TTT----
000000000000000000000000000000000000----------------
000000000000000000000000000000000000X-----------TTTT
000000000000000000000000000000000000X--------------X
000000000000000000000000000000000000X--------------X
000000000000000000000000000000000000XXXXXXXXX------X
000000000000000000000000000000000000XX-------------X
000000000000000000000000000000000000XX--------TTTTTT
000000000000000000000000000000000000XD-------------X
000000000000000000000000000000000000XD-------------X
000000000000000000000000000000000000XXXXX---XXXXXXXX
000000000000000000000000000000000000XXXXXXXXXXXXXXXX
000000000000000000000000000000000000-X-------------X
000000000000000000000000000000000000X-------------XX
000000000000000000000000000000000000XMMMMMMMMMMMMMXX
000000000000000000000000000000000000XX--------------
000000000000000000000000000000000000XX--------------
000000000000000000000000000000000000XXXX--------XXXX
000000000000000000000000000000000000XXXX--------XXXX
000000000000000000000000000000000000XXXX--------XXXX
000000000000000000000000000000000000X-----------DXXX
000000000000000000000000000000000000X-----------DXXX
000000000000000000000000000000000000X---T--XXXXXXXXX
000000000000000000000000000000000000X--------------X
000000000000000000000000000000000000X--------------X
000000000000000000000000000000000000XXXXXXXXX------X
000000000000000000000000000000000000XX-------------X
000000000000000000000000000000000000XX--------TTTTTT
000000000000000000000000000000000000XD-------------X
000000000000000000000000000000000000XD-------------X
000000000000000000000000000000000000XXXXX---XXXXXXXX
000000000000000000000000000000000000XXXXXXXXXXXXXXXX
000000000000000000000000000000000000----------TTTT--
000000000000000000000000000000000000----------------
000000000000000000000000000000000000XXXX--------XXXX
000000000000000000000000000000000000----------------
000000000000000000000000000000000000--------TTT-----
000000000000000000000000000000000000----------------
000000000000000000000000000000000000----------------
000000000000000000000000000000000000XX------TTTTTTTT
000000000000000000000000000000000000XX-------------X
000000000000000000000000000000000000XX-X-----------X
000000000000000000000000000000000000XX-X-----------X
000000000000000000000000000000000000X--------------X
000000000000000000000000000000000000X--------------X
000000000000000000000000000000000000XXXXXXXXX------X
000000000000000000000000000000000000XX-------------X
000000000000000000000000000000000000XX--------TTTTTT
000000000000000000000000000000000000XD-------------X
000000000000000000000000000000000000XD-------------X
000000000000000000000000000000000000XXXXX---XXXXXXXX
000000000000000000000000000000000000XXXXXXXXXXXXXXXX
000000000000000000000000000000000000-------TTT------
000000000000000000000000000000000000----------------
000000000000000000000000000000000000----------------
000000000000000000000000000000000000----TTTT--------
000000000000000000000000000000000000----------TTT---
000000000000000000000000000000000000----------------
000000000000000000000000000000000000----------------
000000000000000000000000000000000000-------------X--
000000000000000000000000000000000000----------------
000000000000000000000000000000000000----------------
000000000000000000000000000000000000XXXX------------
000000000000000000000000000000000000XXXX------------
000000000000000000000000000000000000XXXX--TTTT------
000000000000000000000000000000000000XXXX------------
000000000000000000000000000000000000XX-------------X
000000000000000000000000000000000000XX----------TTTT
000000000000000000000000000000000000XD-------------X
000000000000000000000000000000000000XD-------------X
000000000000000000000000000000000000XXXXX---XXXXXXXX
000000000000000000000000000000000000XXXXXXXXXXXXXXXX
000000000000000000000000000000000000----------------
000000000000000000000000000000000000----------------
000000000000000000000000000000000000------XXXX------
000000000000000000000000000000000000----------------
000000000000000000000000000000000000---XXXX---------
000000000000000000000000000000000000----------------
000000000000000000000000000000000000----------------
000000000000000000000000000000000000---X------------
000000000000000000000000000000000000----------------
000000000000000000000000000000000000----------------
000000000000000000000000000000000000XXXX------------
000000000000000000000000000000000000XXXX------------
000000000000000000000000000000000000XXXX--TTTT------
000000000000000000000000000000000000XXXX------------
000000000000000000000000000000000000XX-------------X
000000000000000000000000000000000000XX----------TTTT
000000000000000000000000000000000000XD-------------X
000000000000000000000000000000000000XD-------------X
000000000000000000000000000000000000XXXXX---XXXXXXXX
000000000000000000000000000000000000XXXXXXXXXXXXXXXX
000000000000000000000000000000000000-XXXX--------XXX
000000000000000000000000000000000000----------------
000000000000000000000000000000000000---------TTT----
000000000000000000000000000000000000----------------
000000000000000000000000000000000000X-----------TTTT
000000000000000000000000000000000000X--------------X
000000000000000000000000000000000000X--------------X
000000000000000000000000000000000000X-----------XXXX
000000000000000000000000000000000000X-----------DXXX
000000000000000000000000000000000000X-----------DXXX
000000000000000000000000000000000000X---T--XXXXXXXXX
000000000000000000000000000000000000X--------------X
000000000000000000000000000000000000X--------------X
000000000000000000000000000000000000XXXXXXXXX------X
000000000000000000000000000000000000XX-------------X
000000000000000000000000000000000000XX--------TTTTTT
000000000000000000000000000000000000XD-------------X
000000000000000000000000000000000000XD-------------X
000000000000000000000000000000000000XXXXX---XXXXXXXX
000000000000000000000000000000000000XXXXXXXXXXXXXXXX
000000000000000000000000000000000000----------------
000000000000000000000000000000000000--------XXXX----
000000000000000000000000000000000000--------XXXX----
000000000000000000000000000000000000------XXXXXX----
000000000000000000000000000000000000----------------
000000000000000000000000000000000000---XXXX---------
000000000000000000000000000000000000----------------
000000000000000000000000000000000000----------------
000000000000000000000000000000000000----TTTT--------
000000000000000000000000000000000000----------TTT---
000000000000000000000000000000000000----------------
000000000000000000000000000000000000----------------
000000000000000000000000000000000000XX------TTTTTTXX
000000000000000000000000000000000000XX------------XX
000000000000000000000000000000000000XX------------XX
000000000000000000000000000000000000XXXX----------XX
000000000000000000000000000000000000XD-------------X
000000000000000000000000000000000000XD-------------X
000000000000000000000000000000000000XXXXX---XXXXXXXX
000000000000000000000000000000000000XXXXXXXXXXXXXXXX
000000000000000000000000000000000000----------------
000000000000000000000000000000000000----X-----------
000000000000000000000000000000000000----------------
000000000000000000000000000000000000----------------
000000000000000000000000000000000000----TTTT--------
000000000000000000000000000000000000----------TTT---
000000000000000000000000000000000000----------------
000000000000000000000000000000000000----------------
000000000000000000000000000000000000---X------------
000000000000000000000000000000000000-TTTT-----------
000000000000000000000000000000000000----------------
000000000000000000000000000000000000----------------
000000000000000000000000000000000000----TTTT--------
000000000000000000000000000000000000-----------X----
000000000000000000000000000000000000-----------X----
000000000000000000000000000000000000XX----------XXXX
000000000000000000000000000000000000XD-------------X
000000000000000000000000000000000000XD-------------X
000000000000000000000000000000000000XXXXX---XXXXXXXX
0000000000000000--------------------XXXXXXXXXXXXXXXX
0000000000000000--------------------0000000000000000
0000000000000000--------------------0000000000000000
0000000000000000--------------------0000000000000000
0000000000000000--------------------0000000000000000
0000000000000000--------------------0000000000000000
0000000000000000--------------------0000000000000000
0000000000000000--------------------0000000000000000
0000000000000000--------------------0000000000000000
0000000000000000--------------------0000000000000000
0000000000000000-------------E------0000000000000000
0000000000000000------------SS------0000000000000000
0000000000000000--------------------0000000000000000
0000000000000000--------------------0000000000000000
0000000000000000--------------------0000000000000000
----------------XXXXXXXXXXXXXXXXXXX-0000000000000000
----TTTT--------000000000000000000000000000000000000
----------TTT---000000000000000000000000000000000000
----------------000000000000000000000000000000000000
----------------000000000000000000000000000000000000
-----------X----000000000000000000000000000000000000
-----------X----000000000000000000000000000000000000
XX----------XXXX000000000000000000000000000000000000
XXXX-----------X000000000000000000000000000000000000
X------X-------X000000000000000000000000000000000000
X-T------------X000000000000000000000000000000000000
X--------------X000000000000000000000000000000000000
X--------------X000000000000000000000000000000000000
XXXXXXXXX------X000000000000000000000000000000000000
XX-------------X000000000000000000000000000000000000
XX--------TTTTTT000000000000000000000000000000000000
XD-------------X000000000000000000000000000000000000
XD-------------X000000000000000000000000000000000000
XXXXX---XXXXXXXX000000000000000000000000000000000000
XXXXXXXXXXXXXXXX000000000000000000000000000000000000