00000000000000000000000000000000000000000000000000000000000000000000000000000000000000000000----------------
00000000000000000000000000000000000000000000000000000000000000000000000000000000000000000000---XXXX---------
00000000000000000000000000000000000000000000000000000000000000000000000000000000000000000000----------------
00000000000000000000000000000000000000000000000000000000000000000000000000000000000000000000----------------
00000000000000000000000000000000000000000000000000000000000000000000000000000000000000000000----------------
00000000000000000000000000000000000000000000000000000000000000000000000000000000000000000000----------------
00000000000000000000000000000000000000000000000000000000000000000000000000000000000000000000---------TTT----
00000000000000000000000000000000000000000000000000000000000000000000000000000000000000000000----------------
00000000000000000000000000000000000000000000000000000000000000000000000000000000000000000000X-----------TTTT
00000000000000000000000000000000000000000000000000000000000000000000000000000000000000000000X--------------X
00000000000000000000000000000000000000000000000000000000000000000000000000000000000000000000X--------------X
00000000000000000000000000000000000000000000000000000000000000000000000000000000000000000000X--------------X
00000000000000000000000000000000000000000000000000000000000000000000000000000000000000000000XXXXXXXXXXXX---X
00000000000000000000000000000000000000000000000000000000000000000000000000000000000000000000XX-------------X
00000000000000000000000000000000000000000000000000000000000000000000000000000000000000000000XX--------TTTTTT
00000000000000000000000000000000000000000000000000000000000000000000000000000000000000000000XD-------------X
00000000000000000000000000000000000000000000000000000000000000000000000000000000000000000000XD-------------X
00000000000000000000000000000000000000000000000000000000000000000000000000000000000000000000TTTTXXXXXXXX--DX
00000000000000000000000000000000000000000000000000000000000000000000000000000000000000000000--TTTTTTTT-----X
00000000000000000000000000000000000000000000000000000000000000000000000000000000000000000000---------TTTTTTT
00000000000000000000000000000000000000000000000000000000000000000000000000000000000000000000---------------X
00000000000000000000000000000000000000000000000000000000000000000000000000000000000000000000----------------
00000000000000000000000000000000000000000000000000000000000000000000000000000000000000000000----------------
00000000000000000000000000000000000000000000000000000000000000000000000000000000000000000000-----X------X---
00000000000000000000000000000000000000000000000000000000000000000000000000000000000000000000------------X---
00000000000000000000000000000000000000000000000000000000000000000000000000000000000000000000----------------
00000000000000000000000000000000000000000000000000000000000000000000000000000000000000000000----------------
00000000000000000000000000000000000000000000000000000000000000000000000000000000000000000000---------TTT----
00000000000000000000000000000000000000000000000000000000000000000000000000000000000000000000----------------
00000000000000000000000000000000000000000000000000000000000000000000000000000000000000000000X-----------TTTT
00000000000000000000000000000000000000000000000000000000000000000000000000000000000000000000X--------------X
00000000000000000000000000000000000000000000000000000000000000000000000000000000000000000000X--------------X
00000000000000000000000000000000000000000000000000000000000000000000000000000000000000000000XXXXXXXXX------X
00000000000000000000000000000000000000000000000000000000000000000000000000000000000000000000XX-------------X
00000000000000000000000000000000000000000000000000000000000000000000000000000000000000000000XX--------TTTTTT
00000000000000000000000000000000000000000000000000000000000000000000000000000000000000000000XD-------------X
00000000000000000000000000000000000000000000000000000000000000000000000000000000000000000000XD-------------X
00000000000000000000000000000000000000000000000000000000000000000000000000000000000000000000TTTTXXXXXXXX--DX
00000000000000000000000000000000000000000000000000000000000000000000000000000000000000000000--TTTTTTTT-----X
00000000000000000000000000000000000000000000000000000000000000000000000000000000000000000000---------TTTTTTT
00000000000000000000000000000000000000000000000000000000000000000000000000000000000000000000TTTTTTTT--------
00000000000000000000000000000000000000000000000000000000000000000000000000000000000000000000---------TTTT---
00000000000000000000000000000000000000000000000000000000000000000000000000000000000000000000----------------
00000000000000000000000000000000000000000000000000000000000000000000000000000000000000000000XXXX--------XXXX
00000000000000000000000000000000000000000000000000000000000000000000000000000000000000000000----------------
00000000000000000000000000000000000000000000000000000000000000000000000000000000000000000000----------------
00000000000000000000000000000000000000000000000000000000000000000000000000000000000000000000XXXX------------
00000000000000000000000000000000000000000000000000000000000000000000000000000000000000000000XXXX------------
00000000000000000000000000000000000000000000000000000000000000000000000000000000000000000000XXXXXXXX--------
00000000000000000000000000000000000000000000000000000000000000000000000000000000000000000000X------TTTT-----
00000000000000000000000000000000000000000000000000000000000000000000000000000000000000000000X--------------X
00000000000000000000000000000000000000000000000000000000000000000000000000000000000000000000X--------------X
00000000000000000000000000000000000000000000000000000000000000000000000000000000000000000000XXXXXXXXX------X
00000000000000000000000000000000000000000000000000000000000000000000000000000000000000000000XX-------------X
00000000000000000000000000000000000000000000000000000000000000000000000000000000000000000000XX--------TTTTTT
00000000000000000000000000000000000000000000000000000000000000000000000000000000000000000000XD-------------X
00000000000000000000000000000000000000000000000000000000000000000000000000000000000000000000XD-------------X
00000000000000000000000000000000000000000000000000000000000000000000000000000000000000000000TTTTXXXXXXXX---X
00000000000000000000000000000000000000000000000000000000000000000000000000000000000000000000--TTTTTTTT-----X
00000000000000000000000000000000000000000000000000000000000000000000000000000000000000000000---------TTTTTTT
00000000000000000000000000000000000000000000000000000000000000000000000000000000000000000000TTT-------------
00000000000000000000000000000000000000000000000000000000000000000000000000000000000000000000----------------
00000000000000000000000000000000000000000000000000000000000000000000000000000000000000000000----------------
00000000000000000000000000000000000000000000000000000000000000000000000000000000000000000000XXXXXXX---------
000000000000000000000000000000000000000000000000000000000000000000000000------------------------------------
000000000000000000000000000000000000000000000000000000000000000000000000--------------------------TTTT------
000000000000000000000000000000000000000000000000000000000000000000000000------------------------------------
000000000000000000000000000000000000000000000000000000000000000000000000-----------------------------TTT----
000000000000000000000000000000000000000000000000000000000000000000000000------------------------------------
000000000000000000000000000000000000000000000000000000000000000000000000--------------------X-----------TTTT
000000000000000000000000000000000000000000000000000000000000000000000000--------------------X--------------X
000000000000000000000000000000000000000000000000000000000000000000000000--------------------X--------------X
000000000000000000000000000000000000000000000000000000000000000000000000--------------------XXXXXXXXX------X
000000000000000000000000000000000000000000000000000000000000000000000000--------------------XX-------------X
000000000000000000000000000000000000000000000000000000000000000000000000--------------------XX--------TTTTTT
000000000000000000000000000000000000000000000000000000000000000000000000--------------------XD-------------X
000000000000000000000000000000000000000000000000000000000000000000000000------------E-------XD-------------X
000000000000000000000000000000000000000000000000000000000000000000000000--------------------TTTTXXXXXXXX---X
000000000000000000000000000000000000000000000000000000000000000000000000----------------------TTTTTTTT-----X
00000000000000000000000000000000000000000000000000000000-----XXXX-------XXXXXXXXXXXXXXXXXXXX---------TTTTTTT
00000000000000000000000000000000000000000000000000000000---XXXX----XXXX-000000000000000000000000000000000000
00000000000000000000000000000000000000000000000000000000----XXXX----XXXX000000000000000000000000000000000000
00000000000000000000000000000000000000000000000000000000XXXXXXXXXXXXXXXX000000000000000000000000000000000000
00000000000000000000000000000000000000000000000000000000XXXXXXXXXXXXXXXX000000000000000000000000000000000000
00000000000000000000000000000000000000000000000000000000XXXX----------XX000000000000000000000000000000000000
00000000000000000000000000000000000000000000000000000000XXXX-----------X000000000000000000000000000000000000
00000000000000000000000000000000000000000000000000000000XXXX----------XX000000000000000000000000000000000000
00000000000000000000000000000000000000000000000000000000XXXX-----XXXXXXX000000000000000000000000000000000000
00000000000000000000000000000000000000000000000000000000XXXX------------000000000000000000000000000000000000
00000000000000000000000000000000000000000000000000000000XXXX------------000000000000000000000000000000000000
00000000000000000000000000000000000000000000000000000000XXXX----------X-000000000000000000000000000000000000
00000000000000000000000000000000000000000000000000000000XXXX----------X-000000000000000000000000000000000000
00000000000000000000000000000000000000000000000000000000XXXX------------000000000000000000000000000000000000
00000000000000000000000000000000000000000000000000000000XXXX------------000000000000000000000000000000000000
00000000000000000000000000000000000000000000000000000000XD--------------000000000000000000000000000000000000
00000000000000000000000000000000000000000000000000000000XD-------------X000000000000000000000000000000000000
00000000000000000000000000000000000000000000000000000000TTTTXXXXXXXX--XX000000000000000000000000000000000000
00000000000000000000000000000000000000000000000000000000--TTTTTTTT-----X000000000000000000000000000000000000
00000000000000000000000000000000000000000000000000000000---------TTTTTTT000000000000000000000000000000000000
00000000000000000000000000000000000000000000000000000000----------------000000000000000000000000000000000000
00000000000000000000000000000000000000000000000000000000TTTTTTTT--------000000000000000000000000000000000000
00000000000000000000000000000000000000000000000000000000---------TTTT---000000000000000000000000000000000000
00000000000000000000000000000000000000000000000000000000----------------000000000000000000000000000000000000
00000000000000000000000000000000000000000000000000000000XXXX--------XXXX000000000000000000000000000000000000
00000000000000000000000000000000000000000000000000000000----------------000000000000000000000000000000000000
00000000000000000000000000000000000000000000000000000000----------------000000000000000000000000000000000000
00000000000000000000000000000000000000000000000000000000---------TTT----000000000000000000000000000000000000
00000000000000000000000000000000000000000000000000000000----------------000000000000000000000000000000000000
0000000000000000----------------------------------------X-----------TTTT000000000000000000000000000000000000
0000000000000000----------------------------------------X--------------X000000000000000000000000000000000000
0000000000000000----------------------------------------X--------------X000000000000000000000000000000000000
0000000000000000----------------------------------------XXXXXXXXX------X000000000000000000000000000000000000
0000000000000000----------------------------------------XX-------------X000000000000000000000000000000000000
0000000000000000----------------------------------------XX--------TTTTTT000000000000000000000000000000000000
0000000000000000----------------------------------------XD-------------X000000000000000000000000000000000000
0000000000000000--------S-------------------------------XD-------------X000000000000000000000000000000000000
0000000000000000----------------------------------------TTTTXXXXXXXX---X000000000000000000000000000000000000
0000000000000000------------------------------------------TTTTTTTT-----X000000000000000000000000000000000000
0000000000000000----SSSS-------------------------------<---------TTTTTTT000000000000000000000000000000000000
0000000000000000---E----S-----X------------------------[0000000000000000000000000000000000000000000000000000
0000000000000000-------------XX------------------------[0000000000000000000000000000000000000000000000000000
0000000000000000------------XXX------------------------[0000000000000000000000000000000000000000000000000000
0000000000000000-----------XXXX------------------------[0000000000000000000000000000000000000000000000000000
----------------XXXXXXXXXXXXXXXXXXX-XXXXXXXXXXXXXXXXXXXX0000000000000000000000000000000000000000000000000000
TTTTTTTT--------00000000000000000000000000000000000000000000000000000000000000000000000000000000000000000000
---------TTTT---00000000000000000000000000000000000000000000000000000000000000000000000000000000000000000000
----------------00000000000000000000000000000000000000000000000000000000000000000000000000000000000000000000
XXXX--------XXXX00000000000000000000000000000000000000000000000000000000000000000000000000000000000000000000
-----E----------00000000000000000000000000000000000000000000000000000000000000000000000000000000000000000000
----TTT---------00000000000000000000000000000000000000000000000000000000000000000000000000000000000000000000
----------------00000000000000000000000000000000000000000000000000000000000000000000000000000000000000000000
----------------00000000000000000000000000000000000000000000000000000000000000000000000000000000000000000000
XXXX------------00000000000000000000000000000000000000000000000000000000000000000000000000000000000000000000
XXXX------------00000000000000000000000000000000000000000000000000000000000000000000000000000000000000000000
XXXXXXX---------00000000000000000000000000000000000000000000000000000000000000000000000000000000000000000000
XXXXXXX---------00000000000000000000000000000000000000000000000000000000000000000000000000000000000000000000
XX-------------X00000000000000000000000000000000000000000000000000000000000000000000000000000000000000000000
XD--TTTT--TTTTTT00000000000000000000000000000000000000000000000000000000000000000000000000000000000000000000
XD-------------X00000000000000000000000000000000000000000000000000000000000000000000000000000000000000000000
XD-------------X00000000000000000000000000000000000000000000000000000000000000000000000000000000000000000000
TTTTXXXXXXXX--XX00000000000000000000000000000000000000000000000000000000000000000000000000000000000000000000
--TTTTTTTT-----X00000000000000000000000000000000000000000000000000000000000000000000000000000000000000000000
---------TTTTTTT00000000000000000000000000000000000000000000000000000000000000000000000000000000000000000000