000000000000000000000000000000000000000000000000000000000000000000000000----------------------------------------000000000000000
000000000000000000000000000000000000000000000000000000000000000000000000----------------------------------------000000000000000
000000000000000000000000000000000000000000000000000000000000000000000000----------------------------------------000000000000000
000000000000000000000000000000000000000000000000000000000000000000000000----------------------------------------000000000000000
000000000000000000000000000000000000000000000000000000000000000000000000----------------------------------------000000000000000
000000000000000000000000000000000000000000000000000000000000000000000000----------------------------------------000000000000000
000000000000000000000000000000000000000000000000000000000000000000000000----------------------------------------000000000000000
000000000000000000000000000000000000000000000000000000000000000000000000------------E----SS---------------------000000000000000
000000000000000000000000000000000000000000000000000000000000000000000000-----------<>---------------------------000000000000000
000000000000000000000000000000000000000000000000000000000000000000000000-----------[]------S--------------------000000000000000
000000000000000000000000000000000000000000000000000000000000000000000000-----------[]---------------------------000000000000000
000000000000000000000000000000000000000000000000000000000000000000000000-----------XX---XX--------EXSS----------000000000000000
000000000000000000000000000000000000000000000000000000000000000000000000----------------XX---------X-S----------000000000000000
000000000000000000000000000000000000000000000000000000000000000000000000----------------XXX--------X------------000000000000000
00000000000000000000000000000000000000000000000000000000---------------------E----------XXX--------X------------000000000000000
00000000000000000000000000000000000000000000000000000000----------------XXXXXXXXXXXXXXXXXXX-XXXXXXXXXXX--XXXXXX-000000000000000
00000000000000000000000000000000000000000000000000000000----TTTT--------0000000000000000000000000000000000000000000000000000000
00000000000000000000000000000000000000000000000000000000----------TTT---0000000000000000000000000000000000000000000000000000000
00000000000000000000000000000000000000000000000000000000----------------0000000000000000000000000000000000000000000000000000000
00000000000000000000000000000000000000000000000000000000----------------0000000000000000000000000000000000000000000000000000000
00000000000000000000000000000000000000000000000000000000-----TTTT-TTTT--0000000000000000000000000000000000000000000000000000000
00000000000000000000000000000000000000000000000000000000----------------0000000000000000000000000000000000000000000000000000000
00000000000000000000000000000000000000000000000000000000----------------0000000000000000000000000000000000000000000000000000000
00000000000000000000000000000000000000000000000000000000---------TTTT---0000000000000000000000000000000000000000000000000000000
00000000000000000000000000000000000000000000000000000000----------------0000000000000000000000000000000000000000000000000000000
00000000000000000000000000000000000000000000000000000000------XXXX------0000000000000000000000000000000000000000000000000000000
00000000000000000000000000000000000000000000000000000000----------------0000000000000000000000000000000000000000000000000000000
00000000000000000000000000000000000000000000000000000000--------T-------0000000000000000000000000000000000000000000000000000000
00000000000000000000000000000000000000000000000000000000----------------0000000000000000000000000000000000000000000000000000000
00000000000000000000000000000000000000000000000000000000----------------0000000000000000000000000000000000000000000000000000000
00000000000000000000000000000000000000000000000000000000XX----TTTTTTTTTT0000000000000000000000000000000000000000000000000000000
00000000000000000000000000000000000000000000000000000000XD-------------X0000000000000000000000000000000000000000000000000000000
00000000000000000000000000000000000000000000000000000000XD-------------X0000000000000000000000000000000000000000000000000000000
00000000000000000000000000000000000000000000000000000000XXXXXXXXXXX-----0000000000000000000000000000000000000000000000000000000
00000000000000000000000000000000000000000000000000000000------X---------0000000000000000000000000000000000000000000000000000000
00000000000000000000000000000000000000000000000000000000-----------X----0000000000000000000000000000000000000000000000000000000
00000000000000000000000000000000000000000000000000000000----------------0000000000000000000000000000000000000000000000000000000
00000000000000000000000000000000000000000000000000000000----------------0000000000000000000000000000000000000000000000000000000
00000000000000000000000000000000000000000000000000000000----------T-----0000000000000000000000000000000000000000000000000000000
00000000000000000000000000000000000000000000000000000000----------------0000000000000000000000000000000000000000000000000000000
00000000000000000000000000000000000000000000000000000000----------------0000000000000000000000000000000000000000000000000000000
00000000000000000000000000000000000000000000000000000000---X------------0000000000000000000000000000000000000000000000000000000
00000000000000000000000000000000000000000000000000000000-TTTT-----------0000000000000000000000000000000000000000000000000000000
00000000000000000000000000000000000000000000000000000000----------------0000000000000000000000000000000000000000000000000000000
00000000000000000000000000000000000000000000000000000000----------------0000000000000000000000000000000000000000000000000000000
00000000000000000000000000000000000000000000000000000000XXXX------------0000000000000000000000000000000000000000000000000000000
00000000000000000000000000000000000000000000000000000000XXXX------------0000000000000000000000000000000000000000000000000000000
00000000000000000000000000000000000000000000000000000000XXXX--TTTT------0000000000000000000000000000000000000000000000000000000
00000000000000000000000000000000000000000000000000000000XXXX------------0000000000000000000000000000000000000000000000000000000
00000000000000000000000000000000000000000000000000000000XX-------------X0000000000000000000000000000000000000000000000000000000
00000000000000000000000000000000000000000000000000000000XX----------TTTT0000000000000000000000000000000000000000000000000000000
00000000000000000000000000000000000000000000000000000000XD-------------X0000000000000000000000000000000000000000000000000000000
00000000000000000000000000000000000000000000000000000000XD-------------X0000000000000000000000000000000000000000000000000000000
00000000000000000000000000000000000000000000000000000000XXXXXXXXXXX-----0000000000000000000000000000000000000000000000000000000
00000000000000000000000000000000000000000000000000000000----------------0000000000000000000000000000000000000000000000000000000
00000000000000000000000000000000000000000000000000000000-----X----------0000000000000000000000000000000000000000000000000000000
00000000000000000000000000000000000000000000000000000000-----------X----0000000000000000000000000000000000000000000000000000000
00000000000000000000000000000000000000000000000000000000----------------0000000000000000000000000000000000000000000000000000000
00000000000000000000000000000000000000000000000000000000----------------0000000000000000000000000000000000000000000000000000000
00000000000000000000000000000000000000000000000000000000MMMMMMMMMMMMMMMM0000000000000000000000000000000000000000000000000000000
00000000000000000000000000000000000000000000000000000000----------------0000000000000000000000000000000000000000000000000000000
00000000000000000000000000000000000000000000000000000000----------------0000000000000000000000000000000000000000000000000000000
00000000000000000000000000000000000000000000000000000000MMMMMMMMMMMMMMMM0000000000000000000000000000000000000000000000000000000
00000000000000000000000000000000000000000000000000000000----------------0000000000000000000000000000000000000000000000000000000
0000000000000000--------------------------------------------------------0000000000000000000000000000000000000000000000000000000
0000000000000000----------------------------------------XXXX------------0000000000000000000000000000000000000000000000000000000
0000000000000000----------------------------------------XXXX------------0000000000000000000000000000000000000000000000000000000
0000000000000000----------------------------------------XXXX--TTTT------0000000000000000000000000000000000000000000000000000000
0000000000000000----------------------------------------XXXX------------0000000000000000000000000000000000000000000000000000000
0000000000000000----------------------------------------XX-------------X0000000000000000000000000000000000000000000000000000000
0000000000000000----------------------------------------XX----------TTTT0000000000000000000000000000000000000000000000000000000
0000000000000000----------------------------------------XD-------------X0000000000000000000000000000000000000000000000000000000
0000000000000000----------------------------------------XD-------------X0000000000000000000000000000000000000000000000000000000
0000000000000000--------------------------------------XXXXXXXXXXXXX-----0000000000000000000000000000000000000000000000000000000
0000000000000000----SSS-----------------------------XXXX00000000000000000000000000000000000000000000000000000000000000000000000
0000000000000000--------------<E-------E-----------XXXXX00000000000000000000000000000000000000000000000000000000000000000000000
0000000000000000--------------[>------<>---------XXXXXXX00000000000000000000000000000000000000000000000000000000000000000000000
0000000000000000--------------[]------[]---------XXXXXXX00000000000000000000000000000000000000000000000000000000000000000000000
0000000000000000--------------[]------[]---------XXXXXXX00000000000000000000000000000000000000000000000000000000000000000000000
----------------XXXXXXXXXXXXXXXXXXX-XXXXXXXXXXXXXXXXXXXX00000000000000000000000000000000000000000000000000000000000000000000000
-------X--------000000000000000000000000000000000000000000000000000000000000000000000000000000000000000000000000000000000000000
------------TTTT000000000000000000000000000000000000000000000000000000000000000000000000000000000000000000000000000000000000000
----TT----------000000000000000000000000000000000000000000000000000000000000000000000000000000000000000000000000000000000000000
----------------000000000000000000000000000000000000000000000000000000000000000000000000000000000000000000000000000000000000000
----------------000000000000000000000000000000000000000000000000000000000000000000000000000000000000000000000000000000000000000
--------TTTT----000000000000000000000000000000000000000000000000000000000000000000000000000000000000000000000000000000000000000
----------------000000000000000000000000000000000000000000000000000000000000000000000000000000000000000000000000000000000000000
--TTTTTTTT------000000000000000000000000000000000000000000000000000000000000000000000000000000000000000000000000000000000000000
----------------000000000000000000000000000000000000000000000000000000000000000000000000000000000000000000000000000000000000000
----------------000000000000000000000000000000000000000000000000000000000000000000000000000000000000000000000000000000000000000
XXXX------------000000000000000000000000000000000000000000000000000000000000000000000000000000000000000000000000000000000000000
XXXX------------000000000000000000000000000000000000000000000000000000000000000000000000000000000000000000000000000000000000000
XXXX--TTTT------000000000000000000000000000000000000000000000000000000000000000000000000000000000000000000000000000000000000000
XXXX------------000000000000000000000000000000000000000000000000000000000000000000000000000000000000000000000000000000000000000
XX-------------X000000000000000000000000000000000000000000000000000000000000000000000000000000000000000000000000000000000000000
XX----------TTTT000000000000000000000000000000000000000000000000000000000000000000000000000000000000000000000000000000000000000
XD-------------X000000000000000000000000000000000000000000000000000000000000000000000000000000000000000000000000000000000000000
XD-------------X000000000000000000000000000000000000000000000000000000000000000000000000000000000000000000000000000000000000000
XXXXXXXXXXX-----000000000000000000000000000000000000000000000000000000000000000000000000000000000000000000000000000000000000000
----------------000000000000000000000000000000000000000000000000000000000000000000000000000000000000000000000000000000000000000
----------------000000000000000000000000000000000000000000000000000000000000000000000000000000000000000000000000000000000000000
-----T----------000000000000000000000000000000000000000000000000000000000000000000000000000000000000000000000000000000000000000
----------------000000000000000000000000000000000000000000000000000000000000000000000000000000000000000000000000000000000000000
---E-----E------000000000000000000000000000000000000000000000000000000000000000000000000000000000000000000000000000000000000000
MMMMMMMMMMMMMMMX000000000000000000000000000000000000000000000000000000000000000000000000000000000000000000000000000000000000000
----------------000000000000000000000000000000000000000000000000000000000000000000000000000000000000000000000000000000000000000
--E--------E----000000000000000000000000000000000000000000000000000000000000000000000000000000000000000000000000000000000000000
MMMMMMMMMMMMMMMM000000000000000000000000000000000000000000000000000000000000000000000000000000000000000000000000000000000000000
----------------000000000000000000000000000000000000000000000000000000000000000000000000000000000000000000000000000000000000000
----------------000000000000000000000000000000000000000000000000000000000000000000000000000000000000000000000000000000000000000
XXXX------------000000000000000000000000000000000000000000000000000000000000000000000000000000000000000000000000000000000000000
XXXX------------000000000000000000000000000000000000000000000000000000000000000000000000000000000000000000000000000000000000000
XXXX--TTTT------000000000000000000000000000000000000000000000000000000000000000000000000000000000000000000000000000000000000000
XXXX------------000000000000000000000000000000000000000000000000000000000000000000000000000000000000000000000000000000000000000
XX-------------X000000000000000000000000000000000000000000000000000000000000000000000000000000000000000000000000000000000000000
XX----------TTTT000000000000000000000000000000000000000000000000000000000000000000000000000000000000000000000000000000000000000
XD-------------X000000000000000000000000000000000000000000000000000000000000000000000000000000000000000000000000000000000000000
XD-------------X000000000000000000000000000000000000000000000000000000000000000000000000000000000000000000000000000000000000000
XXXXXXXXXXX-----000000000000000000000000000000000000000000000000000000000000000000000000000000000000000000000000000000000000000
----------D-----000000000000000000000000000000000000000000000000000000000000000000000000000000000000000000000000000000000000000
--------XD------000000000000000000000000000000000000000000000000000000000000000000000000000000000000000000000000000000000000000
--------XXXXX---000000000000000000000000000000000000000000000000000000000000000000000000000000000000000000000000000000000000000
TTTT--------XXXX000000000000000000000000000000000000000000000000000000000000000000000000000000000000000000000000000000000000000
----------------000000000000000000000000000000000000000000000000000000000000000000000000000000000000000000000000000000000000000
----------------000000000000000000000000000000000000000000000000000000000000000000000000000000000000000000000000000000000000000
------TTT-------000000000000000000000000000000000000000000000000000000000000000000000000000000000000000000000000000000000000000
----------------000000000000000000000000000000000000000000000000000000000000000000000000000000000000000000000000000000000000000
----------------000000000000000000000000000000000000000000000000000000000000000000000000000000000000000000000000000000000000000
-----TTTT-------000000000000000000000000000000000000000000000000000000000000000000000000000000000000000000000000000000000000000
----------------000000000000000000000000000000000000000000000000000000000000000000000000000000000000000000000000000000000000000
XX--------------000000000000000000000000000000000000000000000000000000000000000000000000000000000000000000000000000000000000000
XXXX------------000000000000000000000000000000000000000000000000000000000000000000000000000000000000000000000000000000000000000
XXXX--TTTT------000000000000000000000000000000000000000000000000000000000000000000000000000000000000000000000000000000000000000
XXXX------------000000000000000000000000000000000000000000000000000000000000000000000000000000000000000000000000000000000000000
XX-------------X000000000000000000000000000000000000000000000000000000000000000000000000000000000000000000000000000000000000000
XX----------TTTT000000000000000000000000000000000000000000000000000000000000000000000000000000000000000000000000000000000000000
XD-------------X000000000000000000000000000000000000000000000000000000000000000000000000000000000000000000000000000000000000000
XD-------------X000000000000000000000000000000000000000000000000000000000000000000000000000000000000000000000000000000000000000
XXXXXXXXXXX-----000000000000000000000000000000000000000000000000000000000000000000000000000000000000000000000000000000000000000