000000000000000000000000000000000000000000000000000000000000000000000000000000000000000000000000000000000000000000000000000000000000---------X------
000000000000000000000000000000000000000000000000000000000000000000000000000000000000000000000000000000000000000000000000000000000000----------------
000000000000000000000000000000000000000000000000000000000000000000000000000000000000000000000000000000000000000000000000000000000000-----X----------
000000000000000000000000000000000000000000000000000000000000000000000000000000000000000000000000000000000000000000000000000000000000---X---X---X----
000000000000000000000000000000000000000000000000000000000000000000000000000000000000000000000000000000000000000000000000000000000000--X--X---X---X--
000000000000000000000000000000000000000000000000000000000000000000000000000000000000000000000000000000000000000000000000000000000000--X--X---X---X--
000000000000000000000000000000000000000000000000000000000000000000000000000000000000000000000000000000000000000000000000000000000000--X--X--X--X----
000000000000000000000000000000000000000000000000000000000000000000000000000000000000000000000000000000000000000000000000000000000000--X--X--X--X----
000000000000000000000000000000000000000000000000000000000000000000000000000000000000000000000000000000000000000000000000000000000000TTX--X--X--X----
000000000000000000000000000000000000000000000000000000000000000000000000000000000000000000000000000000000000000000000000000000000000----------------
000000000000000000000000000000000000000000000000000000000000000000000000000000000000000000000000000000000000000000000000000000000000----------------
000000000000000000000000000000000000000000000000000000000000000000000000000000000000000000000000000000000000000000000000000000000000----XXXX--------
000000000000000000000000000000000000000000000000000000000000000000000000000000000000000000000000000000000000000000000000000000000000XXXX----XXXXXXXX
000000000000000000000000000000000000000000000000000000000000000000000000000000000000000000000000000000000000000000000000000000000000XXXX--------XXXX
000000000000000000000000000000000000000000000000000000000000000000000000000000000000000000000000000000000000000000000000000000000000XX------------XX
000000000000000000000000000000000000000000000000000000000000000000000000000000000000000000000000000000000000000000000000000000000000XX----XXXXX---XX
000000000000000000000000000000000000000000000000000000000000000000000000000000000000000000000000000000000000000000000000000000000000XD------------XX
000000000000000000000000000000000000000000000000000000000000000000000000000000000000000000000000000000000000000000000000000000000000XD------------XX
000000000000000000000000000000000000000000000000000000000000000000000000000000000000000000000000000000000000000000000000000000000000XXXXX-------XXXX
000000000000000000000000000000000000000000000000000000000000000000000000000000000000000000000000000000000000000000000000000000000000XXXXXXXXXXXXXXXX
000000000000000000000000000000000000000000000000000000000000000000000000000000000000000000000000000000000000000000000000000000000000XXXXXX--------XX
000000000000000000000000000000000000000000000000000000000000000000000000000000000000000000000000000000000000000000000000000000000000XXXX----------XX
000000000000000000000000000000000000000000000000000000000000000000000000000000000000000000000000000000000000000000000000000000000000XXXX------------
000000000000000000000000000000000000000000000000000000000000000000000000000000000000000000000000000000000000000000000000000000000000XXXX------------
0000000000000000000000000000000000000000000000000000000000000000000000000000000000000000000000000000000000000000--------------------XXXXXXXXXXXX----
0000000000000000000000000000000000000000000000000000000000000000000000000000000000000000000000000000000000000000--------------------X--------TTTT---
0000000000000000000000000000000000000000000000000000000000000000000000000000000000000000000000000000000000000000--------------------X---------------
0000000000000000000000000000000000000000000000000000000000000000000000000000000000000000000000000000000000000000--------------------XXXX--------XXXX
000000000000000000000000000000000000000000000000000000000000000000000000000000000000000000000000XX--------XXXX--S-------------------XXXX--------XXXX
000000000000000000000000000000000000000000000000000000000000000000000000000000000000000000000000XX-------XXXX---S-------------------XXXXXXX-----XXXX
000000000000000000000000000000000000000000000000000000000000000000000000000000000000000000000000XXXX--------XXXXS-------------------XXXX--------XXXX
000000000000000000000000000000000000000000000000000000000000000000000000000000000000000000000000XXXX--------XXXXS-------------XXXXX-XX------------XX
0000000000000000000000000000000000000000000000000000000000000000000000000000--------------------XX------------XXS-------------XXXXX-XX-----XXXX---XX
0000000000000000000000000000000000000000000000000000000000000000000000000000--------------------XX-----XXXX---DXS------------XXXXXX-XX------------XX
0000000000000000000000000000000000000000000000000000000000000000000000000000--------------------XX------------DXS------------XXXXXX-XX------------XX
000000000000000000000000000000000000000000000000000000000000------------------------------------XXXX--------XXXXS----------XXXXXXXX-XX----XXXXXXXXXX
000000000000000000000000000000000000000000000000000000000000----------------S-------------------XXXXXX------XXXXS---------XXXXXXXXX-XD------------XX
000000000000000000000000000000000000000000000000000000000000XXXX------------S-------------------XXXX--------XXXXS--------XXXXXXXXXX-XD------------XX
000000000000000000000000000000000000000000000000000000000000----------------S-------------------XXXX--------XXXXS------E-XXXXXXXXXX-XXXXX-------XXXX
000000000000000000000000000000000000000000000000000000000000------TTTT------S-------------------XX----TTTTTTTTXXXXXXXXXXXXXXXXXXXXXXXXXXXXXXXXXXXXXX
000000000000000000000000000000000000000000000000000000000000----------------S-------------------XX------------XX000000000000000000000000000000000000
000000000000000000000000000000000000000000000000000000000000---------XXXX---S-------------------XX------------XX000000000000000000000000000000000000
000000000000000000000000000000000000000000000000000000000000----------------S---------E-----E---XXXXXXXX------XX000000000000000000000000000000000000
000000000000000000000000000000000000000000000000000000000000------XXXX------S--------<>----<>---XX----XXXXX---XX000000000000000000000000000000000000
000000000000000000000000000000000000000000000000000000000000----------------S--E-----[]----[]---XD------------XX000000000000000000000000000000000000
000000000000000000000000000000000000000000000000000000000000---XXXX---------S-<>-----[]----[]---XD------------XX000000000000000000000000000000000000
000000000000000000000000000000000000000000000000000000000000-X--------------S-[]-----[]----[]-E-XXXXX-------XXXX000000000000000000000000000000000000
000000000000000000000000000000000000000000000000000000000000XXXXX-------XXXXXXXXXXXXXXXXXXXXXXXXXXXXXXXXXXXXXXXX000000000000000000000000000000000000
000000000000000000000000000000000000000000000000000000000000XX--------------000000000000000000000000000000000000000000000000000000000000000000000000
000000000000000000000000000000000000000000000000000000000000XX--------------000000000000000000000000000000000000000000000000000000000000000000000000
000000000000000000000000000000000000000000000000000000000000XX--------TTT---000000000000000000000000000000000000000000000000000000000000000000000000
000000000000000000000000000000000000000000000000000000000000XD--------------000000000000000000000000000000000000000000000000000000000000000000000000
000000000000000000000000000000000000000000000000000000000000XD-------------X000000000000000000000000000000000000000000000000000000000000000000000000
000000000000000000000000000000000000000000000000000000000000XXXXX-------XXXX000000000000000000000000000000000000000000000000000000000000000000000000
000000000000000000000000000000000000000000000000000000000000XXXXXXXXXXXXXXXX000000000000000000000000000000000000000000000000000000000000000000000000
000000000000000000000000000000000000000000000000000000000000XXXX--------XXXX000000000000000000000000000000000000000000000000000000000000000000000000
000000000000000000000000000000000000000000000000000000000000XXXX--------XXXX000000000000000000000000000000000000000000000000000000000000000000000000
000000000000000000000000000000000000000000000000000000000000XXXXXXX-----XXXX000000000000000000000000000000000000000000000000000000000000000000000000
000000000000000000000000000000000000000000000000000000000000XXXX--------XXXX000000000000000000000000000000000000000000000000000000000000000000000000
------------------------------------------------------------XX------------XX000000000000000000000000000000000000000000000000000000000000000000000000
------------------------------------------------------------XX-----XXXX---DX000000000000000000000000000000000000000000000000000000000000000000000000
------------------------------------------------------------XX------------DX000000000000000000000000000000000000000000000000000000000000000000000000
------------------------------------------------------------XXXX--------XXXX000000000000000000000000000000000000000000000000000000000000000000000000
S-------------------S-------------------S-------------------XXXXXX------XXXX000000000000000000000000000000000000000000000000000000000000000000000000
S-------------------S-------------------S-------------------XXXX--------XXXX000000000000000000000000000000000000000000000000000000000000000000000000
S----oooo-----------S-------------------S-------X-----------XXXX--------XXXX000000000000000000000000000000000000000000000000000000000000000000000000
S--o------------XXX-S----------------XXXS--S----XX----------XX----TTTTTTTTXX000000000000000000000000000000000000000000000000000000000000000000000000
S---o----------XXXX-S----------------XXXS-------XX----------XX------------XX000000000000000000000000000000000000000000000000000000000000000000000000
S----X--------XXXXX-S---------------XXXXS-------XX----------XX------------XX000000000000000000000000000000000000000000000000000000000000000000000000
S------------XXXXXX-S--------------XXXXXS-------XX----------XXXXXXXX------XX000000000000000000000000000000000000000000000000000000000000000000000000
S--X--------XXXXXXX-S--------------XXXXXS-SS----XX----------XX----XXXXX---XX000000000000000000000000000000000000000000000000000000000000000000000000
S-----------XXXXXXX-S-------------XXXXXXS-------XX----------XD------------XX000000000000000000000000000000000000000000000000000000000000000000000000
S-----------XXXXXXX-S------------XXXXXXXS-------XX----------XD------------XX000000000000000000000000000000000000000000000000000000000000000000000000
S----------EXXXXXXXDS-----------XXXXXXXXS-------XX----E-----XXXXX-------XXXX000000000000000000000000000000000000000000000000000000000000000000000000
XXEXXXXXXXXXXXXXXXXXXXXXXXXXXXXXXXXXXXXXXXXXXXXXXXXXXXXXXXXXXXXXXXXXXXXXXXXX000000000000000000000000000000000000000000000000000000000000000000000000
0000000000000000000000000000000000000000000000000000000000000000000000000000000000000000000000000000000000000000000000000000000000000000000000000000