00000000000000000000000000000000000000000000000000000000000000000000000000000000000000000000000000000000000000000000000000000000--------------------000000000000000
00000000000000000000000000000000000000000000000000000000000000000000000000000000000000000000000000000000000000000000000000000000--------------------000000000000000
00000000000000000000000000000000000000000000000000000000000000000000000000000000000000000000000000000000000000000000000000000000--------------------000000000000000
00000000000000000000000000000000000000000000000000000000000000000000000000000000000000000000000000000000000000000000000000000000--------------------000000000000000
0000000000000000000000000000000000000000000000000000000000000000000000000000000000000000000000000000000000000000X---------------S-------------------000000000000000
0000000000000000000000000000000000000000000000000000000000000000000000000000000000000000000000000000000000000000X------X--------S-------------------000000000000000
0000000000000000000000000000000000000000000000000000000000000000000000000000000000000000000000000000000000000000XXXXXXXXXXXX---XS---------E---------000000000000000
0000000000000000000000000000000000000000000000000000000000000000000000000000000000000000000000000000000000000000XXXXXXXXXXXXXXXXS---------E---------000000000000000
0000000000000000000000000000000000000000000000000000000000000000000000000000000000000000000000000000000000000000XXXXXXXXXXXX--XXS-----------XXXXXXXX000000000000000
0000000000000000000000000000000000000000000000000000000000000000000000000000000000000000000000000000000000000000XXXX----------XXS-------------------000000000000000
0000000000000000000000000000000000000000000000000000000000000000000000000000000000000000000000000000000000000000XXXX----------DXS-------------------000000000000000
0000000000000000000000000000000000000000000000000000000000000000000000000000000000000000000000000000000000000000XXXX----------DXS------XXXXXX-------000000000000000
0000000000000000000000000000000000000000000000000000000000000000000000000000000000000000000000000000000000000000XXXX----XXXXXXXXS-------------------000000000000000
0000000000000000000000000000000000000000000000000000000000000000000000000000000000000000000000000000000000000000---X-X----------S-------------------000000000000000
0000000000000000000000000000000000000000000000000000000000000000000000000000000000000000000000000000000000000000---X------------S--EE---------------000000000000000
0000000000000000000000000000000000000000000000000000000000000000000000000000000000000000000000000000000000000000XXX-----------XXXXXXXXX-------------000000000000000
0000000000000000000000000000000000000000000000000000000000000000000000000000000000000000000000000000000000000000XXXXXXXXXX----XX00000000000000000000000000000000000
0000000000000000000000000000000000000000000000000000000000000000000000000000000000000000000000000000000000000000XX------------XX00000000000000000000000000000000000
0000000000000000000000000000000000000000000000000000000000000000000000000000000000000000000000000000000000000000XX------------XX00000000000000000000000000000000000
0000000000000000000000000000000000000000000000000000000000000000000000000000000000000000000000000000000000000000XX----XXXXXXXXXX00000000000000000000000000000000000
0000000000000000000000000000000000000000000000000000000000000000000000000000000000000000000000000000000000000000XD------------XX00000000000000000000000000000000000
0000000000000000000000000000000000000000000000000000000000000000000000000000000000000000000000000000000000000000XD------------XX00000000000000000000000000000000000
0000000000000000000000000000000000000000000000000000000000000000000000000000000000000000000000000000000000000000XXXXX-------XXXX00000000000000000000000000000000000
0000000000000000000000000000000000000000000000000000000000000000000000000000000000000000000000000000000000000000XXXXXXXXXXXXXXXX00000000000000000000000000000000000
0000000000000000000000000000000000000000000000000000000000000000000000000000000000000000000000000000000000000000X--------------X00000000000000000000000000000000000
0000000000000000000000000000000000000000000000000000000000000000000000000000000000000000000000000000000000000000XXXX-----------X00000000000000000000000000000000000
0000000000000000000000000000000000000000000000000000000000000000000000000000000000000000000000000000000000000000XXXXXXXXXXXX---X00000000000000000000000000000000000
0000000000000000000000000000000000000000000000000000000000000000000000000000000000000000000000000000000000000000XXXXXXXXXXXXXXXX00000000000000000000000000000000000
0000000000000000000000000000000000000000000000000000000000000000000000000000000000000000000000000000000000000000XXXX----------XX00000000000000000000000000000000000
0000000000000000000000000000000000000000000000000000000000000000000000000000000000000000000000000000000000000000XXXX----------XX00000000000000000000000000000000000
0000000000000000000000000000000000000000000000000000000000000000000000000000000000000000000000000000000000000000XXXX----------DX00000000000000000000000000000000000
0000000000000000000000000000000000000000000000000000000000000000000000000000000000000000000000000000000000000000XXXX----------DX00000000000000000000000000000000000
00000000000000000000000000000000000000000000000000000000000000000000000000000000000000000000--------------------XXXX----XXXXXXXX00000000000000000000000000000000000
00000000000000000000000000000000000000000000000000000000000000000000000000000000000000000000-----------------------X-X----------00000000000000000000000000000000000
00000000000000000000000000000000000000000000000000000000000000000000000000000000000000000000-----------------------X------------00000000000000000000000000000000000
0000000000000000000000000000000000000000000000000000000000000000000000000000--------X---------------------------XXX-----------XX00000000000000000000000000000000000
0000000000000000000000000000000000000000000000000000000000000000000000000000----------------S-------------------XXXXXXXXXX----XX00000000000000000000000000000000000
0000000000000000000000000000000000000000000000000000000000000000000000000000-----X----------S-------------------XX------------XX00000000000000000000000000000000000
0000000000000000000000000000000000000000000000000000000000000000000000000000----------X-----S-------------------XX------------XX00000000000000000000000000000000000
0000000000000000000000000000000000000000000000000000000000000000000000000000----------------S-------------------XX----XXXXXXXXXX00000000000000000000000000000000000
0000000000000000000000000000000000000000000000000000000000000000000000000000----------------S-------------------XD------------XX00000000000000000000000000000000000
0000000000000000000000000000000000000000000000000000000000000000000000000000-------------X--S-------------------XD------------XX00000000000000000000000000000000000
0000000000000000000000000000000000000000000000000000000000000000000000000000----------------S-------------------XXXXX-------XXXX00000000000000000000000000000000000
0000000000000000000000000000000000000000000000000000000000000000000000000000----------------S----------E-------XXXXXXXXXXXXXXXXX00000000000000000000000000000000000
0000000000000000000000000000000000000000000000000000000000000000000000000000---------TTT----S---------<>------XX000000000000000000000000000000000000000000000000000
0000000000000000000000000000000000000000000000000000000000000000000000000000----------------S---------[]-----XXX000000000000000000000000000000000000000000000000000
0000000000000000000000000000000000000000000000000000000000000000000000000000----------------S------EE-[]----XXXX000000000000000000000000000000000000000000000000000
0000000000000000000000000000000000000000000000000000000000000000000000000000----------------XXXXXXXXXXXXXXXXXXXX000000000000000000000000000000000000000000000000000
0000000000000000000000000000000000000000000000000000000000000000000000000000-------------X--00000000000000000000000000000000000000000000000000000000000000000000000
0000000000000000000000000000000000000000000000000000000000000000000000000000-------------X--00000000000000000000000000000000000000000000000000000000000000000000000
0000000000000000000000000000000000000000000000000000000000000000000000000000-------------X--00000000000000000000000000000000000000000000000000000000000000000000000
0000000000000000000000000000000000000000000000000000000000000000000000000000XD-----------TXX00000000000000000000000000000000000000000000000000000000000000000000000
0000000000000000000000000000000000000000000000000000000000000000000000000000XD------------XX00000000000000000000000000000000000000000000000000000000000000000000000
0000000000000000000000000000000000000000000000000000000000000000000000000000XXXXX-------XXXX00000000000000000000000000000000000000000000000000000000000000000000000
0000000000000000000000000000000000000000000000000000000000000000000000000000XXXXXXXXXXXXXXXX00000000000000000000000000000000000000000000000000000000000000000000000
0000000000000000000000000000000000000000000000000000000000000000000000000000MMMMMMMMXMMMMMMM00000000000000000000000000000000000000000000000000000000000000000000000
0000000000000000000000000000000000000000000000000000000000000000000000000000----------------00000000000000000000000000000000000000000000000000000000000000000000000
0000000000000000000000000000000000000000000000000000000000000000000000000000----------------00000000000000000000000000000000000000000000000000000000000000000000000
0000000000000000000000000000000000000000000000000000000000000000000000000000-------TT-------00000000000000000000000000000000000000000000000000000000000000000000000
000000000000000000000000000000000000--------------------------------------------------------00000000000000000000000000000000000000000000000000000000000000000000000
000000000000000000000000000000000000--------------------------------------------------------00000000000000000000000000000000000000000000000000000000000000000000000
000000000000000000000000000000000000----------------------------------------X-----XXXX-TTTT-00000000000000000000000000000000000000000000000000000000000000000000000
000000000000000000000000000000000000----------------------------------------X---------------00000000000000000000000000000000000000000000000000000000000000000000000
00000000000000000000XXXX--------XXXXS-------------------S-------------------X---------------00000000000000000000000000000000000000000000000000000000000000000000000
00000000000000000000XXXX--------XXXXS-------------------S-------------------XXXX--------XXXX00000000000000000000000000000000000000000000000000000000000000000000000
00000000000000000000XXXXE-------XXXXS-------------------S-------------------XXXX--------XXXX00000000000000000000000000000000000000000000000000000000000000000000000
00000000000000000000XXXX--------XXXXS-------------------S-------------------XXXXXXX-----XXXX00000000000000000000000000000000000000000000000000000000000000000000000
00000000000000000000XX------------XXS-------------------S-------------------XXXX------T-XXXX00000000000000000000000000000000000000000000000000000000000000000000000
00000000000000000000XX-----XXXX---DXS-------------------S-------------------XX----------XXXX00000000000000000000000000000000000000000000000000000000000000000000000
00000000000000000000XX------------DXS-------------------S-------------------XX----------XXXX00000000000000000000000000000000000000000000000000000000000000000000000
00000000000000000000XXXX--------XXXXS-XXXXXXXXXXXXXXXXX-S-------------------XX----XXXXXXXXXX00000000000000000000000000000000000000000000000000000000000000000000000
00000000000000000000XXXXXX------XXXXS-------------------S-------------------XD-----------TXX00000000000000000000000000000000000000000000000000000000000000000000000
--------------------XXXX--------XXXXS-------------------S-------------------XD------------XX00000000000000000000000000000000000000000000000000000000000000000000000
--------------------XXXX--------XXXXS-------------------S-------------------XXXXX-------XXXX00000000000000000000000000000000000000000000000000000000000000000000000
--------------------XX----TTTTTTTTXXXX------------------XXXXXXXXXXXXXXXXXXXXXXXXXXXXXXXXXXXX00000000000000000000000000000000000000000000000000000000000000000000000
--------------------XX------------XX0000000000000000000000000000000000000000000000000000000000000000000000000000000000000000000000000000000000000000000000000000000
S-------------------XX------------XX0000000000000000000000000000000000000000000000000000000000000000000000000000000000000000000000000000000000000000000000000000000
S-------------------XXXXXXXX------XX0000000000000000000000000000000000000000000000000000000000000000000000000000000000000000000000000000000000000000000000000000000
S-------------------XXXX----------XX0000000000000000000000000000000000000000000000000000000000000000000000000000000000000000000000000000000000000000000000000000000
S-------------------XD-------------X0000000000000000000000000000000000000000000000000000000000000000000000000000000000000000000000000000000000000000000000000000000
S-------------------XD-------------X0000000000000000000000000000000000000000000000000000000000000000000000000000000000000000000000000000000000000000000000000000000
S-------------------XXXXX-------XXXX0000000000000000000000000000000000000000000000000000000000000000000000000000000000000000000000000000000000000000000000000000000
S------------------<XXXXXXXXXXXXXXXX0000000000000000000000000000000000000000000000000000000000000000000000000000000000000000000000000000000000000000000000000000000
S-----------------E[00000000000000000000000000000000000000000000000000000000000000000000000000000000000000000000000000000000000000000000000000000000000000000000000
S-----------------E[00000000000000000000000000000000000000000000000000000000000000000000000000000000000000000000000000000000000000000000000000000000000000000000000
S------------------[00000000000000000000000000000000000000000000000000000000000000000000000000000000000000000000000000000000000000000000000000000000000000000000000
S------------------[00000000000000000000000000000000000000000000000000000000000000000000000000000000000000000000000000000000000000000000000000000000000000000000000
XXXXXXXXXXXXXXXXXXXX00000000000000000000000000000000000000000000000000000000000000000000000000000000000000000000000000000000000000000000000000000000000000000000000
0000000000000000000000000000000000000000000000000000000000000000000000000000000000000000000000000000000000000000000000000000000000000000000000000000000000000000000