000000000000000000000000000000000000000000000000000000000000------------X---
000000000000000000000000000000000000000000000000000000000000------------X---
000000000000000000000000000000000000000000000000000000000000----------------
000000000000000000000000000000000000000000000000000000000000----------------
000000000000000000000000000000000000000000000000000000000000-----TT--TT-----
000000000000000000000000000000000000000000000000000000000000----------------
000000000000000000000000000000000000000000000000000000000000----------------
000000000000000000000000000000000000000000000000000000000000---------TTT----
000000000000000000000000000000000000000000000000000000000000----------------
000000000000000000000000000000000000000000000000000000000000X-----------TTTT
000000000000000000000000000000000000000000000000000000000000X--------------X
000000000000000000000000000000000000000000000000000000000000X--------------X
000000000000000000000000000000000000000000000000000000000000XXXXXXXXX------X
000000000000000000000000000000000000000000000000000000000000XX-------------X
000000000000000000000000000000000000000000000000000000000000XX--------TTTTTT
000000000000000000000000000000000000000000000000000000000000XD-------------X
000000000000000000000000000000000000000000000000000000000000XD-------------X
000000000000000000000000000000000000000000000000000000000000TTTTXXXXXXXX--DX
000000000000000000000000000000000000000000000000000000000000--TTTTTTTT-----X
000000000000000000000000000000000000000000000000000000000000---------TTTTTTT
000000000000000000000000000000000000000000000000000000000000XT-X----------XX
000000000000000000000000000000000000000000000000000000000000X--XXXXX------XX
000000000000000000000000000000000000000000000000000000000000X--D----------XX
000000000000000000000000000000000000000000000000000000000000X-TX-----------X
000000000000000000000000000000000000000000000000000000000000X--X-----XXXX--X
000000000000000000000000000000000000000000000000000000000000X--X-----------X
000000000000000000000000000000000000000000000000000000000000X-TX-----------X
000000000000000000000000000000000000000000000000000000000000X--X-----------X
000000000000000000000000000000000000000000000000000000000000X--X-----------X
000000000000000000000000000000000000000000000000000000000000X---TT---------X
000000000000000000000000000000000000000000000000000000000000X--------------X
000000000000000000000000000000000000000000000000000000000000X--------------X
000000000000000000000000000000000000000000000000000000000000XXXXXXXXX------X
000000000000000000000000000000000000000000000000000000000000XX-------------X
000000000000000000000000000000000000000000000000000000000000XX--------TTTTTT
000000000000000000000000000000000000000000000000000000000000XD-------------X
000000000000000000000000000000000000000000000000000000000000XD-------------X
000000000000000000000000000000000000000000000000000000000000TTTTXXXXXXXX--DX
000000000000000000000000000000000000000000000000000000000000--TTTTTTTT-----X
000000000000000000000000000000000000000000000000000000000000---------TTTTTTT
000000000000000000000000000000000000000000000000000000000000------XXXX------
000000000000000000000000000000000000000000000000000000000000----------------
000000000000000000000000000000000000000000000000000000000000---------XXXX---
000000000000000000000000000000000000000000000000000000000000XXXX------------
000000000000000000000000000000000000000000000000000000000000----------------
000000000000000000000000000000000000000000000000000000000000------TTTT------
000000000000000000000000000000000000000000000000000000000000----------------
000000000000000000000000000000000000000000000000000000000000---------TTT----
000000000000000000000000000000000000000000000000000000000000----------------
000000000000000000000000000000000000000000000000000000000000X-----------TTTT
000000000000000000000000000000000000000000000000000000000000X--------------X
000000000000000000000000000000000000000000000000000000000000X--------------X
000000000000000000000000000000000000000000000000000000000000XXXXXXXXX------X
000000000000000000000000000000000000000000000000000000000000XX-------------X
000000000000000000000000000000000000000000000000000000000000XX--------TTTTTT
000000000000000000000000000000000000000000000000000000000000XD-------------X
000000000000000000000000000000000000000000000000000000000000XD-------------X
000000000000000000000000000000000000000000000000000000000000TTTTXXXXXXXX--DX
000000000000000000000000000000000000000000000000000000000000--TTTTTTTT-----X
000000000000000000000000000000000000000000000000000000000000---------TTTTTTT
000000000000000000000000000000000000000000000000000000000000X---XXXX------XX
000000000000000000000000000000000000000000000000000000000000XX----XXXXXX--DX
000000000000000000000000000000000000000000000000000000000000XX-----XXXX----X
000000000000000000000000000000000000000000000000000000000000XX------------DX
000000000000000000000000000000000000000000000000000000000000XXXX--------XXXX
000000000000000000000000000000000000000000000000000000000000XXXXXX------XXXX
000000000000000000000000000000000000000000000000000000000000XXXX--------XXXX
000000000000000000000000000000000000000000000000000000000000XXXX--------XXXX
000000000000000000000000000000000000000000000000000000000000XX----TTTTTTTTXX
000000000000000000000000000000000000000000000000000000000000XX------------XX
000000000000000000000000000000000000000000000000000000000000XX------------XX
000000000000000000000000000000000000000000000000000000000000XXXXXXXX------XX
000000000000000000000000000000000000000000000000000000000000XXXX----------XX
000000000000000000000000000000000000000000000000000000000000XX------------XX
000000000000000000000000000000000000000000000000000000000000XX--------XXXXXX
000000000000000000000000000000000000000000000000000000000000XD-------------X
000000000000000000000000000000000000000000000000000000000000XD-------------X
000000000000000000000000000000000000000000000000000000000000TTTTXXXXXXXX--DX
000000000000000000000000000000000000000000000000000000000000--TTTTTTTT-----X
000000000000000000000000000000000000000000000000000000000000---------TTTTTTT
000000000000000000000000000000000000000000000000000000000000----------------
000000000000000000000000000000000000000000000000000000000000----------------
000000000000000000000000000000000000000000000000000000000000----TTTT--------
000000000000000000000000000000000000000000000000000000000000----------------
000000000000000000000000000000000000000000000000000000000000----------------
000000000000000000000000000000000000000000000000000000000000------TTTT------
000000000000000000000000000000000000000000000000000000000000----------------
000000000000000000000000000000000000000000000000000000000000---------XXXX---
000000000000000000000000000000000000000000000000000000000000----------------
000000000000000000000000000000000000000000000000000000000000X-----------TTTT
000000000000000000000000000000000000000000000000000000000000X--------------X
000000000000000000000000000000000000000000000000000000000000X--------------X
000000000000000000000000000000000000000000000000000000000000XXXXXXXXX------X
000000000000000000000000000000000000000000000000000000000000XX-------------X
000000000000000000000000000000000000000000000000000000000000XX--------TTTTTT
000000000000000000000000000000000000000000000000000000000000XD-------------X
000000000000000000000000000000000000000000000000000000000000XD-------------X
000000000000000000000000000000000000000000000000000000000000TTTTXXXXXXXX--DX
000000000000000000000000000000000000000000000000000000000000--TTTTTTTT-----X
000000000000000000000000000000000000000000000000000000000000---------TTTTTTT
000000000000000000000000000000000000000000000000000000000000-------------X--
000000000000000000000000000000000000000000000000000000000000-------------X--
000000000000000000000000000000000000000000000000000000000000-------------X--
000000000000000000000000000000000000000000000000000000000000-------------X--
000000000000000000000000000000000000000000000000000000000000----------------
000000000000000000000000000000000000000000000000000000000000----------------
000000000000000000000000000000000000000000000000000000000000----------------
000000000000000000000000000000000000000000000000000000000000XXXX------------
000000000000000000000000000000000000000000000000000000000000XXXX------------
000000000000000000000000000000000000000000000000000000000000XXXXXXXX--------
000000000000000000000000000000000000000000000000000000000000X---XXXXXXXX----
000000000000000000000000000000000000000000000000000000000000X-----------XXXX
000000000000000000000000000000000000000000000000000000000000XX----------XXXX
000000000000000000000000000000000000000000000000000000000000XXXXXXXXX---XXXX
000000000000000000000000000000000000000000000000000000000000XD-------TTTT--X
000000000000000000000000000000000000000000000000000000000000XD-------------X
000000000000000000000000000000000000000000000000000000000000XD-------------X
000000000000000000000000000000000000000000000000000000000000TTTTXXXXXXXX--XX
000000000000000000000000000000000000000000000000000000000000--TTTTTTTT-----X
000000000000000000000000000000000000000000000000000000000000---------TTTTTTT
000000000000000000000000000000000000000000000000000000000000X--------------X
000000000000000000000000000000000000000000000000000000000000X----------X---X
000000000000000000000000000000000000000000000000000000000000X---------DX---X
000000000000000000000000000000000000000000000000000000000000X----------D---X
------------------------------------------------------------X---XXXXXXXX---X
------------------------------------------------------------X--------------X
------------------------------------------------------------X-----------XXXX
------------------------------------------------------------X-------------XX
------------------------------------------------------------X-------------XX
------------------------------------------------------------X-------------XX
------------------------------------------------------------X-------------XX
----------------------------------------------------XXXX----XXXXXXXX------XX
---------------------------------------------------XXXXX----XX------------XX
--------------------------------------------------XXXXXX----XX--------TTTTTX
------------E----E-------------------------------XXXXXXX----XX------------XX
----------------<>------------------------------XXXXXXXX----XD-------------X
----------------[]-----------------------------XXXXXXXXX----XD-------------X
----------------[]----------------------------XXXXXXXXXX----TTTTXXXXXXXX--DX
----------------[]------------E---EE--------XXXXXXXXXXXX------TTTTTTTT-----X
XXXXXXXXXXXXXXXXXXXXXXXXXXXXXXXXXXXXXXXXXXXXXXXXXXXXXXXXXXXX---------TTTTTTT
0000000000000000000000000000000000000000000000000000000000000000000000000000