00000000000000000000000000000000000000000000000000000000000000000000-------------------------00000000000000000000000000000000000000000000000000000000000000000000000000000000000000000000000000000000000000000000000000000000000000000000000
00000000000000000000000000000000000000000000000000000000000000000000-------------------------0000000000000000----------------------------------------------------------------------------------------------------------------000000000000000
00000000000000000000000000000000000000000000000000000000000000000000-------------------------0000000000000000----------------------------------------------------------------------------------------------------------------000000000000000
00000000000000000000000000000000000000000000000000000000000000000000-------------------------0000000000000000----------------------------------------------------------------------------------------------------------------000000000000000
00000000000000000000000000000000000000000000000000000000000000000000-------------------------0000000000000000----------------------------------------------------------------------------------------------------------------000000000000000
00000000000000000000000000000000000000000000000000000000000000000000-------------------------0000000000000000----------------------------------------------------------------------------------------------------------------000000000000000
00000000000000000000000000000000000000000000000000000000000000000000-------------------------0000000000000000----------------------------------------------------------------------------------------------------------------000000000000000
00000000000000000000000000000000000000000000000000000000000000000000-------------------------0000000000000000----------------------------------------------------------------------------------------------------------------000000000000000
00000000000000000000000000000000000000000000000000000000000000000000-------------------------0000000000000000-------------------S-------------------------------------------------------------XX-----------------------------000000000000000
00000000000000000000000000000000000000000000000000000000000000000000-------------------------0000000000000000---------------------------------------------------------------------------------XX-----------------------------000000000000000
00000000000000000000000000000000000000000000000000000000000000000000-------------------------0000000000000000-------X-------------------------------------------------------------------------XX-----------------------------000000000000000
00000000000000000000000000000000000000000000000000000000000000000000-----------E-------------0000000000000000----X--------------------------------------------------------------------------X-XX-----------------------------000000000000000
00000000000000000000000000000000000000000000000000000000000000000000----------<>-------------0000000000000000---XX-------------------------------------------------------------------------XX-XX-----oo---------------XXXXXXX000000000000000
00000000000000000000000000000000000000000000000000000000000000000000-----------]-------------0000000000000000--XXX-----------------------E-----------------------------------------------XXXX-XX-----------------------------000000000000000
0000000000000000000000000000000000000000000000000000-----------------------E-----------------0000000000000000-XXXX----------------------------------------------------------------------XXXXX-XX-----------------------------000000000000000
0000000000000000000000000000000000000000000000000000----------------XXXXXXXXXXXXXXXXXXXXXXXXX-----------T--XXXXXXX-----------E------------------------------E---EE-----E---------------XXXXXX-XX-------------------E---------000000000000000
0000000000000000000000000000000000000000000000000000-------------X--00000000000000000000000000000000000000000XXXXXXXXXXXXXXXXXXXXXXXXXXXXXXXXXXXXXXXXXXXXXXXXXXXXXXXXXXXXXXXXXXXXXXXXXXXXXXXXXXXXXXXXXXXXXXXXXXXXXXXXX-------000000000000000
0000000000000000000000000000000000000000000000000000----------------000000000000000000000000000000000000000000000000000000000000000000000000000000000000000000000000000000000000000000000000000000000000000000000000000000000000000000000000
0000000000000000000000000000000000000000000000000000----------------000000000000000000000000000000000000000000000000000000000000000000000000000000000000000000000000000000000000000000000000000000000000000000000000000000000000000000000000
0000000000000000000000000000000000000000000000000000XXXX--TTTT------000000000000000000000000000000000000000000000000000000000000000000000000000000000000000000000000000000000000000000000000000000000000000000000000000000000000000000000000
0000000000000000000000000000000000000000000000000000----------------000000000000000000000000000000000000000000000000000000000000000000000000000000000000000000000000000000000000000000000000000000000000000000000000000000000000000000000000
0000000000000000--------------------------------------TTTTTTTT------000000000000000000000000000000000000000000000000000000000000000000000000000000000000000000000000000000000000000000000000000000000000000000000000000000000000000000000000
0000000000000000------------------------------------0000000000000000000000000000000000000000000000000000000000000000000000000000000000000000000000000000000000000000000000000000000000000000000000000000000000000000000000000000000000000000
0000000000000000------------------------------------0000000000000000000000000000000000000000000000000000000000000000000000000000000000000000000000000000000000000000000000000000000000000000000000000000000000000000000000000000000000000000
0000000000000000------------------------------------0000000000000000000000000000000000000000000000000000000000000000000000000000000000000000000000000000000000000000000000000000000000000000000000000000000000000000000000000000000000000000
0000000000000000------------------------------------0000000000000000000000000000000000000000000000000000000000000000000000000000000000000000000000000000000000000000000000000000000000000000000000000000000000000000000000000000000000000000
0000000000000000------------------------------------0000000000000000000000000000000000000000000000000000000000000000000000000000000000000000000000000000000000000000000000000000000000000000000000000000000000000000000000000000000000000000
------XX--------X-----------------------------------0000000000000000000000000000000000000000000000000000000000000000000000000000000000000000000000000000000000000000000000000000000000000000000000000000000000000000000000000000000000000000
------XX--------X-----------------------------------0000000000000000000000000000000000000000000000000000000000000000000000000000000000000000000000000000000000000000000000000000000000000000000000000000000000000000000000000000000000000000
XXXXXXXX----XXXXX-----------------------------------0000000000000000000000000000000000000000000000000000000000000000000000000000000000000000000000000000000000000000000000000000000000000000000000000000000000000000000000000000000000000000
----------------X-----------------------------------0000000000000000000000000000000000000000000000000000000000000000000000000000000000000000000000000000000000000000000000000000000000000000000000000000000000000000000000000000000000000000
----------------X-------------------------------E---0000000000000000000000000000000000000000000000000000000000000000000000000000000000000000000000000000000000000000000000000000000000000000000000000000000000000000000000000000000000000000
-----TT---------X--------S---------------------<>---0000000000000000000000000000000000000000000000000000000000000000000000000000000000000000000000000000000000000000000000000000000000000000000000000000000000000000000000000000000000000000
----------------X------------------------------[]---0000000000000000000000000000000000000000000000000000000000000000000000000000000000000000000000000000000000000000000000000000000000000000000000000000000000000000000000000000000000000000
----------------X------------------------------[]---0000000000000000000000000000000000000000000000000000000000000000000000000000000000000000000000000000000000000000000000000000000000000000000000000000000000000000000000000000000000000000
--------TTTT----X---------------------E-----E--[]---0000000000000000000000000000000000000000000000000000000000000000000000000000000000000000000000000000000000000000000000000000000000000000000000000000000000000000000000000000000000000000
----------------XXXXXXXXXXXXXXXXXXXXXXXXXXXXXXXXX---0000000000000000000000000000000000000000000000000000000000000000000000000000000000000000000000000000000000000000000000000000000000000000000000000000000000000000000000000000000000000000
--TTTTTTTT------0000000000000000000000000000000000000000000000000000000000000000000000000000000000000000000000000000000000000000000000000000000000000000000000000000000000000000000000000000000000000000000000000000000000000000000000000000
----------------0000000000000000000000000000000000000000000000000000000000000000000000000000000000000000000000000000000000000000000000000000000000000000000000000000000000000000000000000000000000000000000000000000000000000000000000000000
----------------0000000000000000000000000000000000000000000000000000000000000000000000000000000000000000000000000000000000000000000000000000000000000000000000000000000000000000000000000000000000000000000000000000000000000000000000000000
XXXX----------XX0000000000000000000000000000000000000000000000000000000000000000000000000000000000000000000000000000000000000000000000000000000000000000000000000000000000000000000000000000000000000000000000000000000000000000000000000000
XD-------------X0000000000000000000000000000000000000000000000000000000000000000000000000000000000000000000000000000000000000000000000000000000000000000000000000000000000000000000000000000000000000000000000000000000000000000000000000000
XD-------------X0000000000000000000000000000000000000000000000000000000000000000000000000000000000000000000000000000000000000000000000000000000000000000000000000000000000000000000000000000000000000000000000000000000000000000000000000000
XXXXX---XXXXXXXX0000000000000000000000000000000000000000000000000000000000000000000000000000000000000000000000000000000000000000000000000000000000000000000000000000000000000000000000000000000000000000000000000000000000000000000000000000
XXXXXXXXXXXXXXXX0000000000000000000000000000000000000000000000000000000000000000000000000000000000000000000000000000000000000000000000000000000000000000000000000000000000000000000000000000000000000000000000000000000000000000000000000000