00000000000000000000000000000000000000000000000000000000----E--------E--
00000000000000000000000000000000000000000000000000000000MMMMMMMMMMMMMMMM
00000000000000000000000000000000000000000000000000000000----------------
00000000000000000000000000000000000000000000000000000000----------------
00000000000000000000000000000000000000000000000000000000---------TTT----
00000000000000000000000000000000000000000000000000000000----------------
00000000000000000000000000000000000000000000000000000000X-----------TTTT
00000000000000000000000000000000000000000000000000000000X--------------X
00000000000000000000000000000000000000000000000000000000X-----------D--X
00000000000000000000000000000000000000000000000000000000X----------DXXXX
00000000000000000000000000000000000000000000000000000000X-----XXXXXXXXXX
00000000000000000000000000000000000000000000000000000000X------XXXXXXXXX
00000000000000000000000000000000000000000000000000000000XXXXXXXX----XXXX
00000000000000000000000000000000000000000000000000000000XXXXXXXXXXXXXXXX
00000000000000000000000000000000000000000000000000000000XD-------TTTT--X
00000000000000000000000000000000000000000000000000000000XD-------------X
00000000000000000000000000000000000000000000000000000000XD-------------X
00000000000000000000000000000000000000000000000000000000TTTTXXXXXXXX--XX
00000000000000000000000000000000000000000000000000000000--TTTTTTTT-----X
00000000000000000000000000000000000000000000000000000000---------TTTTTTT
00000000000000000000000000000000000000000000000000000000XXXX----------XX
00000000000000000000000000000000000000000000000000000000XXXX----------DX
00000000000000000000000000000000000000000000000000000000XXXX----------DX
00000000000000000000000000000000000000000000000000000000XXXX----XXXXXXXX
00000000000000000000000000000000000000000000000000000000---X-X----------
00000000000000000000000000000000000000000000000000000000---X------------
00000000000000000000000000000000000000000000000000000000XXX-----------XX
00000000000000000000000000000000000000000000000000000000XXXXXXXXXX----XX
00000000000000000000000000000000000000000000000000000000XX------------XX
00000000000000000000000000000000000000000000000000000000XX------------XX
00000000000000000000000000000000000000000000000000000000XX------XXXXXXXX
00000000000000000000000000000000000000000000000000000000XXXX----------XX
00000000000000000000000000000000000000000000000000000000XX------------XX
00000000000000000000000000000000000000000000000000000000XXXXXXXX------XX
00000000000000000000000000000000000000000000000000000000XD--TTTT-------X
00000000000000000000000000000000000000000000000000000000XD-------------X
00000000000000000000000000000000000000000000000000000000XD-------------X
00000000000000000000000000000000000000000000000000000000TTTTXXXXXXXX--XX
00000000000000000000000000000000000000000000000000000000--TTTTTTTT-----X
000000000000000000000000000000000000-----------------------------TTTTTTT
000000000000000000000000000000000000--------------------0000000000000000
000000000000000000000000000000000000--------------------0000000000000000
000000000000000000000000000000000000--------------------0000000000000000
000000000000000000000000000000000000--------------------0000000000000000
000000000000000000000000000000000000--------------------0000000000000000
000000000000000000000000000000000000--------------------0000000000000000
000000000000000000000000000000000000-------<------------0000000000000000
000000000000000000000000000000000000-------[E-----------0000000000000000
000000000000000000000000000000000000-------[>-----------0000000000000000
000000000000000000000000000000000000-------[]-----------0000000000000000
000000000000000000000000000000000000--XXXXX[]----X------0000000000000000
000000000000000000000000000000000000-------[]---XX------0000000000000000
000000000000000000000000000000000000-------[]--XXX------0000000000000000
000000000000000000000000000000000000-------[]--XXXX-----0000000000000000
00000000000000000000-------X--------XX-----XXXXXXXXXXXX-0000000000000000
00000000000000000000-------X--------000000000000000000000000000000000000
00000000000000000000-------X--------000000000000000000000000000000000000
00000000000000000000-------X--------000000000000000000000000000000000000
00000000000000000000----------------000000000000000000000000000000000000
00000000000000000000--------------X-000000000000000000000000000000000000
00000000000000000000----------------000000000000000000000000000000000000
00000000000000000000---------TTT----000000000000000000000000000000000000
00000000000000000000----------------000000000000000000000000000000000000
00000000000000000000X-----------TTTT000000000000000000000000000000000000
00000000000000000000X--------------X000000000000000000000000000000000000
00000000000000000000X--------------X000000000000000000000000000000000000
00000000000000000000XXXXXXXXX------X000000000000000000000000000000000000
00000000000000000000XX-------------X000000000000000000000000000000000000
00000000000000000000XX--------TTTTTT000000000000000000000000000000000000
00000000000000000000XD-------------X000000000000000000000000000000000000
00000000000000000000XD-------------X000000000000000000000000000000000000
00000000000000000000TTTTXXXXXXXX---X000000000000000000000000000000000000
00000000000000000000--TTTTTTTT-----X000000000000000000000000000000000000
00000000000000000000---------TTTTTTT000000000000000000000000000000000000
00000000000000000000------XX--------000000000000000000000000000000000000
00000000000000000000XXXXXXXX----XXXX000000000000000000000000000000000000
00000000000000000000----------------000000000000000000000000000000000000
00000000000000000000------T---------000000000000000000000000000000000000
00000000000000000000--------------X-000000000000000000000000000000000000
00000000000000000000----------------000000000000000000000000000000000000
00000000000000000000---------TTT----000000000000000000000000000000000000
00000000000000000000----------------000000000000000000000000000000000000
00000000000000000000X-----------TTTT000000000000000000000000000000000000
00000000000000000000X--------------X000000000000000000000000000000000000
00000000000000000000X--------------X000000000000000000000000000000000000
00000000000000000000XXXXXXXXX------X000000000000000000000000000000000000
00000000000000000000XX-------------X000000000000000000000000000000000000
00000000000000000000XX--------TTTTTT000000000000000000000000000000000000
00000000000000000000XX-------------X000000000000000000000000000000000000
00000000000000000000XD-------------X000000000000000000000000000000000000
00000000000000000000XD-------------X000000000000000000000000000000000000
00000000000000000000TTTTXXXXXXXX--DX000000000000000000000000000000000000
00000000000000000000--TTTTTTTT-----X000000000000000000000000000000000000
00000000000000000000---------TTTTTTT000000000000000000000000000000000000
00000000000000000000-------------XX-000000000000000000000000000000000000
00000000000000000000--------------X-000000000000000000000000000000000000
00000000000000000000--------------X-000000000000000000000000000000000000
00000000000000000000----------------000000000000000000000000000000000000
00000000000000000000----------------000000000000000000000000000000000000
00000000000000000000----------------000000000000000000000000000000000000
00000000000000000000-------------X--000000000000000000000000000000000000
00000000000000000000----------------000000000000000000000000000000000000
00000000000000000000----------------000000000000000000000000000000000000
00000000000000000000X-----------TTTT000000000000000000000000000000000000
00000000000000000000X--------------X000000000000000000000000000000000000
00000000000000000000X--------------X000000000000000000000000000000000000
00000000000000000000XXXXXXXXX------X000000000000000000000000000000000000
00000000000000000000XX-------------X000000000000000000000000000000000000
00000000000000000000XX--------TTTTTT000000000000000000000000000000000000
00000000000000000000XD-------------X000000000000000000000000000000000000
00000000000000000000XD-------------X000000000000000000000000000000000000
00000000000000000000TTTTXXXXXXXX--DX000000000000000000000000000000000000
00000000000000000000--TTTTTTTT-----X000000000000000000000000000000000000
00000000000000000000---------TTTTTTT000000000000000000000000000000000000
00000000000000000000----------------000000000000000000000000000000000000
00000000000000000000---XXXX---------000000000000000000000000000000000000
00000000000000000000----------------000000000000000000000000000000000000
00000000000000000000----------------000000000000000000000000000000000000
00000000000000000000----TTTT--------000000000000000000000000000000000000
00000000000000000000----------------000000000000000000000000000000000000
00000000000000000000----------------000000000000000000000000000000000000
00000000000000000000---------TTT----000000000000000000000000000000000000
00000000000000000000----------------000000000000000000000000000000000000
00000000000000000000X-----------TTTT000000000000000000000000000000000000
00000000000000000000X--------------X000000000000000000000000000000000000
00000000000000000000X--------------X000000000000000000000000000000000000
00000000000000000000XXXXXXXXX------X000000000000000000000000000000000000
00000000000000000000XX-------------X000000000000000000000000000000000000
00000000000000000000XX--------TTTTTT000000000000000000000000000000000000
00000000000000000000XD-------------X000000000000000000000000000000000000
00000000000000000000XD-------------X000000000000000000000000000000000000
00000000000000000000TTTTXXXXXXXX--DX000000000000000000000000000000000000
00000000000000000000--TTTTTTTT-----X000000000000000000000000000000000000
00000000000000000000---------TTTTTTT000000000000000000000000000000000000
00000000000000000000---------TTTT---000000000000000000000000000000000000
00000000000000000000----------------000000000000000000000000000000000000
00000000000000000000XXXX--------XXXX000000000000000000000000000000000000
00000000000000000000----------------000000000000000000000000000000000000
00000000000000000000----------------000000000000000000000000000000000000
00000000000000000000-----TTTT-------000000000000000000000000000000000000
00000000000000000000----------------000000000000000000000000000000000000
00000000000000000000----------------000000000000000000000000000000000000
00000000000000000000---------TTTT---000000000000000000000000000000000000
00000000000000000000X-----------TTTT000000000000000000000000000000000000
00000000000000000000X--------------X000000000000000000000000000000000000
00000000000000000000X--------------X000000000000000000000000000000000000
00000000000000000000XXXXXXXXX------X000000000000000000000000000000000000
00000000000000000000XX-------------X000000000000000000000000000000000000
00000000000000000000XX--------TTTTTT000000000000000000000000000000000000
00000000000000000000XD-------------X000000000000000000000000000000000000
00000000000000000000XD-------------X000000000000000000000000000000000000
00000000000000000000TTTTXXXXXXXX--DX000000000000000000000000000000000000
00000000000000000000--TTTTTTTT-----X000000000000000000000000000000000000
00000000000000000000---------TTTTTTT000000000000000000000000000000000000
00000000000000000000----------------000000000000000000000000000000000000
00000000000000000000---X------------000000000000000000000000000000000000
00000000000000000000----------------000000000000000000000000000000000000
00000000000000000000----------------000000000000000000000000000000000000
---------------------TTTT-----------000000000000000000000000000000000000
------------------------------------000000000000000000000000000000000000
------------------------------------000000000000000000000000000000000000
---------------------------TT-------000000000000000000000000000000000000
------------------------------------000000000000000000000000000000000000
------------------------------------000000000000000000000000000000000000
-------------------------------TTTT-000000000000000000000000000000000000
--------------------XX----------XXXX000000000000000000000000000000000000
--------------------XX--------------000000000000000000000000000000000000
--------------------XX--------------000000000000000000000000000000000000
---------E----------XX--------TTT---000000000000000000000000000000000000
--------<>----------XD--------------000000000000000000000000000000000000
--X-----[]----------XD-------------X000000000000000000000000000000000000
--X-----[]----------TTTTXXXXXXXX--DX000000000000000000000000000000000000
--X-----[]------------TTTTTTTT-----X000000000000000000000000000000000000
XXXXXXXXXXXXXXXXXXXX---------TTTTTTT000000000000000000000000000000000000
000000000000000000000000000000000000000000000000000000000000000000000000