0000000000000000000000000000000000000000000000000000000000000000000000000000000000000000000000000000000000000000000000000000000000000000------------------------------------------------------------000000000000000
0000000000000000000000000000000000000000000000000000000000000000000000000000000000000000000000000000000000000000000000000000000000000000------------------------------------------------------------000000000000000
0000000000000000000000000000000000000000000000000000000000000000000000000000000000000000000000000000000000000000000000000000000000000000------------------------------------------------------------000000000000000
0000000000000000000000000000000000000000000000000000000000000000000000000000000000000000000000000000000000000000000000000000000000000000------------------------------------------------------------000000000000000
0000000000000000000000000000000000000000000000000000000000000000000000000000000000000000000000000000000000000000000000000000000000000000------------------------------------------------------------000000000000000
0000000000000000000000000000000000000000000000000000000000000000000000000000000000000000000000000000000000000000000000000000000000000000------------------------------------------------------------000000000000000
0000000000000000000000000000000000000000000000000000000000000000000000000000000000000000000000000000000000000000000000000000000000000000------------------------------------------------------------000000000000000
0000000000000000000000000000000000000000000000000000000000000000000000000000000000000000000000000000000000000000000000000000000000000000------------------------------------------------------------000000000000000
0000000000000000000000000000000000000000000000000000000000000000000000000000000000000000000000000000000000000000000000000000000000000000-------------------------------------XX---------------------000000000000000
0000000000000000000000000000000000000000000000000000000000000000000000000000000000000000000000000000000000000000000000000000000000000000---------------------------------------X--------------------000000000000000
0000000000000000000000000000000000000000000000000000000000000000000000000000000000000000000000000000000000000000000000000000000000000000-------E-----------------------------------------------oo---000000000000000
0000000000000000000000000000000000000000000000000000000000000000000000000000000000000000000000000000000000000000000000000000000000000000------<>-------------------------XX---------X---------------000000000000000
0000000000000000000000000000000000000000000000000000000000000000000000000000000000000000000000000000000000000000000000000000000000000000------[]---------------<>--------XX--------XX---------------000000000000000
0000000000000000000000000000000000000000000000000000000000000000000000000000000000000000000000000000000000000000000000000000000000000000------[]---------------[]--------XXX------XXX---------------000000000000000
0000000000000000000000000000000000000000000000000000000000000000000000000000000000000000000000000000000000000000000000000000000000000000------[]------E--------[]--------XX-------XXX---------------000000000000000
000000000000000000000000000000000000000000000000000000000000000000000000000000000000000000000000000000000000000000000000----------------XXXXXXXXXXXXXXXXXXX-XXXXXXXXXXXXXX------XXXXXXXXXXXXX-------000000000000000
000000000000000000000000000000000000000000000000000000000000000000000000000000000000000000000000000000000000000000000000---TTTT---------000000000000000000000000000000000000000000000000000000000000000000000000000
000000000000000000000000000000000000000000000000000000000000000000000000000000000000000000000000000000000000000000000000----------------000000000000000000000000000000000000000000000000000000000000000000000000000
000000000000000000000000000000000000000000000000000000000000000000000000000000000000000000000000000000000000000000000000----------------000000000000000000000000000000000000000000000000000000000000000000000000000
000000000000000000000000000000000000000000000000000000000000000000000000000000000000000000000000000000000000000000000000XX-----TTTT---XX000000000000000000000000000000000000000000000000000000000000000000000000000
000000000000000000000000000000000000000000000000000000000000000000000000000000000000000000000000000000000000000000000000XX------------XX000000000000000000000000000000000000000000000000000000000000000000000000000
000000000000000000000000000000000000000000000000000000000000000000000000000000000000000000000000000000000000000000000000XX------------XX000000000000000000000000000000000000000000000000000000000000000000000000000
000000000000000000000000000000000000000000000000000000000000000000000000000000000000000000000000000000000000000000000000XXXX--------XXXX000000000000000000000000000000000000000000000000000000000000000000000000000
000000000000000000000000000000000000000000000000000000000000000000000000000000000000000000000000000000000000000000000000XXXX--------XXXX000000000000000000000000000000000000000000000000000000000000000000000000000
000000000000000000000000000000000000000000000000000000000000000000000000000000000000000000000000000000000000000000000000XXXX--------XXXX000000000000000000000000000000000000000000000000000000000000000000000000000
000000000000000000000000000000000000000000000000000000000000000000000000000000000000000000000000000000000000000000000000XXXX--------XXXX000000000000000000000000000000000000000000000000000000000000000000000000000
000000000000000000000000000000000000000000000000000000000000000000000000000000000000000000000000000000000000000000000000XXXX--------XXXX000000000000000000000000000000000000000000000000000000000000000000000000000
000000000000000000000000000000000000000000000000000000000000000000000000000000000000000000000000000000000000000000000000XX----TTTTTTTTXX000000000000000000000000000000000000000000000000000000000000000000000000000
000000000000000000000000000000000000000000000000000000000000000000000000000000000000000000000000000000000000000000000000XX------------XX000000000000000000000000000000000000000000000000000000000000000000000000000
000000000000000000000000000000000000000000000000000000000000000000000000000000000000000000000000000000000000000000000000XX------------XX000000000000000000000000000000000000000000000000000000000000000000000000000
000000000000000000000000000000000000000000000000000000000000000000000000000000000000000000000000000000000000000000000000XX----XXXXX---XX000000000000000000000000000000000000000000000000000000000000000000000000000
000000000000000000000000000000000000000000000000000000000000000000000000000000000000000000000000000000000000000000000000XD------------XX000000000000000000000000000000000000000000000000000000000000000000000000000
000000000000000000000000000000000000000000000000000000000000000000000000000000000000000000000000000000000000000000000000XD------------XX000000000000000000000000000000000000000000000000000000000000000000000000000
000000000000000000000000000000000000000000000000000000000000000000000000000000000000000000000000000000000000000000000000XXXXX-------XXXX000000000000000000000000000000000000000000000000000000000000000000000000000
------------------------------------------------------------------------------------------------------------------------XXXXXXXXXXXXXXXX000000000000000000000000000000000000000000000000000000000000000000000000000
------------------------------------------------------------------------------------------------------------------------0000000000000000000000000000000000000000000000000000000000000000000000000000000000000000000
------------------------------------------------------------------------------------------------------------------------0000000000000000000000000000000000000000000000000000000000000000000000000000000000000000000
------------------------------------------------------------------------------------------------------------------------0000000000000000000000000000000000000000000000000000000000000000000000000000000000000000000
------------------------------------------------------------------------------------------------------------------------0000000000000000000000000000000000000000000000000000000000000000000000000000000000000000000
------------------------------------------------------------------------------------------------------------------------0000000000000000000000000000000000000000000000000000000000000000000000000000000000000000000
------------------------------------------------------------------------------------------------------------------------0000000000000000000000000000000000000000000000000000000000000000000000000000000000000000000
----------------------------------SSS----------------------------SSS------------------------------X---------------------0000000000000000000000000000000000000000000000000000000000000000000000000000000000000000000
-------------------------------------------------------------------------------------------------EXX--------------------0000000000000000000000000000000000000000000000000000000000000000000000000000000000000000000
------------------------------------------------------------------------------------------------XXXX--------------------0000000000000000000000000000000000000000000000000000000000000000000000000000000000000000000
--------------------------E-----E--------------------E------------------------------------------XXXX--------------------0000000000000000000000000000000000000000000000000000000000000000000000000000000000000000000
-------------------------<>----<>-------------------<>--E---------------------X---------------XXXXXX--------------------0000000000000000000000000000000000000000000000000000000000000000000000000000000000000000000
-------------------------[]----[]-------------------[]-<>--S-----------------XXX--------------XXXXXX--------------------0000000000000000000000000000000000000000000000000000000000000000000000000000000000000000000
-------------------------[]----[]-------------------[]-[]-------------------XXXX--------------XXXXXX-------------E------0000000000000000000000000000000000000000000000000000000000000000000000000000000000000000000
----------------X--------[]-E--[]---------E-EE------[]-[]-------------------XXXX--------------XXXXXX-------E---------X--0000000000000000000000000000000000000000000000000000000000000000000000000000000000000000000
XXXXXXXX----XXXXXXX-XXXXXXXXXXXXXX---X--XXXXXXXXXXXXXXXXXXX-XXXXXXXXXXXXXXXXXXXXXXXXXXXXXXXXXXXXXXXXXXXXXXXXXXXXXXXXXXX-0000000000000000000000000000000000000000000000000000000000000000000000000000000000000000000
0000000000000000000000000000000000000000000000000000000000000000000000000000000000000000000000000000000000000000000000000000000000000000000000000000000000000000000000000000000000000000000000000000000000000000000