--------------------------------------------------------------------------------------------------------------------------------------------------------------------------------------------------------000000000000000
--------------------------------------------------------------------------------------------------------------------------------------------------------------------------------------------------------000000000000000
--------------------------------------------------------------------------------------------------------------------------------------------------------------------------------------------------------000000000000000
--------------------------------------------------------------------------------------------------------------------------------------------------------------------------------------------------------000000000000000
--------------------------------------------------------------------------------------------------------------------------------------------------------------------------------------------------------000000000000000
--------------------------------------------------------------------------------------------------------------------------------------------------------------------------------------------------------000000000000000
-----------------------------------------------------------------------------------------XX-------------------------------------------------------------------------------------------------------------000000000000000
------------------------E---E--------------S--------------------------------------------X---------------SS-----XX----------------------------------------------------------SSQ--------------------------000000000000000
-----------------------<>--------------------------------------------------------------------------------------XX------------------------------------------------------------------Q--------------------000000000000000
-----------------------[]------------------------------------------------------------------------------------XXXX---------------------------------------------------------------------------------------000000000000000
-----------------------[]-------E---------------------E--------E--------------E-----------------------------XXXXX----------------------E------------------E---------------------------------------------000000000000000
-----------------------XX------<>---------S---E------<>-------<>-------------SS------------------------E----XXXXX-----------X---------<>-------X---------<>-----------S?----?SSSQ------E----------------000000000000000
-------------------------E-----[]------------<>------[]-------[]--------------------XX-------------------E-XXXXXX-----------X---------[]-------X---------[]------------------------Q--<>--E--------S----000000000000000
-------------------------------[]------------[]------[]-------[]------------------------------------------XXXXXXX-----------X---------[]-------X---------[]---------------------------[]-<>-------------000000000000000
---------EE------E----E--------[]------------[]-E----[]-------[]-----E------------E-----------------------XXXXXXX-----------X--E------[]-------X---------[]-----------------E---------[]-[]-------------000000000000000
XXXXXXXXXXXXXXXXXXXEXXXXXXXXXXXXXXXXXXXEXXXXXXXXXXXXXXXXXXX-XXXXXXXXXXXXXXXXXXX-XXXX-----------XXXX-XXXXXXXXXXXXXXXXXXX-XXXXXXXXXXXXXXXXXXX-XXXXXXXXXXXXXXXXXXX-XXXXXXXXXXXXXXXXXXX-XXXXXXXXXX-XXXXXXXX-000000000000000
00000000000000000000000000000000000000000000000000000000000000000000000000000000000000000000000000000000000000000000000000000000000000000000000000000000000000000000000000000000000000000000000000000000000000000000000