00000000000000000000000000000000000000000000000000000000000000000000000000000000000000000000000000000000000000000000XXXX------XXXX--
00000000000000000000000000000000000000000000000000000000000000000000000000000000000000000000000000000000000000000000XXXX------XXXX--
00000000000000000000000000000000000000000000000000000000000000000000000000000000000000000000000000000000000000000000XXXX------XXXX--
00000000000000000000000000000000000000000000000000000000000000000000000000000000000000000000000000000000000000000000XXXX------XXXX--
00000000000000000000000000000000000000000000000000000000000000000000000000000000000000000000000000000000000000000000XXXX------XXXX--
00000000000000000000000000000000000000000000000000000000000000000000000000000000000000000000000000000000000000000000XXXX------XXXX--
00000000000000000000000000000000000000000000000000000000000000000000000000000000000000000000000000000000000000000000XXXX------XXXX--
00000000000000000000000000000000000000000000000000000000000000000000000000000000000000000000000000000000000000000000XXXX------XXXX--
00000000000000000000000000000000000000000000000000000000000000000000000000000000000000000000000000000000000000000000XXXX------XXXX--
00000000000000000000000000000000000000000000000000000000000000000000000000000000000000000000000000000000000000000000XXXX------XXXX--
00000000000000000000000000000000000000000000000000000000000000000000000000000000000000000000000000000000000000000000XXXX------XXXX--
00000000000000000000000000000000000000000000000000000000000000000000000000000000000000000000000000000000000000000000XXXX------XXXX--
00000000000000000000000000000000000000000000000000000000000000000000000000000000000000000000000000000000000000000000XXXX------XXXX--
00000000000000000000000000000000000000000000000000000000000000000000000000000000000000000000000000000000000000000000XXXX------XXXX--
00000000000000000000000000000000000000000000000000000000000000000000000000000000000000000000000000000000000000000000XXXX------XXXX--
00000000000000000000000000000000000000000000000000000000000000000000000000000000000000000000000000000000000000000000XXXX------XXXX--
00000000000000000000000000000000000000000000000000000000000000000000000000000000000000000000000000000000000000000000XXXX------XXXX--
00000000000000000000000000000000000000000000000000000000000000000000000000000000000000000000000000000000000000000000XXXX------XXXX--
00000000000000000000000000000000000000000000000000000000000000000000000000000000000000000000000000000000000000000000XXXX------XXXX--
00000000000000000000000000000000000000000000000000000000000000000000000000000000000000000000000000000000000000000000XXXX------XXXX--
00000000000000000000000000000000000000000000000000000000000000000000000000000000000000000000000000000000000000000000XXXX------XXXX--
00000000000000000000000000000000000000000000000000000000000000000000000000000000000000000000000000000000000000000000XXXX------XXXX--
00000000000000000000000000000000000000000000000000000000000000000000000000000000000000000000000000000000000000000000XXXX------XXXX--
00000000000000000000000000000000000000000000000000000000000000000000000000000000000000000000000000000000000000000000XXXX------XXXX--
00000000000000000000000000000000000000000000000000000000000000000000000000000000000000000000000000000000000000000000XXXX------XXXX--
00000000000000000000000000000000000000000000000000000000000000000000000000000000000000000000000000000000000000000000XXXX------XXXX--
00000000000000000000000000000000000000000000000000000000000000000000000000000000000000000000000000000000000000000000XXXX------XXXX--
00000000000000000000000000000000000000000000000000000000000000000000000000000000000000000000000000000000000000000000XXXX------XXXX--
00000000000000000000000000000000000000000000000000000000000000000000000000000000000000000000000000000000000000000000XXXX------XXXX--
00000000000000000000000000000000000000000000000000000000000000000000000000000000000000000000000000000000000000000000XXXX------XXXX--
00000000000000000000000000000000000000000000000000000000000000000000000000000000000000000000000000000000000000000000XXXX------XXXX--
00000000000000000000000000000000000000000000000000000000000000000000000000000000000000000000000000000000000000000000XXXX------XXXX--
00000000000000000000000000000000000000000000000000000000000000000000000000000000000000000000000000000000000000000000XXXX------XXXX--
00000000000000000000000000000000000000000000000000000000000000000000000000000000000000000000000000000000000000000000XXXX------XXXX--
00000000000000000000000000000000000000000000000000000000000000000000000000000000000000000000000000000000000000000000XXXX------XXXX--
00000000000000000000000000000000000000000000000000000000000000000000000000000000000000000000000000000000000000000000XXXX------XXXX--
00000000000000000000000000000000000000000000000000000000000000000000000000000000000000000000000000000000000000000000XXXX------XXXX--
00000000000000000000000000000000000000000000000000000000000000000000000000000000000000000000000000000000000000000000XXXXXXXE--XXXX--
00000000000000000000000000000000000000000000000000000000000000000000000000000000000000000000000000000000000000000000XXXX------XXXX--
00000000000000000000000000000000000000000000000000000000000000000000000000000000000000000000000000000000000000000000XXXX------XXXX--
00000000000000000000000000000000000000000000000000000000000000000000000000000000000000000000000000000000000000000000XXXX--XXXXXXXX--
00000000000000000000000000000000000000000000000000000000000000000000000000000000000000000000000000000000000000000000XXXX--------XXXX
00000000000000000000000000000000000000000000000000000000000000000000000000000000000000000000000000000000000000000000XXXX--------XXXX
00000000000000000000000000000000000000000000000000000000000000000000000000000000000000000000000000000000000000000000XXXX--------XXXX
00000000000000000000000000000000000000000000000000000000000000000000000000000000000000000000000000000000000000000000XXXX--------XXXX
00000000000000000000000000000000000000000000000000000000000000000000000000000000000000000000000000000000000000000000XXXX--------XXXX
00000000000000000000000000000000000000000000000000000000000000000000000000000000000000000000000000000000000000000000XXXX--XXXXXXXXXX
00000000000000000000000000000000000000000000000000000000000000000000000000000000000000000000000000000000000000000000XXXX--------XXXX
00000000000000000000000000000000000000000000000000000000000000000000000000000000000000000000000000000000000000000000XXXX--------XXXX
00000000000000000000000000000000000000000000000000000000000000000000000000000000000000000000000000000000000000000000XXXX--------XXXX
00000000000000000000000000000000000000000000000000000000000000000000000000000000000000000000000000000000000000000000XXXX--------XXXX
00000000000000000000000000000000000000000000000000000000000000000000000000000000000000000000000000000000000000000000XXXX----TTTTXXXX
00000000000000000000000000000000000000000000000000000000000000000000000000000000000000000000000000000000000000000000XXXX--------XXXX
00000000000000000000000000000000000000000000000000000000000000000000000000000000000000000000000000000000000000000000XXXX--------XXXX
00000000000000000000000000000000000000000000000000000000000000000000000000000000000000000000000000000000000000000000XXXX--------XXXX
00000000000000000000000000000000000000000000000000000000000000000000000000000000000000000000000000000000000000000000XXXX--------XXXX
00000000000000000000000000000000000000000000000000000000000000000000000000000000000000000000000000000000000000000000XXXX--------XXXX
00000000000000000000000000000000000000000000000000000000000000000000000000000000000000000000000000000000000000000000XXXX--------XXXX
00000000000000000000000000000000000000000000000000000000000000000000000000000000000000000000000000000000000000000000XXXX--------XXXX
00000000000000000000000000000000000000000000000000000000000000000000000000000000000000000000000000000000000000000000XXXX--------DXXX
00000000000000000000000000000000000000000000000000000000000000000000000000000000000000000000000000000000000000000000XXXX--------DXXX
00000000000000000000000000000000000000000000000000000000000000000000000000000000000000000000000000000000000000000000XXXX----XXXXXXXX
00000000000000000000000000000000000000000000000000000000000000000000000000000000000000000000000000000000000000000000XXXX--------XXXX
00000000000000000000000000000000000000000000000000000000000000000000000000000000000000000000000000000000000000000000XXXX--------XXXX
00000000000000000000000000000000000000000000000000000000000000000000000000000000000000000000000000000000000000000000XXXX--------XXXX
00000000000000000000000000000000000000000000000000000000000000000000000000000000000000000000000000000000000000000000XXXX--------XXXX
00000000000000000000000000000000000000000000000000000000000000000000000000000000000000000000000000000000000000000000XXXX--------XXXX
00000000000000000000000000000000000000000000000000000000000000000000000000000000000000000000000000000000000000000000XXXX--------XXXX
00000000000000000000000000000000000000000000000000000000000000000000000000000000000000000000000000000000000000000000XXXX--------XXXX
00000000000000000000000000000000000000000000000000000000000000000000000000000000000000000000000000000000000000000000XXXX--------XXXX
00000000000000000000000000000000000000000000000000000000000000000000000000000000000000000000000000000000000000000000XXTTTT------XXXX
00000000000000000000000000000000000000000000000000000000000000000000000000000000000000000000000000000000000000000000XXXX--------XXXX
00000000000000000000000000000000000000000000000000000000000000000000000000000000000000000000000000000000000000000000XXXX--------DXXX
00000000000000000000000000000000000000000000000000000000000000000000000000000000000000000000000000000000000000000000XXXX----XXXXXXXX
00000000000000000000000000000000000000000000000000000000000000000000000000000000000000000000000000000000000000000000XXXX--------XXXX
00000000000000000000000000000000000000000000000000000000000000000000000000000000000000000000000000000000000000000000XXXX--------XXXX
00000000000000000000000000000000000000000000000000000000000000000000000000000000000000000000000000000000000000000000XXXXXXX-----XXXX
00000000000000000000000000000000000000000000000000000000000000000000000000000000000000000000000000000000000000000000XXXX--------XXXX
00000000000000000000000000000000000000000000000000000000000000000000000000000000000000000000000000000000000000000000XX------------XX
00000000000000000000000000000000000000000000000000000000000000000000000000000000000000000000000000000000000000000000XX-----XXXX---DX
00000000000000000000000000000000000000000000000000000000000000000000000000000000000000000000000000000000000000000000XX------------DX
00000000000000000000000000000000000000000000000000000000000000000000000000000000000000000000000000000000000000000000XXXX--------XXXX
00000000000000000000000000000000000000000000000000000000000000000000000000000000000000000000000000000000000000000000XXXXXXX-----XXXX
00000000000000000000000000000000000000000000000000000000000000000000000000000000000000000000000000000000000000000---XXXX--------XXXX
00000000000000000000000000000000000000000000000000000000000000000000000000000000000000000000000000000000000000000---XX------------XX
00000000000000000000000000000000000000000000000000000000000000000000000000000000000000000000000000000000000000000---XX-----XXXX---XX
00000000000000000000000000000000000000000000000000000000000000000000000000000000000000000000000000000000000000000---XX------------XX
00000000000000000000000000000000000000000000000000000000000000000000000000000000000000000000000000000000000000000---XXXX-------XXXXX
0000000000000000000000000000000000000000000000000000000000000000000000000000000000000000000000000------TTTTTTTTTT--------------T-XXX
0000000000000000000000000000000000000000000000000000000000000000000000000000000000000000000000000--------------------------XEEEEEEXX
0000000000000000000000000000000000000000000000000000000000000000000000000000000000000000000000000----------------X-------T-XXXXXX-X-
----------------------------------------------------------------------------------------------------X------------X------------------
-------------------------------------------------------------------------------------------------0000000000000000X------------------
-------------------------------------------------------------------------------------------------0000000000000000X-------X----------
-------------------------------------------------------------------------------------------------0000000000000000XX--------X---XX---
-------------------------------------------------------------------------------------------------0000000000000000XXXXXXXXXXXXXXXXXXX
-------------------------------------------------------------------------------------------------0000000000000000XXX0000000000000000
-------------------------------------------------------------------------------------------------0000000000000000XXX0000000000000000
-------------------------------------------------------------------------------------------------0000000000000000XXX0000000000000000
-------------------------------------------------------------------------------------------------00000000000000000000000000000000000
-------------------------------------------------------------------------------------------------00000000000000000000000000000000000
---------------------------------------------------E---------------------------------------------00000000000000000000000000000000000
----------------E---------------------------------<>----SS-S-------------------------------------00000000000000000000000000000000000
---------------<>---------------------------------[]----XX---------------------------------------00000000000000000000000000000000000
---------------[]---------------------------------[]---XXXX--------------------------------------00000000000000000000000000000000000
-------------E-[]---------------E-E---------------[]--XXXXX-----E-------------------------E------00000000000000000000000000000000000
XXXXXXXXXXXXXXXXXXXXXXXXXXXXXXXXXXXXXXXXX-XXXXXXXXXXXXXXXXXXXXXXXXXXXXXXXXXXXXXXXXXXXXXXXXXXXX---00000000000000000000000000000000000
000000000000000000000000000000000000000000000000000000000000000000000000000000000000000000000000000000000000000000000000000000000000