000000000000000000000000000000000000000000000000000000000000000000000000000000000000000000000000000000000000--------------------000000000000000
000000000000000000000000000000000000000000000000000000000000000000000000000000000000000000000000000000000000--------------------000000000000000
000000000000000000000000000000000000000000000000000000000000000000000000000000000000000000000000000000000000--------------------000000000000000
000000000000000000000000000000000000000000000000000000000000000000000000000000000000000000000000000000000000--------------------000000000000000
00000000000000000000000000000000000000000000000000000000000000000000000000000000000000000000XXTTTT------XXXXS-------------------000000000000000
00000000000000000000000000000000000000000000000000000000000000000000000000000000000000000000XXXX------T-XXXXS-------------------000000000000000
00000000000000000000000000000000000000000000000000000000000000000000000000000000000000000000XX----------XXXXS---oooooo-XoooXXXEo000000000000000
00000000000000000000000000000000000000000000000000000000000000000000000000000000000000000000XX----------XXXXS--------XX-XXXX--XX000000000000000
0000000000000000000000000000000000000000000000000000----------------------------------------XX----TTXXXXXXXXS--o----------------000000000000000
0000000000000000000000000000000000000000000000000000----------------------------------------XXD-------------S---XX-XX-----------000000000000000
0000000000000000000000000000000000000000000000000000----------------------------------------XX--------------S-o-----------------000000000000000
000000000000000000000000000000000000---------TTT--------------------------------------------XTTTTTTTT-------S-------------------000000000000000
000000000000000000000000000000000000----------------S-------------------S-------------------X---------------S-------------------000000000000000
000000000000000000000000000000000000X-----------TTTTS-------------------S-------------------X---------------S-------------------000000000000000
000000000000000000000000000000000000X--------------XS-------------------S-------------------XXXX--------XXXXS-------------------000000000000000
000000000000000000000000000000000000X-----------D--XS-------------------S---------------XX--XXXX--------XXXXXXXXXXXXXXXXXXXXXXXX000000000000000
000000000000000000000000000000000000X----------DXXXXS-------------------S---------------XX--XXXXXXXE----XXXX00000000000000000000000000000000000
000000000000000000000000000000000000X-----XXXXXXXXXXS-------------------S--------------XXX--XXXX--------XXXX00000000000000000000000000000000000
000000000000000000000000000000000000X-----XXXX------S--------X----------S-----E-------XXXX--XX------------XX00000000000000000000000000000000000
000000000000000000000000000000000000---X------------S------SE-----------S----<>------XXXXX--XX----XXXXX---XX00000000000000000000000000000000000
000000000000000000000000000000000000---X-X---XXXX---S-------------------S----[]-----XXXXXX--XD------------XX00000000000000000000000000000000000
000000000000000000000000000000000000---X------------S-------------------S----[]----XXXXXXX--XD------------XX00000000000000000000000000000000000
000000000000000000000000000000000000XXXX----------XXS-------------------S----[]---XXXXXXXX--XXXXX-------XXXX00000000000000000000000000000000000
000000000000000000000000000000000000XXXXXXXXXX----XXXXXXXXXXXXXXXXXXXXXXXXXXXXXXXXXXXXXXXXXXXXXXXXXXXXXXXXXX00000000000000000000000000000000000
000000000000000000000000000000000000XXXX----------XX0000000000000000000000000000000000000000000000000000000000000000000000000000000000000000000
000000000000000000000000000000000000XX------------XX0000000000000000000000000000000000000000000000000000000000000000000000000000000000000000000
000000000000000000000000000000000000XX----XXXXXXXXXX0000000000000000000000000000000000000000000000000000000000000000000000000000000000000000000
000000000000000000000000000000000000XD------------XX0000000000000000000000000000000000000000000000000000000000000000000000000000000000000000000
000000000000000000000000000000000000XD------------XX0000000000000000000000000000000000000000000000000000000000000000000000000000000000000000000
000000000000000000000000000000000000XXXXX-------XXXX0000000000000000000000000000000000000000000000000000000000000000000000000000000000000000000
000000000000000000000000000000000000XXXXXXXXXXXXXXXX0000000000000000000000000000000000000000000000000000000000000000000000000000000000000000000
000000000000000000000000000000000000----------------0000000000000000000000000000000000000000000000000000000000000000000000000000000000000000000
000000000000000000000000000000000000---E---E--------0000000000000000000000000000000000000000000000000000000000000000000000000000000000000000000
000000000000000000000000000000000000MMMMMMMMMMMMMMMM0000000000000000000000000000000000000000000000000000000000000000000000000000000000000000000
000000000000000000000000000000000000----------------0000000000000000000000000000000000000000000000000000000000000000000000000000000000000000000
000000000000000000000000000000000000----------------0000000000000000000000000000000000000000000000000000000000000000000000000000000000000000000
000000000000000000000000000000000000TTTTTTTT--------0000000000000000000000000000000000000000000000000000000000000000000000000000000000000000000
000000000000000000000000000000000000---------TTTT---0000000000000000000000000000000000000000000000000000000000000000000000000000000000000000000
000000000000000000000000000000000000----------------0000000000000000000000000000000000000000000000000000000000000000000000000000000000000000000
000000000000000000000000000000000000XXXX--------XXXX0000000000000000000000000000000000000000000000000000000000000000000000000000000000000000000
000000000000000000000000000000000000----------------0000000000000000000000000000000000000000000000000000000000000000000000000000000000000000000
000000000000000000000000000000000000----------------0000000000000000000000000000000000000000000000000000000000000000000000000000000000000000000
000000000000000000000000000000000000---E---E--------0000000000000000000000000000000000000000000000000000000000000000000000000000000000000000000
000000000000000000000000000000000000MMMMMMMMMMMMMMMM0000000000000000000000000000000000000000000000000000000000000000000000000000000000000000000
000000000000000000000000000000000000----------------0000000000000000000000000000000000000000000000000000000000000000000000000000000000000000000
000000000000000000000000000000000000----------------0000000000000000000000000000000000000000000000000000000000000000000000000000000000000000000
000000000000000000000000000000000000XX----XXXXXXXXXX0000000000000000000000000000000000000000000000000000000000000000000000000000000000000000000
000000000000000000000000000000000000XD------------XX0000000000000000000000000000000000000000000000000000000000000000000000000000000000000000000
000000000000000000000000000000000000XD------------XX0000000000000000000000000000000000000000000000000000000000000000000000000000000000000000000
000000000000000000000000000000000000XXXXX-------XXXX0000000000000000000000000000000000000000000000000000000000000000000000000000000000000000000
000000000000000000000000000000000000XXXXXXXXXXXXXXXX0000000000000000000000000000000000000000000000000000000000000000000000000000000000000000000
000000000000000000000000000000000000XXXXXXX-----XXXX0000000000000000000000000000000000000000000000000000000000000000000000000000000000000000000
000000000000000000000000000000000000XXXX--------XXXX0000000000000000000000000000000000000000000000000000000000000000000000000000000000000000000
000000000000000000000000000000000000XX------------XX0000000000000000000000000000000000000000000000000000000000000000000000000000000000000000000
000000000000000000000000000000000000XX-----XXXX---DX0000000000000000000000000000000000000000000000000000000000000000000000000000000000000000000
000000000000000000000000000000000000XX------------DX0000000000000000000000000000000000000000000000000000000000000000000000000000000000000000000
000000000000000000000000000000000000XXXX--------XXXX0000000000000000000000000000000000000000000000000000000000000000000000000000000000000000000
000000000000000000000000000000000000XXXXXX------XXXX0000000000000000000000000000000000000000000000000000000000000000000000000000000000000000000
000000000000000000000000000000000000XXXX--------XXXX0000000000000000000000000000000000000000000000000000000000000000000000000000000000000000000
000000000000000000000000000000000000XXXX--------XXXX0000000000000000000000000000000000000000000000000000000000000000000000000000000000000000000
000000000000000000000000000000000000XX----TTTTTTTTXX0000000000000000000000000000000000000000000000000000000000000000000000000000000000000000000
000000000000000000000000000000000000XX------------XX0000000000000000000000000000000000000000000000000000000000000000000000000000000000000000000
000000000000000000000000000000000000XX------------XX0000000000000000000000000000000000000000000000000000000000000000000000000000000000000000000
000000000000000000000000000000000000XXXXXXXXXX----XX0000000000000000000000000000000000000000000000000000000000000000000000000000000000000000000
000000000000000000000000000000000000XX------------XX0000000000000000000000000000000000000000000000000000000000000000000000000000000000000000000
000000000000000000000000000000000000XX------------XX0000000000000000000000000000000000000000000000000000000000000000000000000000000000000000000
000000000000000000000000000000000000XX----XXXXXXXXXX0000000000000000000000000000000000000000000000000000000000000000000000000000000000000000000
000000000000000000000000000000000000XD------------XX0000000000000000000000000000000000000000000000000000000000000000000000000000000000000000000
000000000000000000000000000000000000XD------------XX0000000000000000000000000000000000000000000000000000000000000000000000000000000000000000000
000000000000000000000000000000000000XXXXX-------XXXX0000000000000000000000000000000000000000000000000000000000000000000000000000000000000000000
000000000000000000000000000000000000XXXXXXXXXXXXXXXX0000000000000000000000000000000000000000000000000000000000000000000000000000000000000000000
000000000000000000000000000000000000---XX-----------0000000000000000000000000000000000000000000000000000000000000000000000000000000000000000000
000000000000000000000000000000000000XXXX----------XX0000000000000000000000000000000000000000000000000000000000000000000000000000000000000000000
000000000000000000000000000000000000XXXX----------DX0000000000000000000000000000000000000000000000000000000000000000000000000000000000000000000
000000000000000000000000000000000000XXXX----------DX0000000000000000000000000000000000000000000000000000000000000000000000000000000000000000000
000000000000000000000000000000000000XXXX----XXXXXXXX0000000000000000000000000000000000000000000000000000000000000000000000000000000000000000000
000000000000000000000000000000000000---X-X----------0000000000000000000000000000000000000000000000000000000000000000000000000000000000000000000
000000000000000000000000000000000000---X------------0000000000000000000000000000000000000000000000000000000000000000000000000000000000000000000
000000000000000000000000000000000000XXXX----------XX0000000000000000000000000000000000000000000000000000000000000000000000000000000000000000000
000000000000000000000000000000000000XXXXXXXXXX----XX0000000000000000000000000000000000000000000000000000000000000000000000000000000000000000000
000000000000000000000000000000000000XXXX----------XX0000000000000000000000000000000000000000000000000000000000000000000000000000000000000000000
000000000000000000000000000000000000XX------------XX0000000000000000000000000000000000000000000000000000000000000000000000000000000000000000000
000000000000000000000000000000000000XXXXXXXXXXXXXXXX0000000000000000000000000000000000000000000000000000000000000000000000000000000000000000000
000000000000000000000000000000000000XXXX-----------X0000000000000000000000000000000000000000000000000000000000000000000000000000000000000000000
000000000000000000000000000000000000XX-------------X0000000000000000000000000000000000000000000000000000000000000000000000000000000000000000000
000000000000000000000000000000000000XX-XXXX--------X0000000000000000000000000000000000000000000000000000000000000000000000000000000000000000000
000000000000000000000000000000000000XX----XXXXXX---X0000000000000000000000000000000000000000000000000000000000000000000000000000000000000000000
000000000000000000000000000000000000XD-----------T-X0000000000000000000000000000000000000000000000000000000000000000000000000000000000000000000
000000000000000000000000000000000000XD------------XX0000000000000000000000000000000000000000000000000000000000000000000000000000000000000000000
000000000000000000000000000000000000XXXXX-------XXXX0000000000000000000000000000000000000000000000000000000000000000000000000000000000000000000
0000000000000000--------------------XXXXXXXXXXXXXXXX0000000000000000000000000000000000000000000000000000000000000000000000000000000000000000000
0000000000000000--------------------00000000000000000000000000000000000000000000000000000000000000000000000000000000000000000000000000000000000
0000000000000000--------------------00000000000000000000000000000000000000000000000000000000000000000000000000000000000000000000000000000000000
0000000000000000--------------------00000000000000000000000000000000000000000000000000000000000000000000000000000000000000000000000000000000000
------------X---S-------------------00000000000000000000000000000000000000000000000000000000000000000000000000000000000000000000000000000000000
------------X---S-------------------00000000000000000000000000000000000000000000000000000000000000000000000000000000000000000000000000000000000
------------X---S-------------------00000000000000000000000000000000000000000000000000000000000000000000000000000000000000000000000000000000000
------------X---S-------------------00000000000000000000000000000000000000000000000000000000000000000000000000000000000000000000000000000000000
-----X------X---S-------------------00000000000000000000000000000000000000000000000000000000000000000000000000000000000000000000000000000000000
------------X---S-------------------00000000000000000000000000000000000000000000000000000000000000000000000000000000000000000000000000000000000
----------------S-------------------00000000000000000000000000000000000000000000000000000000000000000000000000000000000000000000000000000000000
----------------S-------------------00000000000000000000000000000000000000000000000000000000000000000000000000000000000000000000000000000000000
-----TTTT-------S-------------------00000000000000000000000000000000000000000000000000000000000000000000000000000000000000000000000000000000000
----------------S-------------------00000000000000000000000000000000000000000000000000000000000000000000000000000000000000000000000000000000000
XXXX--------XXXXS-------------E-----00000000000000000000000000000000000000000000000000000000000000000000000000000000000000000000000000000000000
XXXX--------XXXXXXXXXXXXXXXXXXXXXXX-00000000000000000000000000000000000000000000000000000000000000000000000000000000000000000000000000000000000
XXXXXXX-----XXXX0000000000000000000000000000000000000000000000000000000000000000000000000000000000000000000000000000000000000000000000000000000
XXXX--------XXXX0000000000000000000000000000000000000000000000000000000000000000000000000000000000000000000000000000000000000000000000000000000
XX------------XX0000000000000000000000000000000000000000000000000000000000000000000000000000000000000000000000000000000000000000000000000000000
XX----XXXXX---XX0000000000000000000000000000000000000000000000000000000000000000000000000000000000000000000000000000000000000000000000000000000
XD------------XX0000000000000000000000000000000000000000000000000000000000000000000000000000000000000000000000000000000000000000000000000000000
XD------------XX0000000000000000000000000000000000000000000000000000000000000000000000000000000000000000000000000000000000000000000000000000000
XXXXX-------XXXX0000000000000000000000000000000000000000000000000000000000000000000000000000000000000000000000000000000000000000000000000000000
XXXXXXXXXXXXXXXX0000000000000000000000000000000000000000000000000000000000000000000000000000000000000000000000000000000000000000000000000000000