00000000000000000000000000000000000000000000000000000000000000000000000000000000000000000000--------------------------------------------------------------------------------000000000000000
00000000000000000000000000000000000000000000000000000000000000000000000000000000000000000000--------------------------------------------------------------------------------000000000000000
00000000000000000000000000000000000000000000000000000000000000000000000000000000000000000000--------------------------------------------------------------------------------000000000000000
00000000000000000000000000000000000000000000000000000000000000000000000000000000000000000000--------------------------------------------------------------------------------000000000000000
00000000000000000000000000000000000000000000000000000000000000000000000000000000000000000000---------------------------------SSSSSS-----------------------------------------000000000000000
00000000000000000000000000000000000000000000000000000000000000000000000000000000000000000000---------------------------------------S----------------------------------------000000000000000
00000000000000000000000000000000000000000000000000000000000000000000000000000000000000000000--------------------------------------------------------------------------------000000000000000
00000000000000000000000000000000000000000000000000000000000000000000000000000000000000000000-------------------------------------------------------XX------------o----------000000000000000
00000000000000000000000000000000000000000000000000000000000000000000000000000000000000000000--------<E------------------------------------------------------------o---------000000000000000
00000000000000000000000000000000000000000000000000000000000000000000000000000000000000000000--------[>----------------------------------------------------------------------000000000000000
00000000000000000000000000000000000000000000000000000000000000000000000000000000000000000000--------[]--------------------S-------------------------------------------------000000000000000
00000000000000000000000000000000000000000000000000000000000000000000000000000000000000000000--------[]-------------------XX-------------------------------------------------000000000000000
00000000000000000000000000000000000000000000000000000000000000000000000000000000000000000000--------[]------------------XXX-------------X--------------------X-------------E000000000000000
00000000000000000000000000000000000000000000000000000000000000000000000000000000000000000000--------[]--------SE-------XXXX------E------XXXXXXXXXXX----------X--------------000000000000000
00000000000000000000000000000000000000000000000000000000000000000000000000000000000000000000--------[]---------S------XXXXX-------------XXX------------------X-----EE-----E-000000000000000
0000000000000000000000000000000000000000000000000000000000000000000000000000-XX-------------XXXXXXXXXXX--XXXXX--XXXXXXXXXX----XXXXX-XX-XX---------------XX-XXX---XXXXXXXXXX-000000000000000
0000000000000000000000000000000000000000000000000000000000000000000000000000XX-----XXXX----X00000000000000000000000000000000000000000000000000000000000000000000000000000000000000000000000
0000000000000000000000000000000000000000000000000000000000000000000000000000XX-------------X00000000000000000000000000000000000000000000000000000000000000000000000000000000000000000000000
0000000000000000000000000000000000000000000000000000000000000000000000000000XXXX--------XXXX00000000000000000000000000000000000000000000000000000000000000000000000000000000000000000000000
0000000000000000000000000000000000000000000000000000000000000000000000000000XXXX--------XXXX00000000000000000000000000000000000000000000000000000000000000000000000000000000000000000000000
0000000000000000000000000000000000000000000000000000000000000000000000000000XXXX--------XXXX00000000000000000000000000000000000000000000000000000000000000000000000000000000000000000000000
0000000000000000------------------------------------------------------------XXXX--------XXXX00000000000000000000000000000000000000000000000000000000000000000000000000000000000000000000000
0000000000000000------------------------------------------------------------XXXX--------XXXX00000000000000000000000000000000000000000000000000000000000000000000000000000000000000000000000
0000000000000000------------------------------------------------------------XXXX--------XXXX00000000000000000000000000000000000000000000000000000000000000000000000000000000000000000000000
0000000000000000------------------------------------------------------------XXXX--------XXXX00000000000000000000000000000000000000000000000000000000000000000000000000000000000000000000000
0000000000000000------------------------------------------------------------XX----TTTTTTTTXX00000000000000000000000000000000000000000000000000000000000000000000000000000000000000000000000
0000000000000000------------------------------------------------------------XX------------XX00000000000000000000000000000000000000000000000000000000000000000000000000000000000000000000000
0000000000000000------------------------------------------------------------XX------------XX00000000000000000000000000000000000000000000000000000000000000000000000000000000000000000000000
0000000000000000------------------------------------------------------------XXXXXX----XXXXXX00000000000000000000000000000000000000000000000000000000000000000000000000000000000000000000000
0000000000000000------ooooo-------------------------------------------------XX------------XX00000000000000000000000000000000000000000000000000000000000000000000000000000000000000000000000
0000000000000000-----------o------------------------------------------------XX-----------XXX00000000000000000000000000000000000000000000000000000000000000000000000000000000000000000000000
0000000000000000------------oo----E------------------------oo-oooooo-oo-----XD-----------XXX00000000000000000000000000000000000000000000000000000000000000000000000000000000000000000000000
0000000000000000-----------------<>--------------------------o------o-------XD-----------XXX00000000000000000000000000000000000000000000000000000000000000000000000000000000000000000000000
0000000000000000-----------------[]---------------------------------------X-XXXXXXXXXXXXXXXX00000000000000000000000000000000000000000000000000000000000000000000000000000000000000000000000
0000000000000000-----------------[]---------------------------------------XXXXXXXXXXXXXXXXXX00000000000000000000000000000000000000000000000000000000000000000000000000000000000000000000000
0000000000000000-----------------[]--------E-EE-E-----E-------------------XX000000000000000000000000000000000000000000000000000000000000000000000000000000000000000000000000000000000000000
-XXXX-----------XX----XXXXXXXXXXXXX-XXXXXXXXXXXXXXXXXXX-XXXXXXXXXXXXXXXXXXXX000000000000000000000000000000000000000000000000000000000000000000000000000000000000000000000000000000000000000
XXXXXXXXXXXX---X000000000000000000000000000000000000000000000000000000000000000000000000000000000000000000000000000000000000000000000000000000000000000000000000000000000000000000000000000
XXXXXXXXXXXX---X000000000000000000000000000000000000000000000000000000000000000000000000000000000000000000000000000000000000000000000000000000000000000000000000000000000000000000000000000
XXXXXXXXXXXXXXXX000000000000000000000000000000000000000000000000000000000000000000000000000000000000000000000000000000000000000000000000000000000000000000000000000000000000000000000000000
XXXX----------XX000000000000000000000000000000000000000000000000000000000000000000000000000000000000000000000000000000000000000000000000000000000000000000000000000000000000000000000000000
XXXX----------XX000000000000000000000000000000000000000000000000000000000000000000000000000000000000000000000000000000000000000000000000000000000000000000000000000000000000000000000000000
XXXX----------XX000000000000000000000000000000000000000000000000000000000000000000000000000000000000000000000000000000000000000000000000000000000000000000000000000000000000000000000000000
XXXX----------XX000000000000000000000000000000000000000000000000000000000000000000000000000000000000000000000000000000000000000000000000000000000000000000000000000000000000000000000000000
XXXX----------XX000000000000000000000000000000000000000000000000000000000000000000000000000000000000000000000000000000000000000000000000000000000000000000000000000000000000000000000000000
XX------------XX000000000000000000000000000000000000000000000000000000000000000000000000000000000000000000000000000000000000000000000000000000000000000000000000000000000000000000000000000
XX--------TTTTXX000000000000000000000000000000000000000000000000000000000000000000000000000000000000000000000000000000000000000000000000000000000000000000000000000000000000000000000000000
XX------------XX000000000000000000000000000000000000000000000000000000000000000000000000000000000000000000000000000000000000000000000000000000000000000000000000000000000000000000000000000
XX------------XX000000000000000000000000000000000000000000000000000000000000000000000000000000000000000000000000000000000000000000000000000000000000000000000000000000000000000000000000000
XXXXXX----XXXXXX000000000000000000000000000000000000000000000000000000000000000000000000000000000000000000000000000000000000000000000000000000000000000000000000000000000000000000000000000
XX------------XX000000000000000000000000000000000000000000000000000000000000000000000000000000000000000000000000000000000000000000000000000000000000000000000000000000000000000000000000000
XX-----------XXX000000000000000000000000000000000000000000000000000000000000000000000000000000000000000000000000000000000000000000000000000000000000000000000000000000000000000000000000000
XD-----------XXX000000000000000000000000000000000000000000000000000000000000000000000000000000000000000000000000000000000000000000000000000000000000000000000000000000000000000000000000000
XD-----------XXX000000000000000000000000000000000000000000000000000000000000000000000000000000000000000000000000000000000000000000000000000000000000000000000000000000000000000000000000000
XXXXXXXXXXXXXXXX000000000000000000000000000000000000000000000000000000000000000000000000000000000000000000000000000000000000000000000000000000000000000000000000000000000000000000000000000
XXXXXXXXXXXXXXXX000000000000000000000000000000000000000000000000000000000000000000000000000000000000000000000000000000000000000000000000000000000000000000000000000000000000000000000000000
----------------000000000000000000000000000000000000000000000000000000000000000000000000000000000000000000000000000000000000000000000000000000000000000000000000000000000000000000000000000
TTTTTTTT--------000000000000000000000000000000000000000000000000000000000000000000000000000000000000000000000000000000000000000000000000000000000000000000000000000000000000000000000000000
----------------000000000000000000000000000000000000000000000000000000000000000000000000000000000000000000000000000000000000000000000000000000000000000000000000000000000000000000000000000
-----------TTTT-000000000000000000000000000000000000000000000000000000000000000000000000000000000000000000000000000000000000000000000000000000000000000000000000000000000000000000000000000
----------------000000000000000000000000000000000000000000000000000000000000000000000000000000000000000000000000000000000000000000000000000000000000000000000000000000000000000000000000000
----------------000000000000000000000000000000000000000000000000000000000000000000000000000000000000000000000000000000000000000000000000000000000000000000000000000000000000000000000000000
-----------X----000000000000000000000000000000000000000000000000000000000000000000000000000000000000000000000000000000000000000000000000000000000000000000000000000000000000000000000000000
-----------X----000000000000000000000000000000000000000000000000000000000000000000000000000000000000000000000000000000000000000000000000000000000000000000000000000000000000000000000000000
XXXXX------XXXXX000000000000000000000000000000000000000000000000000000000000000000000000000000000000000000000000000000000000000000000000000000000000000000000000000000000000000000000000000
--XX------------000000000000000000000000000000000000000000000000000000000000000000000000000000000000000000000000000000000000000000000000000000000000000000000000000000000000000000000000000
--XXXXX---------000000000000000000000000000000000000000000000000000000000000000000000000000000000000000000000000000000000000000000000000000000000000000000000000000000000000000000000000000
-----XX---------000000000000000000000000000000000000000000000000000000000000000000000000000000000000000000000000000000000000000000000000000000000000000000000000000000000000000000000000000
-----XXXXX------000000000000000000000000000000000000000000000000000000000000000000000000000000000000000000000000000000000000000000000000000000000000000000000000000000000000000000000000000
--------XX------000000000000000000000000000000000000000000000000000000000000000000000000000000000000000000000000000000000000000000000000000000000000000000000000000000000000000000000000000
--------XXXXX---000000000000000000000000000000000000000000000000000000000000000000000000000000000000000000000000000000000000000000000000000000000000000000000000000000000000000000000000000
-----------XX---000000000000000000000000000000000000000000000000000000000000000000000000000000000000000000000000000000000000000000000000000000000000000000000000000000000000000000000000000
XD-----------XXX000000000000000000000000000000000000000000000000000000000000000000000000000000000000000000000000000000000000000000000000000000000000000000000000000000000000000000000000000
XD-----------X-X000000000000000000000000000000000000000000000000000000000000000000000000000000000000000000000000000000000000000000000000000000000000000000000000000000000000000000000000000
XXXXXXXXXXXXXXXX000000000000000000000000000000000000000000000000000000000000000000000000000000000000000000000000000000000000000000000000000000000000000000000000000000000000000000000000000
XXXXXXXXXXXXXXXX000000000000000000000000000000000000000000000000000000000000000000000000000000000000000000000000000000000000000000000000000000000000000000000000000000000000000000000000000