000000000000000000000000000000000000000000000000000000000000000000000000000000000000000000000000000000000000000000000000000000000000000000000000000000000000000000000000000000000000000000000000000000000000000---0000000000000000
000000000000000000000000000000000000000000000000000000000000000000000000000000000000000000000000000000000000000000000000000000000000000000000000000000000000000000000000000000000000000000000000000000000000000---0000000000000000
000000000000000000000000000000000000000000000000000000000000000000000000000000000000000000000000000000000000000000000000000000000000000000000000000000000000000000000000000000000000000000000000000000000000000---0000000000000000
000000000000000000000000000000000000000000000000000000000000000000000000000000000000000000000000000000000000000000000000000000000000000000000000000000000000000000000000000000000000000000000000000000000000000---0000000000000000
000000000000000000000000000000000000000000000000000000000000000000000000000000000000000000000000000000000000000000000000000000000000000000000000000000000000000000000000000000000000000000000000000000000000000---0000000000000000
00000000000000000000000000000000000000000000000000000000000000000000000000000000000000000000000000000000000000000000000000000000000000000000000000000000000000000000000000000000000000000000000------TTTTTTTTTT---0000000000000000
00000000000000000000000000000000000000000000000000000000000000000000000000000000000000000000000000000000000000000000000000000000000000000000000000000000000000000000000000000000000000000000000-------------------0000000000000000
00000000000000000000000000000000000000000000000000000000000000000000000000000000000000000000000000000000000000000000000000000000000000000000000000000000000000000000000000000000000000000000000----------------X--0000000000000000
-------------------------------------------------------------------------------------------------------------------------------------------------------------------------------------------------------T-------X--0000000000000000
-----------------------------------------------------------------------------------------------------------------------------------------------------------------------------------------------0000000000000000X--0000000000000000
-----------------------------------------------------------------------------------------------------------------------------------------------------------------------------------------------0000000000000000X--0000000000000000
-----------------------------------------------------------------------------------------------------------------------------------------------------------------------------------------------0000000000000000XX--------XXXXX----
-----------------------------------------------------------------------------------------------------------------------------------------------------------------------------------------------0000000000000000XXXXXXXXXXXXXXXXXXX
-----------------------------------------------------------------------------------------------------------------------------------------------------------------------------------------------0000000000000000XXX0000000000000000
-----------------------------------------------------------------------------------ooooooooooooooo---------------------------------------------------------------------------------------------0000000000000000XXX0000000000000000
--------------------------------------------------------------------------------------------------------------------------------------------------------------------------------------SS-------0000000000000000XXX0000000000000000
-----------------------------------------------------------------------------------------------------------------------------------------------------------------------------------------------00000000000000000000000000000000000
-------------------------------------------------------------------------------------XX--------------------------------------------------------------------------------------------------------00000000000000000000000000000000000
-------------------------------------------------------------E--------------------------------------------E------------------------------------------------------------------------------------00000000000000000000000000000000000
---------------------------------------X---------------X----<>------------------X------------------------<>----------------------------------------------------------------------------S-------00000000000000000000000000000000000
----------------------------------X-------------------------[]-------------------------------------------[]------------------------------------------------------E-----------------E------XX---00000000000000000000000000000000000
---------------------------------XX-------------------------[]--------------------------------X--X-------[]-----------------------------------------------------------------------<>-----XXX---00000000000000000000000000000000000
--E---------E-------E-----------XXX---------EE-E------E-----[]---------E-------E-------------------------[]-------------------------------E---E-------E--------------E----EE------[]--XXXXXX---00000000000000000000000000000000000
XXXXXXXXXXXXXXXXXXXXXXXXXXXXXXXXXXXXXXXXXXXXXXXXXXXXXXXXXXXXXXXXXXXXXXXXXXXXXXXXXXXXXXXXXXXXXXXXXXXXXXXXXXXXX-XXXXXXXXXXXXX-XXXXXXXXXXXXXXXXXXXXXXXXXXXXXXX-XXXXXXXXXXXXXXXXXXXXXXXXXXXXXXXX---00000000000000000000000000000000000
0000000000000000000000000000000000000000000000000000000000000000000000000000000000000000000000000000000000000000000000000000000000000000000000000000000000000000000000000000000000000000000000000000000000000000000000000000000000