--------------------------------------------------------------------------------------------------------------------------------------------------------------------------------------------------------000000000000000
--------------------------------------------------------------------------------------------------------------------------------------------------------------------------------------------------------000000000000000
--------------------------------------------------------------------------------------------------------------------------------------------------------------------------------------------------------000000000000000
--------------------------------------------------------------------------------------------------------------------------------------------------------------------------------------------------------000000000000000
---------------------------------------------------------------------------------------------------------------------------------------------------SSSSSSSSSSSS-----------------------------------------000000000000000
--------------------------------------------------------------------------------------------------------------------------------------------------SSSSSSS------S----------------------------------------000000000000000
----------------------------------------------------------------------oo---------------------------------------------------------------------------SSSSSS-----------------------------------------------000000000000000
--------------------------------------------------XX--------------------o-------------------------------------------------------------------------S-SS------------------------------------SS------------000000000000000
-------------------------------------------------XXX-------------------------------------------------------------S----------------------------------SS--------------------------------------------------000000000000000
-------------------------------------------------XXX-------------------------------------------XX---------------------------------------------------SS--------------------------------------------------000000000000000
--------------------------XX---------------------XXX-------------------------------------------XX-----------oo------------------------------------SoSS------------------------------------------------S-000000000000000
--------------------------XX---------------------XXX-----------------------------------------XXXX----------------------------------oo-------------SSSSSSS--------------SSS---------------------------S--000000000000000
-------------------------XXX---------------------XXX-------------------------------------XXX-XXXX-----------------------------------------------------S-S---------------------------------------E-------000000000000000
------------------------XXXX------X--------------XXX-------------------------------------XXX-XXXX-----------------------------------------------------S-S--------------------------------------<>-------000000000000000
--E-E------X------E----XXXXX------X-----------E-E-XX-----------------------E-------------XXX-XXXX------------------------------------E--------------E--------E--------------EEE--------E-E-----[]------E000000000000000
XXXXXXXXXXXXXXXXXXXEXXXXXXX----XXXXXXXX-XXXXXXXXX-XXXXXXX---XX--------XXXXXXXXX-XXXXXXXXXXX--XXXX---XXXXXXX--------XXXX-XXXXXXXXXXXXXXXXXXXEXX-----XXXXXXXXXXXXEXXXXXXXXXXXXXXXXXXX-XXXXXXXXXXXXXXXXXXX-000000000000000
00000000000000000000000000000000000000000000000000000000000000000000000000000000000000000000000000000000000000000000000000000000000000000000000000000000000000000000000000000000000000000000000000000000000000000000000