0000000000000000000000000000000000000000000000000000000000000000000000000000000000000000000000000000000000000000--------TTTT----
0000000000000000000000000000000000000000000000000000000000000000000000000000000000000000000000000000000000000000----------------
0000000000000000000000000000000000000000000000000000000000000000000000000000000000000000000000000000000000000000----------------
0000000000000000000000000000000000000000000000000000000000000000000000000000000000000000000000000000000000000000-TTTTTTTT-------
0000000000000000000000000000000000000000000000000000000000000000000000000000000000000000000000000000000000000000----------------
0000000000000000000000000000000000000000000000000000000000000000000000000000000000000000000000000000000000000000X---------------
0000000000000000000000000000000000000000000000000000000000000000000000000000000000000000000000000000000000000000X-----------XXXX
0000000000000000000000000000000000000000000000000000000000000000000000000000000000000000000000000000000000000000XXXX--------XXXX
0000000000000000000000000000000000000000000000000000000000000000000000000000000000000000000000000000000000000000XXXX--------XXXX
0000000000000000000000000000000000000000000000000000000000000000000000000000000000000000000000000000000000000000XTTTTTTTT---XXXX
0000000000000000000000000000000000000000000000000000000000000000000000000000000000000000000000000000000000000000XXXX--------XXXX
0000000000000000000000000000000000000000000000000000000000000000000000000000000000000000000000000000000000000000XXXX--------XXXX
0000000000000000000000000000000000000000000000000000000000000000000000000000000000000000000000000000000000000000XXXXXXX-----XXXX
0000000000000000000000000000000000000000000000000000000000000000000000000000000000000000000000000000000000000000XXXX--------XXXX
0000000000000000000000000000000000000000000000000000000000000000000000000000000000000000000000000000000000000000XX------------XX
0000000000000000000000000000000000000000000000000000000000000000000000000000000000000000000000000000000000000000XX-----XXXXX--XX
0000000000000000000000000000000000000000000000000000000000000000000000000000000000000000000000000000000000000000XD------------XX
0000000000000000000000000000000000000000000000000000000000000000000000000000000000000000000000000000000000000000XD------------DX
0000000000000000000000000000000000000000000000000000000000000000000000000000000000000000000000000000000000000000XXXXX-------XXXX
0000000000000000000000000000000000000000000000000000000000000000000000000000000000000000000000000000000000000000XXXXXXXXXXXXXXXX
0000000000000000000000000000000000000000000000000000000000000000000000000000000000000000000000000000000000000000XXXX--------XXXX
0000000000000000000000000000000000000000000000000000000000000000000000000000000000000000000000000000000000000000XXXX-----TTTTXXX
0000000000000000000000000000000000000000000000000000000000000000000000000000000000000000000000000000000000000000XXXX--------XXXX
0000000000000000000000000000000000000000000000000000000000000000000000000000000000000000000000000000000000000000XXXX--------XXXX
00000000000000000000000000000000000000000000000000000000000000000000000000000000000000000000--------------------XX------------XX
00000000000000000000000000000000000000000000000000000000000000000000000000000000000000000000--------------------XX-----XXXX---DX
00000000000000000000000000000000000000000000000000000000000000000000000000000000000000000000--------------------XX------------DX
00000000000000000000000000000000000000000000000000000000000000000000000000000000000000000000--------------------XXXX--------XXXX
0000000000000000000000000000000000000000000000000000000000000000000000000000------XXXX------S-------------------XXXXXX------XXXX
0000000000000000000000000000000000000000000000000000000000000000000000000000------XX--------S-------------------XXXX--------XXXX
0000000000000000000000000000000000000000000000000000000000000000000000000000---XXXXX--------S-------------------XXXX--------XXXX
0000000000000000000000000000000000000000000000000000000000000000000000000000---XX-----------S-------------------XX----TTTTTTTTXX
0000000000000000000000000000000000000000000000000000000000000000000000000000---XX-----------S-------------------XX------------XX
0000000000000000000000000000000000000000000000000000000000000000000000000000XXXX----------XXS-------------------XX------------XX
0000000000000000000000000000000000000000000000000000000000000000000000000000XXXX----------DXS------E------------XXXXXXXX------XX
0000000000000000000000000000000000000000000000000000000000000000000000000000XXXX----------DXS-----<>------------XX----XXXXX---XX
0000000000000000000000000000000000000000000000000000000000000000000000000000XXXX----XXXXXXXXS-----[]------------XD------------XX
0000000000000000000000000000000000000000000000000000000000000000000000000000---X-X----------S-----[]------------XD------------XX
0000000000000000000000000000000000000000000000000000000000000000000000000000---X------------S-----[]------------XXXXX-------XXXX
0000000000000000000000000000000000000000000000000000000000000000000000000000XXXX----------XXXXXXXXXXXXXXXXXXXXXXXXXXXXXXXXXXXXXX
0000000000000000000000000000000000000000000000000000000000000000000000000000XXXXXXXXXX----XX000000000000000000000000000000000000
0000000000000000000000000000000000000000000000000000000000000000000000000000XXXX----------XX000000000000000000000000000000000000
0000000000000000000000000000000000000000000000000000000000000000000000000000XX------------XX000000000000000000000000000000000000
0000000000000000000000000000000000000000000000000000000000000000000000000000XX----XXXXXXXXXX000000000000000000000000000000000000
0000000000000000000000000000000000000000000000000000000000000000000000000000XD------------XX000000000000000000000000000000000000
0000000000000000000000000000000000000000000000000000000000000000000000000000XD------------XX000000000000000000000000000000000000
0000000000000000000000000000000000000000000000000000000000000000000000000000XXXXX-------XXXX000000000000000000000000000000000000
0000000000000000000000000000000000000000000000000000000000000000000000000000XXXXXXXXXXXXXXXX000000000000000000000000000000000000
0000000000000000000000000000000000000000000000000000000000000000000000000000X-------------XX000000000000000000000000000000000000
0000000000000000000000000000000000000000000000000000000000000000000000000000X-------------XX000000000000000000000000000000000000
0000000000000000000000000000000000000000000000000000000000000000000000000000X-------------XX000000000000000000000000000000000000
0000000000000000000000000000000000000000000000000000000000000000000000000000X-------------XX000000000000000000000000000000000000
0000000000000000000000000000000000000000000000000000000000000000000000000000X-------------XX000000000000000000000000000000000000
0000000000000000000000000000000000000000000000000000000000000000000000000000X-------------XX000000000000000000000000000000000000
0000000000000000000000000000000000000000000000000000000000000000000000000000X-------------XX000000000000000000000000000000000000
0000000000000000000000000000000000000000000000000000000000000000000000000000X-------------XX000000000000000000000000000000000000
0000000000000000000000000000000000000000000000000000000000000000000000000000X-------------XX000000000000000000000000000000000000
0000000000000000000000000000000000000000000000000000000000000000000000000000X-------------XX000000000000000000000000000000000000
0000000000000000000000000000000000000000000000000000000000000000000000000000XXXX----------XX000000000000000000000000000000000000
0000000000000000000000000000000000000000000000000000000000000000000000000000XXXXXXXX------XX000000000000000000000000000000000000
0000000000000000000000000000000000000000000000000000000000000000000000000000XXXXXXXXXXXX--XX000000000000000000000000000000000000
0000000000000000000000000000000000000000000000000000000000000000000000000000XX------------XX000000000000000000000000000000000000
0000000000000000000000000000000000000000000000000000000000000000000000000000XX------------XX000000000000000000000000000000000000
0000000000000000000000000000000000000000000000000000000000000000000000000000XX----XXXXXXXXXX000000000000000000000000000000000000
0000000000000000000000000000000000000000000000000000000000000000000000000000XD------------XX000000000000000000000000000000000000
0000000000000000000000000000000000000000000000000000000000000000000000000000XD------------XX000000000000000000000000000000000000
0000000000000000000000000000000000000000000000000000000000000000000000000000XXXXX-------XXXX000000000000000000000000000000000000
0000000000000000000000000000000000000000000000000000000000000000000000000000XXXXXXXXXXXXXXXX000000000000000000000000000000000000
0000000000000000000000000000000000000000000000000000000000000000000000000000X--X------------000000000000000000000000000000000000
0000000000000000000000000000000000000000000000000000000000000000000000000000X--X------------000000000000000000000000000000000000
0000000000000000000000000000000000000000000000000000000000000000000000000000X--X------------000000000000000000000000000000000000
0000000000000000000000000000000000000000000000000000000000000000000000000000X--X------------000000000000000000000000000000000000
0000000000000000000000000000000000000000000000000000000000000000000000000000X--X------------000000000000000000000000000000000000
0000000000000000000000000000000000000000000000000000000000000000000000000000XX-X------------000000000000000000000000000000000000
0000000000000000000000000000000000000000000000000000000000000000000000000000---X-X----------000000000000000000000000000000000000
0000000000000000000000000000000000000000000000000000000000000000000000000000---X------------000000000000000000000000000000000000
0000000000000000000000000000000000000000000000000000000000000000000000000000XXXX----------XX000000000000000000000000000000000000
0000000000000000000000000000000000000000000000000000000000000000000000000000XXXXXXXX------XX000000000000000000000000000000000000
0000000000000000000000000000000000000000000000000000000000000000000000000000XXXXXXXX------XX000000000000000000000000000000000000
0000000000000000000000000000000000000000000000000000000000000000000000000000XD------------XX000000000000000000000000000000000000
0000000000000000000000000000000000000000000000000000000000000000000000000000XD------------XX000000000000000000000000000000000000
0000000000000000000000000000000000000000000000000000000000000000000000000000XXTTTTXXXXXXXXXX000000000000000000000000000000000000
0000000000000000000000000000000000000000000000000000000000000000000000000000XX------------XX000000000000000000000000000000000000
0000000000000000000000000000000000000000000000000000000000000000000000000000XX----XXXXXXXXXX000000000000000000000000000000000000
0000000000000000000000000000000000000000000000000000000000000000000000000000XD-----------TXX000000000000000000000000000000000000
0000000000000000000000000000000000000000000000000000000000000000000000000000XD------------XX000000000000000000000000000000000000
0000000000000000000000000000000000000000000000000000000000000000000000000000XXXXX-------XXXX000000000000000000000000000000000000
0000000000000000------------------------------------------------------------XXXXXXXXXXXXXXXX000000000000000000000000000000000000
0000000000000000------------------------------------------------------------0000000000000000000000000000000000000000000000000000
0000000000000000------------------------------------------------------------0000000000000000000000000000000000000000000000000000
0000000000000000------------------------------------------------------------0000000000000000000000000000000000000000000000000000
XXXX--------XXXXS-------------------S-------------------S-------------------0000000000000000000000000000000000000000000000000000
XXXX--------XXXXS-------------------S-------------------S-------------------0000000000000000000000000000000000000000000000000000
XXXXXXX-----XXXXS-------------------S-------------------S-----oo------E-o---0000000000000000000000000000000000000000000000000000
XXXX--------XXXXS---------XXXXX-----S-------------------S----XXX-------o----0000000000000000000000000000000000000000000000000000
XX------------XXS---------XXXX------S-------------------S-------------------0000000000000000000000000000000000000000000000000000
XX-----XXXX---DXS---------XXXX------S-------------------S-------------------0000000000000000000000000000000000000000000000000000
XX------------DXS--------XXXXX------S-------------------S-------------------0000000000000000000000000000000000000000000000000000
XXXX--------XXXXS--------XXXXX------S-------E-----------S--XXX--XXXXXX--XXX-0000000000000000000000000000000000000000000000000000
XXXXXX------XXXXS------X-XXXXX------S-------E----------<S-------------------0000000000000000000000000000000000000000000000000000
XXXX--------XXXXS------X-XXXXX--<>--S------------------[S-------------------0000000000000000000000000000000000000000000000000000
XXXX--------XXXXS---E--X-XXXXX--[]--S------------------[S-------------------0000000000000000000000000000000000000000000000000000
XX----TTTTTTTTXXXXXXXXXXXXXXXXXXXXXXXXXXXXXXXXXXXXXXXXXXXXX-----------------0000000000000000000000000000000000000000000000000000
XX------------XX0000000000000000000000000000000000000000000000000000000000000000000000000000000000000000000000000000000000000000
XX------------XX0000000000000000000000000000000000000000000000000000000000000000000000000000000000000000000000000000000000000000
XXXXXXXX------XX0000000000000000000000000000000000000000000000000000000000000000000000000000000000000000000000000000000000000000
XX----XXXXX---XX0000000000000000000000000000000000000000000000000000000000000000000000000000000000000000000000000000000000000000
XD------------XX0000000000000000000000000000000000000000000000000000000000000000000000000000000000000000000000000000000000000000
XD------------XX0000000000000000000000000000000000000000000000000000000000000000000000000000000000000000000000000000000000000000
XXXXX-------XXXX0000000000000000000000000000000000000000000000000000000000000000000000000000000000000000000000000000000000000000
XXXXXXXXXXXXXXXX0000000000000000000000000000000000000000000000000000000000000000000000000000000000000000000000000000000000000000