00000000000000000000000000000000000000000000000000000000000000000000000000000000000000000000000000000000000000000000000000000000000000000000000000000000000000000000000000000000--------------------000000000000000
00000000000000000000000000000000000000000000000000000000000000000000000000000000000000000000000000000000000000000000000000000000000000000000000000000000000000000000000000000000--------------------000000000000000
00000000000000000000000000000000000000000000000000000000000000000000000000000000000000000000000000000000000000000000000000000000000000000000000000000000000000000000000000000000--------------------000000000000000
00000000000000000000000000000000000000000000000000000000000000000000000000000000000000000000000000000000000000000000000000000000000000000000000000000000000000000000000000000000--------------------000000000000000
00000000000000000000000000000000000000000000000000000000000000000000000000000000000000000000000000000000000000000000000000000000000000000000000000000000000000000000000000000000--------------------000000000000000
00000000000000000000000000000000000000000000000000000000000000000000000000000000000000000000000000000000000000000000000000000000000000000000000000000000000000000000000000000000--------------------000000000000000
00000000000000000000000000000000000000000000000000000000000000000000000000000000000000000000000000000000000000000000000000000000000000000000000000000000000000000000000000000000--------------------000000000000000
00000000000000000000000000000000000000000000000000000000000000000000000000000000000000000000000000000000000000000000000000000000000000000000000000000000000000000000000000000000-------XX-------o---000000000000000
00000000000000000000000000000000000000000000000000000000000000000000000000000000000000000000000000000000000000000000000000000000000000000000000000000000000000000000000000000000-------XX-----------000000000000000
00000000000000000000000000000000000000000000000000000000000000000000000000000000000000000000000000000000000000000000000000000000000000000000000000000000000000000000000000000000-----XXXX-----------000000000000000
00000000000000000000000000000000000000000000000000000000000000000000000000000000000000000000000000000000000000000000000000000000000000000000000000000000000000000000000000000000---XXXXXX-----------000000000000000
00000000000000000000000000000000000000000000000000000000000000000000000000000000000000000000000000000000000000000000000000000000000000000000000000000000000000000000000000000000--XXXXXXX--------X--000000000000000
00000000000000000000000000000000000000000000000000000000000000000000000000000000000000000000000000000000000000000000000000000000000000000000000000000000000000000000000000000000--XXXXXXX-----------000000000000000
0000000000000000000000000000000000000000000000000000000000000000000000000000000000000000000000000000000000000000000000000000000000000000000000000000000000000000----XXXX----------XXXXXXX-----------000000000000000
0000000000000000000000000000000000000000000000000000000000000000000000000000000000000000000000000000000000000000000000000000000000000000000000000000000000000000------------------XXXXXXX-----------000000000000000
0000000000000000000000000000000000000000000000000000000000000000000000000000000000000000000000000000000000000000000000000000000000000000000000000000000000000000----------------XXXXXXXXX-----------000000000000000
0000000000000000000000000000000000000000000000000000000000000000000000000000000000000000000000000000000000000000000000000000000000000000000000000000000000000000TTTTTTTT--------00000000000000000000000000000000000
--------------------------------------------------------------------------------------------------------------------------------------------------------------------------------00000000000000000000000000000000000
--------------------------------------------------------------------------------------------------------------------------------------------------------------------------------00000000000000000000000000000000000
----------------------------------------------------------------------------------------------------------------------------------------------------------------------TTT-------00000000000000000000000000000000000
--------------------------------------------------------------------------------------------------------------------------------------------------------------------------------00000000000000000000000000000000000
--------------------------------------------------------------------------------------------------------------------------------------------------------------------------T-----00000000000000000000000000000000000
--------------------------------------------------------------------------------------------------------------------------------------------------------------------------------00000000000000000000000000000000000
----------------------------------------------------------------------------S------------oo-------------------------------------------------------------------------------------00000000000000000000000000000000000
-----------------------------------------------------------------------------------------------------------------------------------------------------------------------------X--00000000000000000000000000000000000
--------------------------------------------------------------------------------------------------------------------------------------------------------------------------------00000000000000000000000000000000000
--------------------------------------------------------XXX--------------------------------------------------------------------------------------------------------------TTT----00000000000000000000000000000000000
--------------------------------------E----------------------------------------------E-----------E-----------------------------------E------------------------------------------00000000000000000000000000000000000
----------------------------------E--<>---------------------------------------------<>------XX--<>----------Q--SSS-SS?--------------<>----------S?S-------------X-----------TTTT00000000000000000000000000000000000
--<>-----------------------------<>--[]---------------------------------------------[]----------[]---------------------------------E[]--------------------------XD-------------X00000000000000000000000000000000000
--[]-X---------------------------[]--[]---X-----------------------------------------[]----------[]---------------------<------------[]--------------------------XD-------------X00000000000000000000000000000000000
--[]-X---------------------------[]--[]---X-----E----------------E------------------[]----------[]---------------------[--------E---[]--------------------------XXXXX---XXXXXXXX00000000000000000000000000000000000
XXXXXXXXXX-----XXXX-XXXXXXXXXXXXXXXXXXX-XXXXXXXXXXX-X-------XXXXXXXXX-----------XXXXXXX--------XXXX-XXXXXXXXXXXXXXXXXXX[XXXXXXXXXXXXXXXXXXX-XXXXXXXX--XXXXXXXXXEXXXXXXXXXXXXXXXX00000000000000000000000000000000000
0000000000000000000000000000000000000000000000000000000000000000000000000000000000000000000000000000000000000000000000000000000000000000000000000000000000000000000000000000000000000000000000000000000000000000000