000000000000000000000000000000000000000000000000000000000000000000000000000000000000000000000000--------------------------------------------------------------------------------000000000000000
000000000000000000000000000000000000000000000000000000000000000000000000000000000000000000000000--------------------------------------------------------------------------------000000000000000
000000000000000000000000000000000000000000000000000000000000000000000000000000000000000000000000--------------------------------------------------------------------------------000000000000000
000000000000000000000000000000000000000000000000000000000000000000000000000000000000000000000000--------------------------------------------------------------------------------000000000000000
000000000000000000000000000000000000000000000000000000000000000000000000000000000000000000000000--------------------------------------------------------------------------------000000000000000
000000000000000000000000000000000000000000000000000000000000000000000000000000000000000000000000--------------------------------------------------------------------------------000000000000000
000000000000000000000000000000000000000000000000000000000000000000000000000000000000000000000000---------------------------------E----------------------------------------------000000000000000
000000000000000000000000000000000000000000000000000000000000000000000000000000000000000000000000---------------------------------E---------------QQ-----------------------------000000000000000
000000000000000000000000000000000000000000000000000000000000000000000000000000000000000000000000-----------------------------------XXXX-----------------------------------------000000000000000
000000000000000000000000000000000000000000000000000000000000000000000000000000000000000000000000---------------------------------------X----------------------------------------000000000000000
000000000000000000000000000000000000000000000000000000000000000000000000000000000000000000000000--------o---------------------XX-------------------------------E----------------000000000000000
000000000000000000000000000000000000000000000000000000000000000000000000000000000000000000000000-------o----------<--------------------------S?QQQX-------<E--<>----------------000000000000000
000000000000000000000000000000000000000000000000000000000000000000000000000000000000000000000000------------------[>-------X------------------------------[>--[]-----------E----000000000000000
000000000000000000000000000000000000000000000000000000000000000000000000000000000000000000000000------------------[]--------------------------------------[]--[]----------<>----000000000000000
000000000000000000000000000000000000000000000000000000000000000000000000000000000000000000000000------------------[]-----------------------------------EE-[]--[]---EE-----[]-E--000000000000000
00000000000000000000000000000000000000000000000000000000000000000000000000000000----------------XXXXXXXXXX---XXXXXX]XXXXX---------------XXXXXXXXXX--XXXXXXX]XXXXXXXXXXXXXXXXXXX-000000000000000
00000000000000000000000000000000000000000000000000000000000000000000000000000000---------TTT----00000000000000000000000000000000000000000000000000000000000000000000000000000000000000000000000
00000000000000000000000000000000000000000000000000000000000000000000000000000000----------------00000000000000000000000000000000000000000000000000000000000000000000000000000000000000000000000
00000000000000000000000000000000000000000000000000000000000000000000000000000000X-----------TTTT00000000000000000000000000000000000000000000000000000000000000000000000000000000000000000000000
00000000000000000000000000000000000000000000000000000000000000000000000000000000X--------------X00000000000000000000000000000000000000000000000000000000000000000000000000000000000000000000000
00000000000000000000000000000000000000000000000000000000000000000000000000000000X--------------X00000000000000000000000000000000000000000000000000000000000000000000000000000000000000000000000
00000000000000000000000000000000000000000000000000000000000000000000000000000000---X------------00000000000000000000000000000000000000000000000000000000000000000000000000000000000000000000000
00000000000000000000000000000000000000000000000000000000000000000000000000000000---X------------00000000000000000000000000000000000000000000000000000000000000000000000000000000000000000000000
00000000000000000000000000000000000000000000000000000000000000000000000000000000XXX-----------XX00000000000000000000000000000000000000000000000000000000000000000000000000000000000000000000000
00000000000000000000000000000000000000000000000000000000000000000000000000000000XXXXXXXXXXX---XX00000000000000000000000000000000000000000000000000000000000000000000000000000000000000000000000
00000000000000000000000000000000000000000000000000000000000000000000000000000000XXXX----------XX00000000000000000000000000000000000000000000000000000000000000000000000000000000000000000000000
00000000000000000000000000000000000000000000000000000000000000000000000000000000XXXX-----------X00000000000000000000000000000000000000000000000000000000000000000000000000000000000000000000000
00000000000000000000000000000000000000000000000000000000000000000000000000000000XXXX-----------X00000000000000000000000000000000000000000000000000000000000000000000000000000000000000000000000
00000000000000000000000000000000000000000000000000000000000000000000000000000000-XXXX----------X00000000000000000000000000000000000000000000000000000000000000000000000000000000000000000000000
00000000000000000000000000000000000000000000000000000000000000000000000000000000XXXXXX--------XX00000000000000000000000000000000000000000000000000000000000000000000000000000000000000000000000
00000000000000000000000000000000000000000000000000000000000000000000000000000000XX----XXXXX---XX00000000000000000000000000000000000000000000000000000000000000000000000000000000000000000000000
00000000000000000000000000000000000000000000000000000000000000000000000000000000XD------------XX00000000000000000000000000000000000000000000000000000000000000000000000000000000000000000000000
00000000000000000000000000000000000000000000000000000000000000000000000000000000XD------------XX00000000000000000000000000000000000000000000000000000000000000000000000000000000000000000000000
00000000000000000000000000000000000000000000000000000000000000000000000000000000XXXXX-------XXXX00000000000000000000000000000000000000000000000000000000000000000000000000000000000000000000000
00000000000000000000000000000000000000000000000000000000000000000000000000000000XXXXXXXXXXXXXXXX00000000000000000000000000000000000000000000000000000000000000000000000000000000000000000000000
00000000000000000000000000000000000000000000000000000000000000000000000000000000----------------00000000000000000000000000000000000000000000000000000000000000000000000000000000000000000000000
00000000000000000000000000000000000000000000000000000000000000000000000000000000----------------00000000000000000000000000000000000000000000000000000000000000000000000000000000000000000000000
00000000000000000000000000000000000000000000000000000000000000000000000000000000---------TTTT---00000000000000000000000000000000000000000000000000000000000000000000000000000000000000000000000
00000000000000000000000000000000000000000000000000000000000000000000000000000000----------------00000000000000000000000000000000000000000000000000000000000000000000000000000000000000000000000
00000000000000000000000000000000000000000000000000000000000000000000000000000000------XXXX------00000000000000000000000000000000000000000000000000000000000000000000000000000000000000000000000
00000000000000000000000000000000000000000000000000000000000000000000000000000000----------------00000000000000000000000000000000000000000000000000000000000000000000000000000000000000000000000
00000000000000000000000000000000000000000000000000000000000000000000000000000000---TTTT---------00000000000000000000000000000000000000000000000000000000000000000000000000000000000000000000000
00000000000000000000000000000000000000000000000000000000000000000000000000000000--------------E-00000000000000000000000000000000000000000000000000000000000000000000000000000000000000000000000
00000000000000000000000000000000000000000000000000000000000000000000000000000000XXXX--------XXXX00000000000000000000000000000000000000000000000000000000000000000000000000000000000000000000000
00000000000000000000000000000000000000000000000000000000000000000000000000000000----------------00000000000000000000000000000000000000000000000000000000000000000000000000000000000000000000000
00000000000000000000000000000000000000000000000000000000000000000000000000000000---------TTTT---00000000000000000000000000000000000000000000000000000000000000000000000000000000000000000000000
00000000000000000000000000000000000000000000000000000000000000000000000000000000----------------00000000000000000000000000000000000000000000000000000000000000000000000000000000000000000000000
00000000000000000000000000000000000000000000000000000000000000000000000000000000----------------00000000000000000000000000000000000000000000000000000000000000000000000000000000000000000000000
00000000000000000000000000000000000000000000000000000000000000000000000000000000XX------TTTTTTXX00000000000000000000000000000000000000000000000000000000000000000000000000000000000000000000000
00000000000000000000000000000000000000000000000000000000000000000000000000000000XX------------XX00000000000000000000000000000000000000000000000000000000000000000000000000000000000000000000000
00000000000000000000000000000000000000000000000000000000000000000000000000000000XX------------XX00000000000000000000000000000000000000000000000000000000000000000000000000000000000000000000000
00000000000000000000000000000000000000000000000000000000000000000000000000000000XD------------XX00000000000000000000000000000000000000000000000000000000000000000000000000000000000000000000000
00000000000000000000000000000000000000000000000000000000000000000000000000000000XD------------XX00000000000000000000000000000000000000000000000000000000000000000000000000000000000000000000000
00000000000000000000000000000000000000000000000000000000000000000000000000000000XXXXX-------XXXX00000000000000000000000000000000000000000000000000000000000000000000000000000000000000000000000
--------------------------------------------------------------------------------XXXXXXXXXXXXXXXX00000000000000000000000000000000000000000000000000000000000000000000000000000000000000000000000
--------------------------------------------------------------------------------000000000000000000000000000000000000000000000000000000000000000000000000000000000000000000000000000000000000000
--------------------------------------------------------------------------------000000000000000000000000000000000000000000000000000000000000000000000000000000000000000000000000000000000000000
--------------------------------------------------------------------------------000000000000000000000000000000000000000000000000000000000000000000000000000000000000000000000000000000000000000
--------------------------------------------------------------------------------000000000000000000000000000000000000000000000000000000000000000000000000000000000000000000000000000000000000000
--------------------------------------------------------------------------------000000000000000000000000000000000000000000000000000000000000000000000000000000000000000000000000000000000000000
----------------------------------------------------E---------------------------000000000000000000000000000000000000000000000000000000000000000000000000000000000000000000000000000000000000000
--------------E---------------------------------SSSSSS--------------------------000000000000000000000000000000000000000000000000000000000000000000000000000000000000000000000000000000000000000
-------------<>-----------------------------------------------------------------000000000000000000000000000000000000000000000000000000000000000000000000000000000000000000000000000000000000000
----------XX-[]-----------------------------------------------------------------000000000000000000000000000000000000000000000000000000000000000000000000000000000000000000000000000000000000000
---E------XX-X]-----------------------o-------------------------------E---------000000000000000000000000000000000000000000000000000000000000000000000000000000000000000000000000000000000000000
--<>----XXXX-XX----S-------------------------------SSSS--------------<>---------000000000000000000000000000000000000000000000000000000000000000000000000000000000000000000000000000000000000000
--[]----XXXX-XX------------------------------------------------------[]---------000000000000000000000000000000000000000000000000000000000000000000000000000000000000000000000000000000000000000
--[]----XXXX-XX------------------------------------------------------[]---------000000000000000000000000000000000000000000000000000000000000000000000000000000000000000000000000000000000000000
--[]----XXXX-XX----------E-----------------------E-------------E--E--[]-------E-000000000000000000000000000000000000000000000000000000000000000000000000000000000000000000000000000000000000000
XXXXXXXXXXXX-XXXX---XXXXXXXXXXXXXXXXX---XXXXXXXXXXXXXXXXXXX-XXXXXXXXXXXXXX--XXX-000000000000000000000000000000000000000000000000000000000000000000000000000000000000000000000000000000000000000
00000000000000000000000000000000000000000000000000000000000000000000000000000000000000000000000000000000000000000000000000000000000000000000000000000000000000000000000000000000000000000000000