00000000000000000000000000000000000000000000000000000000000000000000000000000000000000000000000000000000000000000000000000000000XXXX--------XXXX
00000000000000000000000000000000000000000000000000000000000000000000000000000000000000000000000000000000000000000000000000000000XXXX--------XXXX
00000000000000000000000000000000000000000000000000000000000000000000000000000000000000000000000000000000000000000000000000000000XXXXXXX-----XXXX
00000000000000000000000000000000000000000000000000000000000000000000000000000000000000000000000000000000000000000000000000000000XXXX--------XXXX
0000000000000000000000000000000000000000000000000000000000000000000000000000000000000000----------------------------------------XX-------------X
0000000000000000000000000000000000000000000000000000000000000000000000000000000000000000----------------------------------------XX---------XXXXX
0000000000000000000000000000000000000000000000000000000000000000000000000000000000000000----------------------------------------XXXX--XXXXXXXXXX
0000000000000000000000000000000000000000000000000000000000000000000000000000000000000000----------------------------------------XX----------XXXX
000000000000000000000000000000000000000000000000000000000000000000000000XD-------------XS-------------------S-------------------XX-----------XXX
000000000000000000000000000000000000000000000000000000000000000000000000XD-------------XS-------------------S-------------------XX----XXXXXXXXXX
000000000000000000000000000000000000000000000000000000000000000000000000XXXXXXXXXXXXXXXXS-------------------S-------------------XX------------XX
000000000000000000000000000000000000000000000000000000000000000000000000XXXXXXXXXXXX---XS---------------SSSSS-------------------XX------------XX
000000000000000000000000000000000000000000000000000000000000000000000000XXXXXXXXXXXXXXXXS-------------------S-------------------XXXXXXXX------XX
000000000000000000000000000000000000000000000000000000000000000000000000XXXX----------DXS-------------------S-------------------XXXX----------XX
000000000000000000000000000000000000000000000000000000000000000000000000XXXX----------XXS-------------------S-------------------XX------------XX
000000000000000000000000000000000000000000000000000000000000000000000000XXXXXXXX------XXS----XX-------E-----S-------------------XX----XXXXXXXXXX
000000000000000000000000000000000000000000000000000000000000000000000000XXXXXXXXXX----XXS----XX------<>-----S-------------------XD------------XX
000000000000000000000000000000000000000000000000000000000000000000000000XX------------XXS----XX------[]-----S--------<>---------XD------------XX
000000000000000000000000000000000000000000000000000000000000000000000000XX------------XXS----XX------[]-----S--------[]---------XXXXX-------XXXX
000000000000000000000000000000000000000000000000000000000000000000000000XX----XXXXXXXXXXXXEXXXXXXXXXXXXXXXXXXXXXXXXXXXXXXXXXXXXXXXXXXXXXXXXXXXXX
000000000000000000000000000000000000000000000000000000000000000000000000XX------------XX00000000000000000000000000000000000000000000000000000000
000000000000000000000000000000000000000000000000000000000000000000000000XX------------XX00000000000000000000000000000000000000000000000000000000
000000000000000000000000000000000000000000000000000000000000000000000000XXXXXXXX------XX00000000000000000000000000000000000000000000000000000000
000000000000000000000000000000000000000000000000000000000000000000000000XX----XXXXX---XX00000000000000000000000000000000000000000000000000000000
000000000000000000000000000000000000000000000000000000000000000000000000XD------------XX00000000000000000000000000000000000000000000000000000000
000000000000000000000000000000000000000000000000000000000000000000000000XD------------XX00000000000000000000000000000000000000000000000000000000
000000000000000000000000000000000000000000000000000000000000000000000000XXXXX-------XXXX00000000000000000000000000000000000000000000000000000000
000000000000000000000000000000000000000000000000000000000000000000000000XXXXXXXXXXXXXXXX00000000000000000000000000000000000000000000000000000000
000000000000000000000000000000000000000000000000000000000000000000000000----------------00000000000000000000000000000000000000000000000000000000
000000000000000000000000000000000000000000000000000000000000000000000000----------------00000000000000000000000000000000000000000000000000000000
000000000000000000000000000000000000000000000000000000000000000000000000-----T---TT-----00000000000000000000000000000000000000000000000000000000
000000000000000000000000000000000000000000000000000000000000000000000000----------------00000000000000000000000000000000000000000000000000000000
000000000000000000000000000000000000000000000000000000000000000000000000----------------00000000000000000000000000000000000000000000000000000000
000000000000000000000000000000000000000000000000000000000000000000000000-----TT--TT-----00000000000000000000000000000000000000000000000000000000
000000000000000000000000000000000000000000000000000000000000000000000000----------------00000000000000000000000000000000000000000000000000000000
000000000000000000000000000000000000000000000000000000000000000000000000----------------00000000000000000000000000000000000000000000000000000000
000000000000000000000000000000000000000000000000000000000000000000000000---------TTT----00000000000000000000000000000000000000000000000000000000
000000000000000000000000000000000000000000000000000000000000000000000000----------------00000000000000000000000000000000000000000000000000000000
000000000000000000000000000000000000000000000000000000000000000000000000X-----------TTTT00000000000000000000000000000000000000000000000000000000
000000000000000000000000000000000000000000000000000000000000000000000000X--------------X00000000000000000000000000000000000000000000000000000000
000000000000000000000000000000000000000000000000000000000000000000000000X--------------X00000000000000000000000000000000000000000000000000000000
000000000000000000000000000000000000000000000000000000000000000000000000XXXXXXXXX------X00000000000000000000000000000000000000000000000000000000
000000000000000000000000000000000000000000000000000000000000000000000000XX-------------X00000000000000000000000000000000000000000000000000000000
000000000000000000000000000000000000000000000000000000000000000000000000XX--------TTTTTT00000000000000000000000000000000000000000000000000000000
000000000000000000000000000000000000000000000000000000000000000000000000XD-------------X00000000000000000000000000000000000000000000000000000000
000000000000000000000000000000000000000000000000000000000000000000000000XD-------------X00000000000000000000000000000000000000000000000000000000
000000000000000000000000000000000000000000000000000000000000000000000000XXXXX-------XXXX00000000000000000000000000000000000000000000000000000000
000000000000000000000000000000000000000000000000000000000000000000000000XXXXXXXXXXXXXXXX00000000000000000000000000000000000000000000000000000000
000000000000000000000000000000000000000000000000000000000000000000000000X-------------XX00000000000000000000000000000000000000000000000000000000
000000000000000000000000000000000000000000000000000000000000000000000000X-------------XX00000000000000000000000000000000000000000000000000000000
000000000000000000000000000000000000000000000000000000000000000000000000X-------------XX00000000000000000000000000000000000000000000000000000000
000000000000000000000000000000000000000000000000000000000000000000000000X-------------XX00000000000000000000000000000000000000000000000000000000
000000000000000000000000000000000000000000000000000000000000000000000000X-------------XX00000000000000000000000000000000000000000000000000000000
000000000000000000000000000000000000000000000000000000000000000000000000X-------------DX00000000000000000000000000000000000000000000000000000000
000000000000000000000000000000000000000000000000000000000000000000000000X-------------DX00000000000000000000000000000000000000000000000000000000
000000000000000000000000000000000000000000000000000000000000000000000000X-----------XXXX00000000000000000000000000000000000000000000000000000000
000000000000000000000000000000000000000000000000000000000000000000000000XXXXX-------XXXX00000000000000000000000000000000000000000000000000000000
000000000000000000000000000000000000000000000000000000000000000000000000XX---------XXXXX00000000000000000000000000000000000000000000000000000000
000000000000000000000000000000000000000000000000000000000000000000000000XX--------TTTTTT00000000000000000000000000000000000000000000000000000000
000000000000000000000000000000000000000000000000000000000000000000000000XX----------XXXX00000000000000000000000000000000000000000000000000000000
0000000000000000000000000000000000000000000000000000--------------------XX----------XXXX00000000000000000000000000000000000000000000000000000000
0000000000000000000000000000000000000000000000000000--------------------XX------------XX00000000000000000000000000000000000000000000000000000000
0000000000000000000000000000000000000000000000000000--------------------XX--------------00000000000000000000000000000000000000000000000000000000
0000000000000000000000000000000000000000000000000000--------------------XX--------TTTTTT00000000000000000000000000000000000000000000000000000000
000000000000000000000000000000000000XXXX--------XXXXS-------------------XD--------------00000000000000000000000000000000000000000000000000000000
000000000000000000000000000000000000XXXX--------XXXXS-------------------XD-------------X00000000000000000000000000000000000000000000000000000000
000000000000000000000000000000000000XXTTTT------XXXXS-------------------XXXXX-------XXXX00000000000000000000000000000000000000000000000000000000
000000000000000000000000000000000000XXXX--------DXXXS-----------------XXXXXXXXXXXXXXXXXX00000000000000000000000000000000000000000000000000000000
0000000000000000--------------------XXXX--------DXXXS-----------------XX000000000000000000000000000000000000000000000000000000000000000000000000
0000000000000000--------------------XXXX--XXXXXXXXXXS---------------XXXX000000000000000000000000000000000000000000000000000000000000000000000000
0000000000000000--------------------XXXX---------DXXS-----E--------XXXXX000000000000000000000000000000000000000000000000000000000000000000000000
0000000000000000--------------------XXXX---------DXXS----<>-------XXXXXX000000000000000000000000000000000000000000000000000000000000000000000000
----------------S-------------------XXXX----XXXXXXXXS----[]------XXXXXXX000000000000000000000000000000000000000000000000000000000000000000000000
-----TT--TT-----S----------------------X-X----------S----[]-----XXXXXXXX000000000000000000000000000000000000000000000000000000000000000000000000
----------------S----------------------X------------S----[]----XXXXXXXXX000000000000000000000000000000000000000000000000000000000000000000000000
----------------S------SSSSSS----S--XXX-----------XXXXXXXXXXXXXXXXXXXXXX000000000000000000000000000000000000000000000000000000000000000000000000
--------TTTT----S-------------------XXXXXXXXXX----XX00000000000000000000000000000000000000000000000000000000000000000000000000000000000000000000
----------------S-------------------XX------------XX00000000000000000000000000000000000000000000000000000000000000000000000000000000000000000000
--TTTTTTTT------S-------------------XX------------XX00000000000000000000000000000000000000000000000000000000000000000000000000000000000000000000
----------------S--X--------S---SS--XX----XXXXXXXXXX00000000000000000000000000000000000000000000000000000000000000000000000000000000000000000000
----------------S-------------------XD------------XX00000000000000000000000000000000000000000000000000000000000000000000000000000000000000000000
-TTTT-----------S-------------------XD------------XX00000000000000000000000000000000000000000000000000000000000000000000000000000000000000000000
----------------S--------EE---------XXXXX-------XXXX00000000000000000000000000000000000000000000000000000000000000000000000000000000000000000000
----------------XXX-XXXXXXXXXXXXXXXXXXXXXXXXXXXXXXXX00000000000000000000000000000000000000000000000000000000000000000000000000000000000000000000
--------T-------00000000000000000000000000000000000000000000000000000000000000000000000000000000000000000000000000000000000000000000000000000000
----------------00000000000000000000000000000000000000000000000000000000000000000000000000000000000000000000000000000000000000000000000000000000
----------------00000000000000000000000000000000000000000000000000000000000000000000000000000000000000000000000000000000000000000000000000000000
XX----XXXXXXXXXX00000000000000000000000000000000000000000000000000000000000000000000000000000000000000000000000000000000000000000000000000000000
XD-----------TXX00000000000000000000000000000000000000000000000000000000000000000000000000000000000000000000000000000000000000000000000000000000
XD------------XX00000000000000000000000000000000000000000000000000000000000000000000000000000000000000000000000000000000000000000000000000000000
XXXXX-------XXXX00000000000000000000000000000000000000000000000000000000000000000000000000000000000000000000000000000000000000000000000000000000
XXXXXXXXXXXXXXXX00000000000000000000000000000000000000000000000000000000000000000000000000000000000000000000000000000000000000000000000000000000