000000000000000000000000000000000000----------------
000000000000000000000000000000000000----------------
000000000000000000000000000000000000--------TTTT----
000000000000000000000000000000000000----------------
000000000000000000000000000000000000----------------
000000000000000000000000000000000000------TTTT------
000000000000000000000000000000000000----------------
000000000000000000000000000000000000---------TTT----
000000000000000000000000000000000000----------------
000000000000000000000000000000000000X-----------TTTT
000000000000000000000000000000000000X--------------X
000000000000000000000000000000000000X--------------X
000000000000000000000000000000000000XXXXXXXXX------X
000000000000000000000000000000000000XX-------------X
000000000000000000000000000000000000XX--------TTTTTT
000000000000000000000000000000000000XD-------------X
000000000000000000000000000000000000XD-------------X
000000000000000000000000000000000000TTTTXXXXXXXX--DX
000000000000000000000000000000000000--TTTTTTTT-----X
000000000000000000000000000000000000---------TTTTTTT
000000000000000000000000000000000000X--XXXXX-------X
000000000000000000000000000000000000X--X-------X---X
000000000000000000000000000000000000X-TX-----XXXX--X
000000000000000000000000000000000000X--X-----------X
000000000000000000000000000000000000X--X----------XX
000000000000000000000000000000000000X--X----------XX
000000000000000000000000000000000000X--XXXXXXXXXXXXX
000000000000000000000000000000000000X-T------------X
000000000000000000000000000000000000X---------------
000000000000000000000000000000000000X--TTTT----TTTTT
000000000000000000000000000000000000X---------------
000000000000000000000000000000000000X---------------
000000000000000000000000000000000000XXXXXXXX--------
000000000000000000000000000000000000XX-------------X
000000000000000000000000000000000000XD--TTTT--TTTTTT
000000000000000000000000000000000000XD-------------X
000000000000000000000000000000000000XD-------------X
000000000000000000000000000000000000TTTTXXXXXXXX--XX
000000000000000000000000000000000000--TTTTTTTT-----X
000000000000000000000000000000000000---------TTTTTTT
000000000000000000000000000000000000----------------
000000000000000000000000000000000000XXXX--------XXXX
000000000000000000000000000000000000----------------
000000000000000000000000000000000000----------------
000000000000000000000000000000000000----------------
000000000000000000000000000000000000-----TTTTTTT----
000000000000000000000000000000000000----------------
000000000000000000000000000000000000----------------
000000000000000000000000000000000000---------TTTT---
000000000000000000000000000000000000X-----------TTTT
000000000000000000000000000000000000X--------------X
000000000000000000000000000000000000X--------------X
000000000000000000000000000000000000XXXXXXXXX------X
000000000000000000000000000000000000XX-------------X
000000000000000000000000000000000000XX--------TTTTTT
000000000000000000000000000000000000XD-------------X
000000000000000000000000000000000000XD-------------X
000000000000000000000000000000000000TTTTXXXXXXXX--DX
000000000000000000000000000000000000--TTTTTTTT-----X
000000000000000000000000000000000000---------TTTTTTT
000000000000000000000000000000000000----------------
000000000000000000000000000000000000----------------
000000000000000000000000000000000000------TTTT------
000000000000000000000000000000000000----------------
000000000000000000000000000000000000----------------
000000000000000000000000000000000000------TTTTTTTT--
000000000000000000000000000000000000----------------
000000000000000000000000000000000000---------TTT----
0000000000000000------------------------------------
0000000000000000--------------------X-----------TTTT
0000000000000000--------------------X--------------X
0000000000000000--------------------X--------------X
0000000000000000-------E------------XXXXXXXXX------X
0000000000000000--------------------XX-------------X
0000000000000000--------------------XX--------TTTTTT
0000000000000000--------------------XD-------------X
0000000000000000--------------------XD-------------X
0000000000000000--------------------TTTTXXXXXXXX--DX
0000000000000000----------------------TTTTTTTT-----X
0000000000000000-------------------X---------TTTTTTT
0000000000000000-------------------X0000000000000000
0000000000000000-------------------X0000000000000000
0000000000000000-------------------X0000000000000000
XXXX-----TTTTTTTXXXXXXXXXXXXXXXXXXXX0000000000000000
XXXX--------XXXX000000000000000000000000000000000000
XXXX--------XXXX000000000000000000000000000000000000
XXTTTT------XXXX000000000000000000000000000000000000
XXXX--------XXXX000000000000000000000000000000000000
XXXX--------XXXX000000000000000000000000000000000000
XXXX-T------XXXX000000000000000000000000000000000000
X-----------DXXX000000000000000000000000000000000000
X-----------DXXX000000000000000000000000000000000000
X---T--XXXXXXXXX000000000000000000000000000000000000
X--------------X000000000000000000000000000000000000
X--------------X000000000000000000000000000000000000
XXXXXXXXX------X000000000000000000000000000000000000
XX-------------X000000000000000000000000000000000000
XX--------TTTTTT000000000000000000000000000000000000
XD-------------X000000000000000000000000000000000000
XD-------------X000000000000000000000000000000000000
TTTTXXXXXXXX--DX000000000000000000000000000000000000
--TTTTTTTT-----X000000000000000000000000000000000000
---------TTTTTTT000000000000000000000000000000000000
----------------000000000000000000000000000000000000
---X------------000000000000000000000000000000000000
TTTT------------000000000000000000000000000000000000
----------------000000000000000000000000000000000000
----------------000000000000000000000000000000000000
------TTT-------000000000000000000000000000000000000
----------------000000000000000000000000000000000000
---------TTT----000000000000000000000000000000000000
----------------000000000000000000000000000000000000
X-----------TTTT000000000000000000000000000000000000
X--------------X000000000000000000000000000000000000
X--------------X000000000000000000000000000000000000
XXXXXXXXX------X000000000000000000000000000000000000
XX-------------X000000000000000000000000000000000000
XX--------TTTTTT000000000000000000000000000000000000
XD-------------X000000000000000000000000000000000000
XD-------------X000000000000000000000000000000000000
TTTTXXXXXXXX--DX000000000000000000000000000000000000
--TTTTTTTT-----X000000000000000000000000000000000000
---------TTTTTTT000000000000000000000000000000000000
---------TTTT---000000000000000000000000000000000000
----------------000000000000000000000000000000000000
XXXX--------XXXX000000000000000000000000000000000000
----------------000000000000000000000000000000000000
----------------000000000000000000000000000000000000
---------TTT----000000000000000000000000000000000000
----------------000000000000000000000000000000000000
X-----------TTTT000000000000000000000000000000000000
X--------------X000000000000000000000000000000000000
X----------X---X000000000000000000000000000000000000
X----------XXXXX000000000000000000000000000000000000
X----------XXXXX000000000000000000000000000000000000
XXXX-------XXXXX000000000000000000000000000000000000
XXXXXXXX---XXXXX000000000000000000000000000000000000
XD-------TTTT--X000000000000000000000000000000000000
XD-------------X000000000000000000000000000000000000
XD-------------X000000000000000000000000000000000000
TTTTXXXXXXXX--XX000000000000000000000000000000000000
--TTTTTTTT-----X000000000000000000000000000000000000
---------TTTTTTT000000000000000000000000000000000000
X--X-----------X000000000000000000000000000000000000
X--XXXXX-------X000000000000000000000000000000000000
X--X-----------X000000000000000000000000000000000000
X--X------XXXX-X000000000000000000000000000000000000
X--X-----------X000000000000000000000000000000000000
X--X-----XXXX--X000000000000000000000000000000000000
X--X-----------X000000000000000000000000000000000000
X--X----------XX000000000000000000000000000000000000
X--XXXXX------XX000000000000000000000000000000000000
X-----XXXX----XX000000000000000000000000000000000000
XXXX----------XX000000000000000000000000000000000000
XXXX----------DX000000000000000000000000000000000000
XXXXXXXXXXXX--DX000000000000000000000000000000000000
XXXXXXXXXXXXXXXX000000000000000000000000000000000000
XXXX----------XX000000000000000000000000000000000000
XD-------------X000000000000000000000000000000000000
XD-------------X000000000000000000000000000000000000
TTTTXXXXXXXX---X000000000000000000000000000000000000
--TTTTTTTT-----X000000000000000000000000000000000000
---------TTTTTTT000000000000000000000000000000000000
XXXX--------XXXX000000000000000000000000000000000000
XTTTTTTTT---XXXX000000000000000000000000000000000000
XXXX--------XXXX000000000000000000000000000000000000
XXXX--------XXXX000000000000000000000000000000000000
XXXX-----TTTTXXX000000000000000000000000000000000000
XXXX--------XXXX000000000000000000000000000000000000
XXXX--------XXXX000000000000000000000000000000000000
XTTTTTTTT---XXXX000000000000000000000000000000000000
XXXX--------XXXX000000000000000000000000000000000000
XXXX--------XXXX000000000000000000000000000000000000
XXXX-----TTTTXXX000000000000000000000000000000000000
XXXX--------XXXX000000000000000000000000000000000000
XXXX--------XXXX000000000000000000000000000000000000
XXXXXXXX----XXXX000000000000000000000000000000000000
X----XXXXXXXX--X000000000000000000000000000000000000
XD-------------X000000000000000000000000000000000000
XD-------------X000000000000000000000000000000000000
TTTTXXXXXXXX--XX000000000000000000000000000000000000
--TTTTTTTT-----X000000000000000000000000000000000000
---------TTTTTTT000000000000000000000000000000000000