000000000000000000000000000000000000000000000000000000000000000000000000----------------
000000000000000000000000000000000000000000000000000000000000000000000000----------------
000000000000000000000000000000000000000000000000000000000000000000000000TTTTTTTT--------
000000000000000000000000000000000000000000000000000000000000000000000000---------TTTT---
000000000000000000000000000000000000000000000000000000000000000000000000----------------
000000000000000000000000000000000000000000000000000000000000000000000000XXXX------T-XXXX
000000000000000000000000000000000000000000000000000000000000000000000000X-----------XXXX
000000000000000000000000000000000000000000000000000000000000000000000000XX----------XXXX
000000000000000000000000000000000000000000000000000000000000000000000000XX-----XXXXXXXXX
000000000000000000000000000000000000000000000000000000000000000000000000XX-------TTTT--X
000000000000000000000000000000000000000000000000000000000000000000000000XX-------------X
000000000000000000000000000000000000000000000000000000000000000000000000XX-------------X
000000000000000000000000000000000000000000000000000000000000000000000000XXXXXXXX----XXXX
000000000000000000000000000000000000000000000000000000000000000000000000XX-----XXXXXXXXX
000000000000000000000000000000000000000000000000000000000000000000000000XX-----------XXX
000000000000000000000000000000000000000000000000000000000000000000000000XX-----------XXX
000000000000000000000000000000000000000000000000000000000000000000000000XD-----------XXX
000000000000000000000000000000000000000000000000000000000000000000000000XD-----------XXX
000000000000000000000000000000000000000000000000000000000000000000000000XXXXXXXXXXXXXXXX
000000000000000000000000000000000000000000000000000000000000000000000000XXXXXXXXXXXXXXXX
000000000000000000000000000000000000000000000000000000000000000000000000X-----------XXXX
000000000000000000000000000000000000000000000000000000000000000000000000X-------------XX
000000000000000000000000000000000000000000000000000000000000000000000000X-------------XX
000000000000000000000000000000000000000000000000000000000000000000000000XXXX----------XX
000000000000000000000000000000000000000000000000000000000000000000000000XXXX----------XX
000000000000000000000000000000000000000000000000000000000000000000000000XXXX-----TTTT--X
000000000000000000000000000000000000000000000000000000000000000000000000XXXX--------XXXX
000000000000000000000000000000000000000000000000000000000000000000000000XXXX--------XXXX
000000000000000000000000000000000000000000000000000000000000000000000000XTTTTTTTT---XXXX
000000000000000000000000000000000000000000000000000000000000000000000000X---XXXX----XXXX
000000000000000000000000000000000000000000000000000000000000000000000000XX----------XXXX
000000000000000000000000000000000000000000000000000000000000000000000000XX----------XXXX
000000000000000000000000000000000000000000000000000000000000000000000000XXXXXXXX----XXXX
000000000000000000000000000000000000000000000000000000000000000000000000XX------XXXXXXXX
000000000000000000000000000000000000000000000000000000000000000000000000XX-----------XXX
000000000000000000000000000000000000000000000000000000000000000000000000XX-----------XXX
000000000000000000000000000000000000000000000000000000000000000000000000XD-----------XXX
000000000000000000000000000000000000000000000000000000000000000000000000XD-----------XXX
000000000000000000000000000000000000000000000000000000000000000000000000XXXXXXXXXXXXXXXX
000000000000000000000000000000000000000000000000000000000000000000000000XXXXXXXXXXXXXXXX
000000000000000000000000000000000000000000000000000000000000000000000000XXXX--------XXXX
000000000000000000000000000000000000000000000000000000000000000000000000XXXX--------XXXX
000000000000000000000000000000000000000000000000000000000000000000000000XXXX--XXXX--XXXX
000000000000000000000000000000000000000000000000000000000000000000000000XXXX--------XXXX
000000000000000000000000000000000000000000000000000000000000000000000000XXXX--------XXXX
000000000000000000000000000000000000000000000000000000000000000000000000XTTTTTTTT---XXXX
000000000000000000000000000000000000000000000000000000000000000000000000XXXX--------XXXX
000000000000000000000000000000000000000000000000000000000000000000000000XXXX--------XXXX
000000000000000000000000000000000000000000000000000000000000000000000000XXXXXXX-----XXXX
000000000000000000000000000000000000000000000000000000000000000000000000XXXX--------XXXX
000000000000000000000000000000000000000000000000000000000000000000000000XX------------XX
000000000000000000000000000000000000000000000000000000000000000000000000XX------XXXX--XX
000000000000000000000000000000000000000000000000000000000000000000000000XX-----XXXX---XX
000000000000000000000000000000000000000000000000000000000000000000000000XX------------XX
000000000000000000000000000000000000000000000000000000000000000000000000XX-----------XXX
000000000000000000000000000000000000000000000000000000000000000000000000XX-----------XXX
000000000000000000000000000000000000000000000000000000000000000000000000XD-----------XXX
000000000000000000000000000000000000000000000000000000000000000000000000XD-----------XXX
000000000000000000000000000000000000000000000000000000000000000000000000XXXXXXXXXXXXXXXX
000000000000000000000000000000000000000000000000000000000000000000000000XXXXXXXXXXXXXXXX
000000000000000000000000000000000000000000000000000000000000000000000000----------------
000000000000000000000000000000000000000000000000000000000000000000000000----------------
000000000000000000000000000000000000000000000000000000000000000000000000----------------
000000000000000000000000000000000000000000000000000000000000000000000000TTTTTTTT--------
000000000000000000000000000000000000000000000000000000000000000000000000---------TTTT---
000000000000000000000000000000000000000000000000000000000000000000000000----------------
000000000000000000000000000000000000000000000000000000000000000000000000XXXX--------XXXX
000000000000000000000000000000000000000000000000000000000000000000000000----------------
000000000000000000000000000000000000000000000000000000000000000000000000--------XXXX----
000000000000000000000000000000000000000000000000000000000000000000000000XX----------XXXX
000000000000000000000000000000000000000000000000000000000000000000000000XXXX--------XXXX
000000000000000000000000000000000000000000000000000000000000000000000000XX-----------XXX
000000000000000000000000000000000000000000000000000000000000000000000000XX-----XXXX--XXX
000000000000000000000000000000000000000000000000000000000000000000000000XX-----------XXX
000000000000000000000000000000000000000000000000000000000000000000000000XX-----------XXX
000000000000000000000000000000000000000000000000000000000000000000000000XX-----------XXX
000000000000000000000000000000000000000000000000000000000000000000000000XD-----------XXX
000000000000000000000000000000000000000000000000000000000000000000000000XD-----------XXX
000000000000000000000000000000000000000000000000000000000000000000000000XXXXXXXXXXXXXXXX
000000000000000000000000000000000000000000000000000000000000000000000000XXXXXXXXXXXXXXXX
000000000000000000000000000000000000000000000000000000000000000000000000----------------
000000000000000000000000000000000000000000000000000000000000000000000000----------------
000000000000000000000000000000000000000000000000000000000000000000000000----------------
000000000000000000000000000000000000000000000000000000000000000000000000----------------
000000000000000000000000000000000000000000000000000000000000000000000000----------------
000000000000000000000000000000000000000000000000000000000000000000000000XX----------XXXX
000000000000000000000000000000000000000000000000000000000000000000000000XX----------XXXX
000000000000000000000000000000000000000000000000000000000000000000000000XX----------XXXX
0000000000000000000000000000000000000000000000000000--------------------XX-----------XXX
0000000000000000000000000000000000000000000000000000--------------------XX-----------XXX
0000000000000000000000000000000000000000000000000000--------------------XXXXXXXX-----XXX
0000000000000000000000000000000000000000000000000000--------------------XX-----------XXX
0000000000000000000000000000000000000000000000000000--------------------XX-----------XXX
0000000000000000000000000000000000000000000000000000--------------------XXXXXXXX-----XXX
0000000000000000000000000000000000000000000000000000--------------------XX-----------XXX
0000000000000000000000000000000000000000000000000000--------------------XX-----------XXX
0000000000000000000000000000000000000000000000000000--------------------XD-----------XXX
0000000000000000000000000000000000000000000000000000--------------------XD-----------XXX
0000000000000000000000000000000000000000000000000000--------------------XXXXXXXXXXXXXXXX
0000000000000000000000000000000000000000000000000000-------------------SXXXXXXXXXXXXXXXX
0000000000000000000000000000000000000000000000000000----------S---------0000000000000000
0000000000000000000000000000000000000000000000000000--------------------0000000000000000
0000000000000000000000000000000000000000000000000000---------------X----0000000000000000
000000000000000000000000000000000000---XXXXX--------XXXXXXXXXXXXXXXXXXXX0000000000000000
000000000000000000000000000000000000---XX-----------000000000000000000000000000000000000
000000000000000000000000000000000000---XX-----------000000000000000000000000000000000000
000000000000000000000000000000000000XXXX----------XX000000000000000000000000000000000000
000000000000000000000000000000000000XXXX----------DX000000000000000000000000000000000000
000000000000000000000000000000000000XXXX----------DX000000000000000000000000000000000000
000000000000000000000000000000000000XXXX----XXXXXXXX000000000000000000000000000000000000
000000000000000000000000000000000000---X-X----------000000000000000000000000000000000000
000000000000000000000000000000000000---X------------000000000000000000000000000000000000
000000000000000000000000000000000000XXXX----------XX000000000000000000000000000000000000
000000000000000000000000000000000000XXXXXXXX------XX000000000000000000000000000000000000
000000000000000000000000000000000000XXXXXXXXXX----XX000000000000000000000000000000000000
000000000000000000000000000000000000XX------------XX000000000000000000000000000000000000
000000000000000000000000000000000000XX------------XX000000000000000000000000000000000000
000000000000000000000000000000000000XX-----XXXXXXXXX000000000000000000000000000000000000
000000000000000000000000000000000000XX-------------X000000000000000000000000000000000000
000000000000000000000000000000000000XD-----------XXX000000000000000000000000000000000000
000000000000000000000000000000000000XD-----------XXX000000000000000000000000000000000000
000000000000000000000000000000000000XXXXXXXXXXXXXXXX000000000000000000000000000000000000
000000000000000000000000000000000000XXXXXXXXXXXXXXXX000000000000000000000000000000000000
000000000000000000000000000000000000MMMMMMMMMMMMMMMM000000000000000000000000000000000000
000000000000000000000000000000000000----------------000000000000000000000000000000000000
000000000000000000000000000000000000----------------000000000000000000000000000000000000
000000000000000000000000000000000000-------TT-------000000000000000000000000000000000000
000000000000000000000000000000000000----------------000000000000000000000000000000000000
000000000000000000000000000000000000----------------000000000000000000000000000000000000
000000000000000000000000000000000000X-----------TTT-000000000000000000000000000000000000
0000000000000000--------------------X-------------X-000000000000000000000000000000000000
0000000000000000--------------------X-------------XX000000000000000000000000000000000000
0000000000000000--------------------X-------------DX000000000000000000000000000000000000
0000000000000000--------------------X-------------DX000000000000000000000000000000000000
0000000000000000--------------------X-----XXXXXXXXXX000000000000000000000000000000000000
0000000000000000--------------------X------XXXXXXXXX000000000000000000000000000000000000
0000000000000000--------------------XXXXXXXXXXXXXXXX000000000000000000000000000000000000
0000000000000000-----------o--------XXXXXXXX---XXXXX000000000000000000000000000000000000
0000000000000000------------ooooo---XX------TTTTTTTT000000000000000000000000000000000000
0000000000000000--------------------XD-----------XXX000000000000000000000000000000000000
0000000000000000--------------------XD-----------XXX000000000000000000000000000000000000
0000000000000000-------SSS----------XXXXXXXXXXXXXXXX000000000000000000000000000000000000
0000000000000000-------------------XXXXXXXXXXXXXXXXX000000000000000000000000000000000000
0000000000000000--------------------0000000000000000000000000000000000000000000000000000
0000000000000000--------E-----------0000000000000000000000000000000000000000000000000000
-------X--------XXXXXXXXXXXXXXXXXXX-0000000000000000000000000000000000000000000000000000
-------X--------000000000000000000000000000000000000000000000000000000000000000000000000
-------X---X----000000000000000000000000000000000000000000000000000000000000000000000000
----------------000000000000000000000000000000000000000000000000000000000000000000000000
----X-----------000000000000000000000000000000000000000000000000000000000000000000000000
----------------000000000000000000000000000000000000000000000000000000000000000000000000
----------------000000000000000000000000000000000000000000000000000000000000000000000000
----------X-----000000000000000000000000000000000000000000000000000000000000000000000000
----------X-----000000000000000000000000000000000000000000000000000000000000000000000000
----------------000000000000000000000000000000000000000000000000000000000000000000000000
----------------000000000000000000000000000000000000000000000000000000000000000000000000
-------------X--000000000000000000000000000000000000000000000000000000000000000000000000
-----------XXXX-000000000000000000000000000000000000000000000000000000000000000000000000
----------XXXX--000000000000000000000000000000000000000000000000000000000000000000000000
XX--------XXXX--000000000000000000000000000000000000000000000000000000000000000000000000
XX------XXXXX---000000000000000000000000000000000000000000000000000000000000000000000000
XD-----------XXX000000000000000000000000000000000000000000000000000000000000000000000000
XD-----------XXX000000000000000000000000000000000000000000000000000000000000000000000000
XXXXXXXXXXXXXXXX000000000000000000000000000000000000000000000000000000000000000000000000
XXXXXXXXXXXXXXXX000000000000000000000000000000000000000000000000000000000000000000000000