00000000000000000000000000000000000000000000000000000000----------------
00000000000000000000000000000000000000000000000000000000XXXX------------
00000000000000000000000000000000000000000000000000000000XXXX------------
00000000000000000000000000000000000000000000000000000000XXXXEEEX--------
00000000000000000000000000000000000000000000000000000000XXXXXX-XX-------
00000000000000000000000000000000000000000000000000000000----------------
00000000000000000000000000000000000000000000000000000000----------------
00000000000000000000000000000000000000000000000000000000---------TTT----
00000000000000000000000000000000000000000000000000000000----------------
00000000000000000000000000000000000000000000000000000000X-----------TTTT
00000000000000000000000000000000000000000000000000000000X--------------X
00000000000000000000000000000000000000000000000000000000X--------------X
00000000000000000000000000000000000000000000000000000000XXXXXXXXX------X
00000000000000000000000000000000000000000000000000000000XX-------------X
00000000000000000000000000000000000000000000000000000000XX--------TTTTTT
00000000000000000000000000000000000000000000000000000000XD-------------X
00000000000000000000000000000000000000000000000000000000XD-------------X
00000000000000000000000000000000000000000000000000000000TTTTXXXXXXXX--DX
00000000000000000000000000000000000000000000000000000000--TTTTTTTT-----X
00000000000000000000000000000000000000000000000000000000---------TTTTTTT
00000000000000000000000000000000000000000000000000000000----------------
00000000000000000000000000000000000000000000000000000000---------XXXX---
00000000000000000000000000000000000000000000000000000000----------------
00000000000000000000000000000000000000000000000000000000---E---E--------
00000000000000000000000000000000000000000000000000000000MMMMMMMMMMMMMMMM
00000000000000000000000000000000000000000000000000000000----------------
00000000000000000000000000000000000000000000000000000000----------------
00000000000000000000000000000000000000000000000000000000---------TTT----
00000000000000000000000000000000000000000000000000000000----------------
00000000000000000000000000000000000000000000000000000000X-----------TTTT
00000000000000000000000000000000000000000000000000000000X--------------X
00000000000000000000000000000000000000000000000000000000X--------------X
00000000000000000000000000000000000000000000000000000000XXXXXXXXXXXX---X
00000000000000000000000000000000000000000000000000000000XX-------------X
00000000000000000000000000000000000000000000000000000000XX--------TTTTTT
00000000000000000000000000000000000000000000000000000000XD-------------X
00000000000000000000000000000000000000000000000000000000XD-------------X
00000000000000000000000000000000000000000000000000000000TTTTXXXXXXXX---X
00000000000000000000000000000000000000000000000000000000--TTTTTTTT-----X
00000000000000000000000000000000000000000000000000000000---------TTTTTTT
00000000000000000000000000000000000000000000000000000000--------T-------
00000000000000000000000000000000000000000000000000000000----------------
00000000000000000000000000000000000000000000000000000000----------------
00000000000000000000000000000000000000000000000000000000XXXXXXX---------
00000000000000000000000000000000000000000000000000000000----------------
00000000000000000000000000000000000000000000000000000000------TTT-------
00000000000000000000000000000000000000000000000000000000----------------
00000000000000000000000000000000000000000000000000000000---------TTT----
00000000000000000000000000000000000000000000000000000000----------------
00000000000000000000000000000000000000000000000000000000X-----------TTTT
00000000000000000000000000000000000000000000000000000000X--------------X
00000000000000000000000000000000000000000000000000000000X--------------X
00000000000000000000000000000000000000000000000000000000XXXXXXXXX------X
00000000000000000000000000000000000000000000000000000000XX-------------X
00000000000000000000000000000000000000000000000000000000XX--------TTTTTT
00000000000000000000000000000000000000000000000000000000XD-------------X
00000000000000000000000000000000000000000000000000000000XD-------------X
00000000000000000000000000000000000000000000000000000000TTTTXXXXXXXX---X
00000000000000000000000000000000000000000000000000000000--TTTTTTTT-----X
00000000000000000000000000000000000000000000000000000000---------TTTTTTT
00000000000000000000000000000000000000000000000000000000X----XXXXXXXXXXX
00000000000000000000000000000000000000000000000000000000X-------XXXXXXXX
00000000000000000000000000000000000000000000000000000000X-----------XXXX
00000000000000000000000000000000000000000000000000000000X-------------XX
00000000000000000000000000000000000000000000000000000000X-------------XX
00000000000000000000000000000000000000000000000000000000X-------------XX
00000000000000000000000000000000000000000000000000000000X-------------DX
00000000000000000000000000000000000000000000000000000000X-------------DX
00000000000000000000000000000000000000000000000000000000X-------------XX
00000000000000000000000000000000000000000000000000000000X---T--XXXXXXXXX
00000000000000000000000000000000000000000000000000000000X--------------X
00000000000000000000000000000000000000000000000000000000X--------------X
00000000000000000000000000000000000000000000000000000000XXXXXXXXX------X
00000000000000000000000000000000000000000000000000000000XX-------------X
00000000000000000000000000000000000000000000000000000000XX--------TTTTTT
00000000000000000000000000000000000000000000000000000000XD-------------X
00000000000000000000000000000000000000000000000000000000XD-------------X
00000000000000000000000000000000000000000000000000000000TTTTXXXXXXXX--DX
00000000000000000000000000000000000000000000000000000000--TTTTTTTT-----X
00000000000000000000000000000000000000000000000000000000---------TTTTTTT
00000000000000000000000000000000000000000000000000000000----------X-----
00000000000000000000000000000000000000000000000000000000---------X------
00000000000000000000000000000000000000000000000000000000---------X------
00000000000000000000000000000000000000000000000000000000-------X--------
00000000000000000000000000000000000000000000000000000000-------X--------
00000000000000000000000000000000000000000000000000000000-------X--------
00000000000000000000000000000000000000000000000000000000-------X--------
00000000000000000000000000000000000000000000000000000000------X--X------
00000000000000000000000000000000000000000000000000000000----------------
00000000000000000000000000000000000000000000000000000000----------------
00000000000000000000000000000000000000000000000000000000----------------
00000000000000000000000000000000000000000000000000000000----------------
00000000000000000000000000000000000000000000000000000000XXXX------------
00000000000000000000000000000000000000000000000000000000XXXX------------
00000000000000000000000000000000000000000000000000000000XD-------TTTT---
00000000000000000000000000000000000000000000000000000000XD-------------X
00000000000000000000000000000000000000000000000000000000XD-------------X
00000000000000000000000000000000000000000000000000000000TTTTXXXXXXXX--XX
00000000000000000000000000000000000000000000000000000000--TTTTTTTT-----X
00000000000000000000000000000000000000000000000000000000---------TTTTTTT
00000000000000000000000000000000000000000000000000000000----------------
00000000000000000000000000000000000000000000000000000000----------------
00000000000000000000000000000000000000000000000000000000--------TTT-----
00000000000000000000000000000000000000000000000000000000----------------
00000000000000000000000000000000000000000000000000000000----------------
00000000000000000000000000000000000000000000000000000000------TTTT------
00000000000000000000000000000000000000000000000000000000----------------
00000000000000000000000000000000000000000000000000000000---------XXXX---
00000000000000000000000000000000000000000000000000000000---------E------
00000000000000000000000000000000000000000000000000000000X-----------TTTT
00000000000000000000000000000000000000000000000000000000X--------------X
00000000000000000000000000000000000000000000000000000000X--------------X
00000000000000000000000000000000000000000000000000000000XXXXXXXXXXXX---X
00000000000000000000000000000000000000000000000000000000XX-------------X
00000000000000000000000000000000000000000000000000000000XX--------TTTTTT
00000000000000000000000000000000000000000000000000000000XD-------------X
00000000000000000000000000000000000000000000000000000000XD-------------X
00000000000000000000000000000000000000000000000000000000TTTTXXXXXXXX--DX
00000000000000000000000000000000000000000000000000000000--TTTTTTTT-----X
00000000000000000000000000000000000000000000000000000000---------TTTTTTT
00000000000000000000000000000000000000000000000000000000X-----------D--X
00000000000000000000000000000000000000000000000000000000X----------DXXXX
00000000000000000000000000000000000000000000000000000000X---XXXXXXXXXXXX
00000000000000000000000000000000000000000000000000000000X-------XXXXXXXX
00000000000000000000000000000000000000000000000000000000X-----------XXXX
00000000000000000000000000000000000000000000000000000000X-------------XX
00000000000000000000000000000000000000000000000000000000X-------------XX
00000000000000000000000000000000000000000000000000000000X-------------XX
00000000000000000000000000000000000000000000000000000000X-------------XX
00000000000000000000000000000000000000000000000000000000X-------------XX
00000000000000000000000000000000000000000000000000000000X-----XXXX----XX
00000000000000000000000000000000000000000000000000000000X-------------XX
00000000000000000000000000000000000000000000000000000000XX------------XX
00000000000000000000000000000000000000000000000000000000XXXXXXXXX-----XX
00000000000000000000000000000000000000000000000000000000XD--TTTT-------X
00000000000000000000000000000000000000000000000000000000XD-------------X
00000000000000000000000000000000000000000000000000000000XD-------------X
00000000000000000000000000000000000000000000000000000000TTTTXXXXXXXX--XX
00000000000000000000000000000000000000000000000000000000--TTTTTTTT-----X
0000000000000000-------------------------------------------------TTTTTTT
0000000000000000----------------------------------------0000000000000000
0000000000000000----------------------------------------0000000000000000
0000000000000000----------------------------------------0000000000000000
0000000000000000----------------------------------------0000000000000000
0000000000000000----------------------------------------0000000000000000
0000000000000000----------------------------------------0000000000000000
0000000000000000------------------------o---------------0000000000000000
0000000000000000----------------------------------------0000000000000000
0000000000000000----------------------------------------0000000000000000
0000000000000000----SSS---------------------------------0000000000000000
0000000000000000----------------------------------------0000000000000000
0000000000000000----------------------X---X-------------0000000000000000
0000000000000000----------------------X---X-------------0000000000000000
0000000000000000-------------E-E-E-E--X---X-------------0000000000000000
X-------------XXXXXXXXXXXXXXXXXXXXXXXXXXXXXXXXXXXXXXXXX-0000000000000000
X-------------XX00000000000000000000000000000000000000000000000000000000
X-------------XX00000000000000000000000000000000000000000000000000000000
X-------------XX00000000000000000000000000000000000000000000000000000000
X-------------XX00000000000000000000000000000000000000000000000000000000
X-----XXXX----XX00000000000000000000000000000000000000000000000000000000
X-------------XX00000000000000000000000000000000000000000000000000000000
X-------------XX00000000000000000000000000000000000000000000000000000000
X-----XXXX----XX00000000000000000000000000000000000000000000000000000000
X------------XXX00000000000000000000000000000000000000000000000000000000
X------------XXX00000000000000000000000000000000000000000000000000000000
X-----XX------XX00000000000000000000000000000000000000000000000000000000
XXXXXXXXXXXXXXXX00000000000000000000000000000000000000000000000000000000
XX-----XXXXXXXXX00000000000000000000000000000000000000000000000000000000
XX--------TTTTTT00000000000000000000000000000000000000000000000000000000
XD-------------X00000000000000000000000000000000000000000000000000000000
XD-------------X00000000000000000000000000000000000000000000000000000000
TTTTXXXXXXXX--DX00000000000000000000000000000000000000000000000000000000
--TTTTTTTT-----X00000000000000000000000000000000000000000000000000000000
---------TTTTTTT00000000000000000000000000000000000000000000000000000000