0000000000000000000000000000000000000000000000000000000000000000000000000000--000000000000000
0000000000000000000000000000000000000000000000000000000000000000000000000000--000000000000000
0000000000000000000000000000000000000000000000000000000000000000000000000000--000000000000000
0000000000000000000000000000000000000000000000000000000000000000000000000000--000000000000000
0000000000000000000000000000000000000000000000000000000000000000000000000000--000000000000000
0000000000000000000000000000000000000000000000000000000000000000000000000000--000000000000000
0000000000000000000000000000000000000000000000000000000000000000000000000000--000000000000000
0000000000000000000000000000000000000000000000000000000000000000000000000000--000000000000000
0000000000000000000000000000000000000000000000000000000000000000000000000000--000000000000000
0000000000000000000000000000000000000000000000000000000000000000000000000000--000000000000000
0000000000000000000000000000000000000000000000000000000000000000000000000000--000000000000000
0000000000000000000000000000000000000000000000000000000000000000000000000000--000000000000000
0000000000000000000000000000000000000000000000000000000000000000000000000000--000000000000000
000000000000000000000000000000000000000000000000000000000000------------------000000000000000
000000000000000000000000000000000000000000000000000000000000------------------000000000000000
000000000000000000000000000000000000000000000000000000000000----------------XX000000000000000
000000000000000000000000000000000000000000000000000000000000-----TT---------00000000000000000
000000000000000000000000000000000000000000000000000000000000----------------00000000000000000
000000000000000000000000000000000000000000000000000000000000---E-----E------00000000000000000
000000000000000000000000000000000000000000000000000000000000MMMMMMMMMMMMMMMX00000000000000000
000000000000000000000000000000000000000000000000000000000000----------------00000000000000000
000000000000000000000000000000000000000000000000000000000000--E--------E----00000000000000000
000000000000000000000000000000000000000000000000000000000000MMMMMMMMMMMMMMMM00000000000000000
000000000000000000000000000000000000000000000000000000000000----------------00000000000000000
000000000000000000000000000000000000000000000000000000000000----------------00000000000000000
000000000000000000000000000000000000000000000000000000000000XXXX------------00000000000000000
000000000000000000000000000000000000000000000000000000000000----------------00000000000000000
000000000000000000000000000000000000000000000000000000000000------TTTT------00000000000000000
000000000000000000000000000000000000000000000000000000000000----------------00000000000000000
000000000000000000000000000000000000000000000000000000000000---------XXXX---00000000000000000
000000000000000000000000000000000000000000000000000000000000----------------00000000000000000
000000000000000000000000000000000000000000000000000000000000----------------00000000000000000
000000000000000000000000000000000000000000000000000000000000XMMMMMMMMMMMMMMM00000000000000000
000000000000000000000000000000000000000000000000000000000000----------------00000000000000000
000000000000000000000000000000000000000000000000000000000000----E--------E--00000000000000000
000000000000000000000000000000000000000000000000000000000000MMMMMMMMMMMMMMMM00000000000000000
000000000000000000000000000000000000000000000000000000000000----------------00000000000000000
000000000000000000000000000000000000000000000000000000000000----------------00000000000000000
000000000000000000000000000000000000000000000000000000000000XMMMMMMMMMMMMMMM00000000000000000
000000000000000000000000000000000000000000000000000000000000----------------00000000000000000
000000000000000000000000000000000000000000000000000000000000----E--------E--00000000000000000
000000000000000000000000000000000000000000000000000000000000MMMMMMMMMMMMMMMM00000000000000000
000000000000000000000000000000000000000000000000000000000000----------------00000000000000000
000000000000000000000000000000000000000000000000000000000000----------------00000000000000000
000000000000000000000000000000000000000000000000000000000000TTTTTTTT-------X00000000000000000
000000000000000000000000000000000000000000000000000000000000---------TTTT---00000000000000000
000000000000000000000000000000000000000000000000000000000000----------------00000000000000000
000000000000000000000000000000000000000000000000000000000000XXXX--------XXXX00000000000000000
000000000000000000000000000000000000000000000000000000000000-----E----------00000000000000000
000000000000000000000000000000000000000000000000000000000000----TTT---------00000000000000000
000000000000000000000000000000000000000000000000000000000000----------------00000000000000000
000000000000000000000000000000000000000000000000000000000000------XXXX------00000000000000000
000000000000000000000000000000000000000000000000000000000000----------------00000000000000000
00000000000000000000000000000000000000000000000000000----------------TTTT---00000000000000000
00000000000000000000000000000000000000000000000000000-------000000000000000000000000000000000
00000000000000000000000000000000000000000000000000000-------000000000000000000000000000000000
00000000000000000000000000000000000000000000000000000-------000000000000000000000000000000000
00000000000000000000000000000000000000000000000000000-------000000000000000000000000000000000
00000000000000000000000000000000000000000000000000000-------000000000000000000000000000000000
00000000000000000000000000000000000000000000000000000-------000000000000000000000000000000000
00000000000000000000000000000000000000000000000000000-------000000000000000000000000000000000
00000000000000000000000000000000000000000000000000000-------000000000000000000000000000000000
00000000000000000000000000000000000000000000000000000-------000000000000000000000000000000000
00000000000000000000000000000000000000000000000000000-------000000000000000000000000000000000
00000000000000000000000000000000000000000000000000000----X--000000000000000000000000000000000
00000000000000000000000000000000000000000000000000000----X--000000000000000000000000000000000
0000000000000000000000000000000000000--------------------X--000000000000000000000000000000000
0000000000000000000000000000000000000----------------E---X--000000000000000000000000000000000
0000000000000000000000000000000000000TTTTTTTT--------XXXXX--000000000000000000000000000000000
0000000000000000000000000000000000000---------TTTT---0000000000000000000000000000000000000000
0000000000000000000000000000000000000----------------0000000000000000000000000000000000000000
0000000000000000000000000000000000000XXXX--------XXXX0000000000000000000000000000000000000000
0000000000000000000000000000000000000----------------0000000000000000000000000000000000000000
0000000000000000000000000000000000000----------------0000000000000000000000000000000000000000
0000000000000000000000000000000000000----------------0000000000000000000000000000000000000000
0000000000000000000000000000000000000--------TTTT----0000000000000000000000000000000000000000
0000000000000000000000000000000000000----------------0000000000000000000000000000000000000000
0000000000000000000000000000000000000----------------0000000000000000000000000000000000000000
0000000000000000000000000000000000000-----TT--TT-----0000000000000000000000000000000000000000
0000000000000000000000000000000000000----------------0000000000000000000000000000000000000000
0000000000000000000000000000000000000----------------0000000000000000000000000000000000000000
0000000000000000000000000000000000000--------TTTT----0000000000000000000000000000000000000000
0000000000000000000000000000000000000----------------0000000000000000000000000000000000000000
0000000000000000000000000000000000000--TTTTTTTT------0000000000000000000000000000000000000000
0000000000000000000000000000000000000----------------0000000000000000000000000000000000000000
0000000000000000000000000000000000000----------------0000000000000000000000000000000000000000
0000000000000000000000000000000000000XXXX------------0000000000000000000000000000000000000000
0000000000000000000000000000000000000XXXX------------0000000000000000000000000000000000000000
0000000000000000000000000000000000000XXXXXXXXX-------0000000000000000000000000000000000000000
0000000000000000000000000000000000000X---------------0000000000000000000000000000000000000000
0000000000000000000000000000000000000X---------------0000000000000000000000000000000000000000
0000000000000000000000000000000000000XXXX--------XXXX0000000000000000000000000000000000000000
0000000000000000000000000000000000000XXXX--------XXXX0000000000000000000000000000000000000000
0000000000000000000000000000000000000XXXX--XXXXXXXXXX0000000000000000000000000000000000000000
0000000000000000000000000000000000000XXXX--------XXXX0000000000000000000000000000000000000000
0000000000000000000000000000000000000XX-----------XXX0000000000000000000000000000000000000000
0000000000000000000000000000000000000XX-----XXXXXXXXX0000000000000000000000000000000000000000
0000000000000000000000000000000000000XXXX----XXXXXXXX0000000000000000000000000000000000000000
0000000000000000000000000000000000000XX----------XXXX0000000000000000000000000000000000000000
0000000000000000000000000000000000000XX----------XXXX0000000000000000000000000000000000000000
0000000000000000000000000000000000000XX----TTXXXXXXXX0000000000000000000000000000000000000000
0000000000000000000000000000000000000XX--------------0000000000000000000000000000000000000000
0000000000000000000000000000000000000XX--------------0000000000000000000000000000000000000000
0000000000000000000000000000000000000XXTTTT----------0000000000000000000000000000000000000000
0000000000000000000000000000000000000XX--------------0000000000000000000000000000000000000000
0000000000000000000000000000000000000----------------0000000000000000000000000000000000000000
0000000000000000000000000000000000000------TTTT------0000000000000000000000000000000000000000
0000000000000000000000000000000000000----------------0000000000000000000000000000000000000000
0000000000000000000000000000000000000----------------0000000000000000000000000000000000000000
0000000000000000000000000000000000000----------------0000000000000000000000000000000000000000
0000000000000000000000000000000000000---------X---X--0000000000000000000000000000000000000000
0000000000000000000000000000000000000---------X---X--0000000000000000000000000000000000000000
0000000000000000000000000000000000000-------------X--0000000000000000000000000000000000000000
0000000000000000000000000000000000000-------------X--0000000000000000000000000000000000000000
0000000000000000000000000000000000000-------------X--0000000000000000000000000000000000000000
00000000000000000000000000000000000---------------X--0000000000000000000000000000000000000000
00000000000000000000000000000000000--00000000000000000000000000000000000000000000000000000000
00000000000000000000000000000000000--00000000000000000000000000000000000000000000000000000000
00000000000000000000000000000000000--00000000000000000000000000000000000000000000000000000000
00000000000000000000000000000000000--00000000000000000000000000000000000000000000000000000000
00000000000000000000000000000000000--00000000000000000000000000000000000000000000000000000000
00000000000000000000000000000000000--00000000000000000000000000000000000000000000000000000000
00000000000000000000000000000000000--00000000000000000000000000000000000000000000000000000000
00000000000000000000000000000000000--00000000000000000000000000000000000000000000000000000000
00000000000000000000000000000000000--00000000000000000000000000000000000000000000000000000000
00000000000000000000000000000000000--00000000000000000000000000000000000000000000000000000000
00000000000000000000000000000000000--00000000000000000000000000000000000000000000000000000000
00000000000000000000000000000000000--00000000000000000000000000000000000000000000000000000000
00000000000000000000000000000000000--00000000000000000000000000000000000000000000000000000000
0000000000000000000------------------00000000000000000000000000000000000000000000000000000000
0000000000000000000----------------X-00000000000000000000000000000000000000000000000000000000
0000000000000000000-----------XXXX-0000000000000000000000000000000000000000000000000000000000
0000000000000000000-XXXX-----------0000000000000000000000000000000000000000000000000000000000
0000000000000000000----------------0000000000000000000000000000000000000000000000000000000000
0000000000000000000----------------0000000000000000000000000000000000000000000000000000000000
0000000000000000000----TTTT--------0000000000000000000000000000000000000000000000000000000000
0000000000000000000----------------0000000000000000000000000000000000000000000000000000000000
0000000000000000000----------------0000000000000000000000000000000000000000000000000000000000
0000000000000000000----------------0000000000000000000000000000000000000000000000000000000000
0000000000000000000-------X---X----0000000000000000000000000000000000000000000000000000000000
0000000000000000000----------------0000000000000000000000000000000000000000000000000000000000
0000000000000000000----X-----------0000000000000000000000000000000000000000000000000000000000
0000000000000000000----------------0000000000000000000000000000000000000000000000000000000000
0000000000000000000----------------0000000000000000000000000000000000000000000000000000000000
0000000000000000000TTTTTTTT--------0000000000000000000000000000000000000000000000000000000000
0000000000000000000---------TTTT---0000000000000000000000000000000000000000000000000000000000
0000000000000000000----------------0000000000000000000000000000000000000000000000000000000000
0000000000000000000XXXX--------XXXX0000000000000000000000000000000000000000000000000000000000
0000000000000000000----------------0000000000000000000000000000000000000000000000000000000000
0000000000000000000----------TTTT--0000000000000000000000000000000000000000000000000000000000
0000000000000000000----------------0000000000000000000000000000000000000000000000000000000000
0000000000000000000----------------0000000000000000000000000000000000000000000000000000000000
0000000000000000000--------------X-0000000000000000000000000000000000000000000000000000000000
0000000000000000-----------------X-0000000000000000000000000000000000000000000000000000000000
0000000000000000---00000000000000000000000000000000000000000000000000000000000000000000000000
0000000000000000---00000000000000000000000000000000000000000000000000000000000000000000000000
0000000000000000---00000000000000000000000000000000000000000000000000000000000000000000000000
0000000000000000---00000000000000000000000000000000000000000000000000000000000000000000000000
0000000000000000---00000000000000000000000000000000000000000000000000000000000000000000000000
0000000000000000---00000000000000000000000000000000000000000000000000000000000000000000000000
0000000000000000---00000000000000000000000000000000000000000000000000000000000000000000000000
0000000000000000---00000000000000000000000000000000000000000000000000000000000000000000000000
----------------X--00000000000000000000000000000000000000000000000000000000000000000000000000
------XXXX------X--00000000000000000000000000000000000000000000000000000000000000000000000000
----------------X--00000000000000000000000000000000000000000000000000000000000000000000000000
---------XXXX---X--00000000000000000000000000000000000000000000000000000000000000000000000000
----------------X--00000000000000000000000000000000000000000000000000000000000000000000000000
XXXX--------XXXXX--00000000000000000000000000000000000000000000000000000000000000000000000000
-----E----------X--00000000000000000000000000000000000000000000000000000000000000000000000000
----TTT---------00000000000000000000000000000000000000000000000000000000000000000000000000000
----------------00000000000000000000000000000000000000000000000000000000000000000000000000000
----------------00000000000000000000000000000000000000000000000000000000000000000000000000000
X----------XXXX-00000000000000000000000000000000000000000000000000000000000000000000000000000
X-----------XXXX00000000000000000000000000000000000000000000000000000000000000000000000000000
X------------XXX00000000000000000000000000000000000000000000000000000000000000000000000000000
X-------------XX00000000000000000000000000000000000000000000000000000000000000000000000000000
X-----XXXX----XX00000000000000000000000000000000000000000000000000000000000000000000000000000
X-------------XX00000000000000000000000000000000000000000000000000000000000000000000000000000
X-------------XX00000000000000000000000000000000000000000000000000000000000000000000000000000
X-------------XX00000000000000000000000000000000000000000000000000000000000000000000000000000
X-------------DX00000000000000000000000000000000000000000000000000000000000000000000000000000
X-------------DX00000000000000000000000000000000000000000000000000000000000000000000000000000
X-----------XXXX00000000000000000000000000000000000000000000000000000000000000000000000000000
X-----XXXXXXXXXX00000000000000000000000000000000000000000000000000000000000000000000000000000
--------TTTTTTTT00000000000000000000000000000000000000000000000000000000000000000000000000000
----TTTTTTTT----00000000000000000000000000000000000000000000000000000000000000000000000000000
TTTT------------00000000000000000000000000000000000000000000000000000000000000000000000000000
----------------00000000000000000000000000000000000000000000000000000000000000000000000000000
----------------00000000000000000000000000000000000000000000000000000000000000000000000000000
-------TT-------00000000000000000000000000000000000000000000000000000000000000000000000000000
----------------00000000000000000000000000000000000000000000000000000000000000000000000000000
----------------00000000000000000000000000000000000000000000000000000000000000000000000000000
X----------TTTT-00000000000000000000000000000000000000000000000000000000000000000000000000000
X---------------00000000000000000000000000000000000000000000000000000000000000000000000000000
X---------------00000000000000000000000000000000000000000000000000000000000000000000000000000
X---------------00000000000000000000000000000000000000000000000000000000000000000000000000000
X-----TTTT------00000000000000000000000000000000000000000000000000000000000000000000000000000
X---------------00000000000000000000000000000000000000000000000000000000000000000000000000000
TTTT------TTTTTT00000000000000000000000000000000000000000000000000000000000000000000000000000
X---------------00000000000000000000000000000000000000000000000000000000000000000000000000000
X---------------00000000000000000000000000000000000000000000000000000000000000000000000000000
X-----TT-TTTT---00000000000000000000000000000000000000000000000000000000000000000000000000000
X---------------00000000000000000000000000000000000000000000000000000000000000000000000000000
X---------------00000000000000000000000000000000000000000000000000000000000000000000000000000
X---------TTTT--00000000000000000000000000000000000000000000000000000000000000000000000000000
X---------------00000000000000000000000000000000000000000000000000000000000000000000000000000
X--------------X00000000000000000000000000000000000000000000000000000000000000000000000000000
XXXX--------XXXX00000000000000000000000000000000000000000000000000000000000000000000000000000
XXXX------XXXXXX00000000000000000000000000000000000000000000000000000000000000000000000000000
XXXX-----TTTTTTT00000000000000000000000000000000000000000000000000000000000000000000000000000
XXXX--------XXXX00000000000000000000000000000000000000000000000000000000000000000000000000000
XXXX--------XXXX00000000000000000000000000000000000000000000000000000000000000000000000000000
XX------------XX00000000000000000000000000000000000000000000000000000000000000000000000000000
XX-----XXXX---DX00000000000000000000000000000000000000000000000000000000000000000000000000000
XX------------DX00000000000000000000000000000000000000000000000000000000000000000000000000000
XXXX--------XXXX00000000000000000000000000000000000000000000000000000000000000000000000000000
XXXXXX------XXXX00000000000000000000000000000000000000000000000000000000000000000000000000000
XXXX--------XXXX00000000000000000000000000000000000000000000000000000000000000000000000000000
XXXX--------XXXX00000000000000000000000000000000000000000000000000000000000000000000000000000
XX----TTTTTTTTXX00000000000000000000000000000000000000000000000000000000000000000000000000000
XX------------XX00000000000000000000000000000000000000000000000000000000000000000000000000000
XX------------XX00000000000000000000000000000000000000000000000000000000000000000000000000000
XXXX----------XX00000000000000000000000000000000000000000000000000000000000000000000000000000
XXXX-----------X00000000000000000000000000000000000000000000000000000000000000000000000000000
XXXX-----------X00000000000000000000000000000000000000000000000000000000000000000000000000000
XXXXXXXXXXXX---X00000000000000000000000000000000000000000000000000000000000000000000000000000
XXXXXXXXXXX----X00000000000000000000000000000000000000000000000000000000000000000000000000000
XXXX----------XX00000000000000000000000000000000000000000000000000000000000000000000000000000
XD-------------X00000000000000000000000000000000000000000000000000000000000000000000000000000
XD-------------X00000000000000000000000000000000000000000000000000000000000000000000000000000
XXXXX---XXXXXXXX00000000000000000000000000000000000000000000000000000000000000000000000000000
XXXXXXXXXXXXXXXX00000000000000000000000000000000000000000000000000000000000000000000000000000