0000000000000000000000000000000000000000000000000000000000000---------------------------------------------------------------------------------------------------------------------------------------------000000000000000
0000000000000000000000000000000000000000000000000000000000000---------------------------------------------------------------------------------------------------------------------------------------------000000000000000
0000000000000000000000000000000000000000000000000000000000000---------------------------------------------------------------------------------------------------------------------------------------------000000000000000
0000000000000000000000000000000000000000000000000000000000000---------------------------------------------------------------------------------------------------------------------------------------------000000000000000
0000000000000000-----------------------------0000000000000000------------E--------------------------------------------------------------------------------------------------------------------------------000000000000000
0000000000000000-----------------------------0000000000000000---------------------------------------------------------------------------------------------------------------------------------------------000000000000000
0000000000000000---------------------------------------------X--------------------------------------------------------------------------------------------------------------------------------------------000000000000000
0000000000000000--------------------------------------XXXX---X----------------------------------------------------------------------------------SSSSSSS---------------------------------------------------000000000000000
0000000000000000---------------------------------------------X--------------------------------------------------------------------------------------------------------------------------------------------000000000000000
0000000000000000-----------------------------XXXX--------XXXXX--------------------------------------------------------------------------------------------------------------------------------------------000000000000000
0000000000000000---------------------------------------------X--------------------------------------------------------------------------------------------------------------------------------------------000000000000000
0000000000000000---------------------------------------------X-------------------------------------------------------------------------------X------------------------------------------------------------000000000000000
----XXXXX----------------------------------------TTTTT-------X--------------------------------E-----------------------------------------------------------------------------------------------------------000000000000000
-------------------------------------------------------------X--------------------------------------------------------------------------------------------------------------------------------------------000000000000000
----------------------X--o-----------------------------------X--X---X---------------------------------------EEE---------------E--------------------------E-E-E--------------------------------------------000000000000000
----------------X----XX----E----------------X-----X----------XXXXXXXXXXXXXXXXXXXXXXXXXXXXXXXXXXXXXXXXXXXXXXXXXXXXXXXXXXXXXXXXXXXXXXXXXXXXXXXX-X-XXXXXXXXXXXXXXXXXXXXXXXXXXXXXXXXXXXXXXXXXXXXXXXXXXXXXXXXXX000000000000000
XXXXXXX---------X---XXX---<>-----------------0000000000000000000000000000000000000000000000000000000000000000000000000000000000000000000000000000000000000000000000000000000000000000000000000000000000000000000000000000
----------------X--XXXX---[]-----------------0000000000000000000000000000000000000000000000000000000000000000000000000000000000000000000000000000000000000000000000000000000000000000000000000000000000000000000000000000
-------TTTT-----XXXXXXX---[]-----------------0000000000000000000000000000000000000000000000000000000000000000000000000000000000000000000000000000000000000000000000000000000000000000000000000000000000000000000000000000
----------------XXXXXXXXXXXXXXXXXXXXXXXXXXX--0000000000000000000000000000000000000000000000000000000000000000000000000000000000000000000000000000000000000000000000000000000000000000000000000000000000000000000000000000
---------TTT----000000000000000000000000000000000000000000000000000000000000000000000000000000000000000000000000000000000000000000000000000000000000000000000000000000000000000000000000000000000000000000000000000000000
----------------000000000000000000000000000000000000000000000000000000000000000000000000000000000000000000000000000000000000000000000000000000000000000000000000000000000000000000000000000000000000000000000000000000000
X-----------TTTT000000000000000000000000000000000000000000000000000000000000000000000000000000000000000000000000000000000000000000000000000000000000000000000000000000000000000000000000000000000000000000000000000000000
X--------------X000000000000000000000000000000000000000000000000000000000000000000000000000000000000000000000000000000000000000000000000000000000000000000000000000000000000000000000000000000000000000000000000000000000
X--------------X000000000000000000000000000000000000000000000000000000000000000000000000000000000000000000000000000000000000000000000000000000000000000000000000000000000000000000000000000000000000000000000000000000000
XXXXXXXXXXXX---X000000000000000000000000000000000000000000000000000000000000000000000000000000000000000000000000000000000000000000000000000000000000000000000000000000000000000000000000000000000000000000000000000000000
XX-------------X000000000000000000000000000000000000000000000000000000000000000000000000000000000000000000000000000000000000000000000000000000000000000000000000000000000000000000000000000000000000000000000000000000000
XX-------TTTT-TT000000000000000000000000000000000000000000000000000000000000000000000000000000000000000000000000000000000000000000000000000000000000000000000000000000000000000000000000000000000000000000000000000000000
XD-------------X000000000000000000000000000000000000000000000000000000000000000000000000000000000000000000000000000000000000000000000000000000000000000000000000000000000000000000000000000000000000000000000000000000000
XD-------------X000000000000000000000000000000000000000000000000000000000000000000000000000000000000000000000000000000000000000000000000000000000000000000000000000000000000000000000000000000000000000000000000000000000
XXXXX---XXXXXXXX000000000000000000000000000000000000000000000000000000000000000000000000000000000000000000000000000000000000000000000000000000000000000000000000000000000000000000000000000000000000000000000000000000000
XXXXXXXXXXXXXXXX000000000000000000000000000000000000000000000000000000000000000000000000000000000000000000000000000000000000000000000000000000000000000000000000000000000000000000000000000000000000000000000000000000000