00000000000000000000000000000000000000000000000000000000000000000000000000000000000000000000--------------------000000000000000
00000000000000000000000000000000000000000000000000000000000000000000000000000000000000000000--------------------000000000000000
00000000000000000000000000000000000000000000000000000000000000000000000000000000000000000000--------------------000000000000000
00000000000000000000000000000000000000000000000000000000000000000000000000000000000000000000--------------------000000000000000
00000000000000000000000000000000000000000000000000000000000000000000000000000000000000000000--------------------000000000000000
00000000000000000000000000000000000000000000000000000000000000000000000000000000000000000000--------------------000000000000000
00000000000000000000000000000000000000000000000000000000000000000000000000000000000000000000--------------------000000000000000
00000000000000000000000000000000000000000000000000000000000000000000000000000000000000000000--------------------000000000000000
00000000000000000000000000000000000000000000000000000000000000000000000000000000000000000000--------------------000000000000000
00000000000000000000000000000000000000000000000000000000000000000000000000000000000000000000--------------------000000000000000
00000000000000000000000000000000000000000000000000000000000000000000000000000000000000000000--------------------000000000000000
00000000000000000000000000000000000000000000000000000000000000000000000000000000000000000000--------------------000000000000000
00000000000000000000000000000000000000000000000000000000000000000000000000000000000000000000----E---------------000000000000000
00000000000000000000000000000000000000000000000000000000000000000000000000000000000000000000---<>---------------000000000000000
0000000000000000000000000000000000000000000000000000000000000000000000000000-------------------[]--X------------000000000000000
0000000000000000000000000000000000000000000000000000000000000000000000000000----------------XXXXXXXXXXXXXXXXXXXX000000000000000
0000000000000000000000000000000000000000000000000000000000000000000000000000------TTTT------00000000000000000000000000000000000
0000000000000000000000000000000000000000000000000000000000000000000000000000----------------00000000000000000000000000000000000
0000000000000000000000000000000000000000000000000000000000000000000000000000---------TTTT---00000000000000000000000000000000000
0000000000000000000000000000000000000000000000000000000000000000000000000000----------------00000000000000000000000000000000000
0000000000000000000000000000000000000000000000000000000000000000000000000000----------------00000000000000000000000000000000000
0000000000000000000000000000000000000000000000000000000000000000000000000000------TTTT------00000000000000000000000000000000000
0000000000000000000000000000000000000000000000000000000000000000000000000000----------------00000000000000000000000000000000000
0000000000000000000000000000000000000000000000000000000000000000000000000000---------XXXX---00000000000000000000000000000000000
0000000000000000000000000000000000000000000000000000000000000000000000000000----------XX----00000000000000000000000000000000000
0000000000000000000000000000000000000000000000000000000000000000000000000000----------XX----00000000000000000000000000000000000
0000000000000000000000000000000000000000000000000000000000000000000000000000XX----------XXXX00000000000000000000000000000000000
0000000000000000000000000000000000000000000000000000000000000000000000000000XX-----------XXX00000000000000000000000000000000000
0000000000000000000000000000000000000000000000000000000000000000000000000000XX-----------XXX00000000000000000000000000000000000
0000000000000000000000000000000000000000000000000000000000000000000000000000XX-----------XXX00000000000000000000000000000000000
0000000000000000000000000000000000000000000000000000000000000000000000000000XD-----------XXX00000000000000000000000000000000000
0000000000000000000000000000000000000000000000000000000000000000000000000000XD-----------XXX00000000000000000000000000000000000
0000000000000000000000000000000000000000000000000000000000000000000000000000XXXXXXXXXXXXXXXX00000000000000000000000000000000000
0000000000000000000000000000000000000000000000000000000000000000000000000000XXXXXXXXXXXXXXXX00000000000000000000000000000000000
0000000000000000000000000000000000000000000000000000000000000000000000000000---E--------E---00000000000000000000000000000000000
0000000000000000000000000000000000000000000000000000000000000000000000000000MMMMMMMMMMMMMMMM00000000000000000000000000000000000
0000000000000000000000000000000000000000000000000000000000000000000000000000----------------00000000000000000000000000000000000
0000000000000000000000000000000000000000000000000000000000000000000000000000----------------00000000000000000000000000000000000
0000000000000000000000000000000000000000000000000000000000000000000000000000---------TT-----00000000000000000000000000000000000
0000000000000000000000000000000000000000000000000000000000000000000000000000----------------00000000000000000000000000000000000
0000000000000000000000000000000000000000000000000000000000000000000000000000----------------00000000000000000000000000000000000
0000000000000000000000000000000000000000000000000000000000000000000000000000XX----------XXXX00000000000000000000000000000000000
0000000000000000000000000000000000000000000000000000000000000000000000000000XX--------------00000000000000000000000000000000000
0000000000000000000000000000000000000000000000000000000000000000000000000000XX----------XXXX00000000000000000000000000000000000
0000000000000000000000000000000000000000000000000000000000000000000000000000XX----------XXXX00000000000000000000000000000000000
0000000000000000000000000000000000000000000000000000000000000000000000000000XXXXXXXX----XXXX00000000000000000000000000000000000
0000000000000000000000000000000000000000000000000000000000000000000000000000XX------XXXXXXXX00000000000000000000000000000000000
0000000000000000000000000000000000000000000000000000000000000000000000000000XX----------XXXX00000000000000000000000000000000000
0000000000000000000000000000000000000000000000000000000000000000000000000000XX-----------XXX00000000000000000000000000000000000
0000000000000000000000000000000000000000000000000000000000000000000000000000XX-----------XXX00000000000000000000000000000000000
0000000000000000000000000000000000000000000000000000000000000000000000000000XD-----------XXX00000000000000000000000000000000000
0000000000000000000000000000000000000000000000000000000000000000000000000000XD-----------XXX00000000000000000000000000000000000
0000000000000000000000000000000000000000000000000000000000000000000000000000XXXXXXXXXXXXXXXX00000000000000000000000000000000000
0000000000000000000000000000000000000000000000000000000000000000000000000000XXXXXXXXXXXXXXXX00000000000000000000000000000000000
0000000000000000000000000000000000000000000000000000000000000000000000000000---------XXXXXXX00000000000000000000000000000000000
0000000000000000000000000000000000000000000000000000000000000000000000000000----------------00000000000000000000000000000000000
0000000000000000000000000000000000000000000000000000000000000000000000000000------XXXX------00000000000000000000000000000000000
0000000000000000000000000000000000000000000000000000000000000000000000000000----------------00000000000000000000000000000000000
0000000000000000000000000000000000000000000000000000000000000000000000000000---XXXX---------00000000000000000000000000000000000
0000000000000000000000000000000000000000000000000000000000000000000000000000----------------00000000000000000000000000000000000
0000000000000000000000000000000000000000000000000000000000000000000000000000----------------00000000000000000000000000000000000
0000000000000000000000000000000000000000000000000000000000000000000000000000TTTTTTTT--------00000000000000000000000000000000000
0000000000000000000000000000000000000000000000000000000000000000000000000000---------TTTT---00000000000000000000000000000000000
0000000000000000000000000000000000000000000000000000000000000000000000000000----------------00000000000000000000000000000000000
0000000000000000000000000000000000000000000000000000000000000000000000000000XXXX--------XXXX00000000000000000000000000000000000
0000000000000000000000000000000000000000000000000000000000000000000000000000XX--------------00000000000000000000000000000000000
0000000000000000000000000000000000000000000000000000000000000000000000000000XX--------------00000000000000000000000000000000000
0000000000000000000000000000000000000000000000000000000000000000000000000000XXXX--------XXXX00000000000000000000000000000000000
0000000000000000000000000000000000000000000000000000000000000000000000000000XX----------XXXX00000000000000000000000000000000000
0000000000000000000000000000000000000000000000000000000000000000000000000000XX------XXXXXXXX00000000000000000000000000000000000
0000000000000000000000000000000000000000000000000000000000000000000000000000XD-----------XXX00000000000000000000000000000000000
0000000000000000000000000000000000000000000000000000000000000000000000000000XD-----------XXX00000000000000000000000000000000000
0000000000000000000000000000000000000000000000000000000000000000000000000000XXXXXXXXXXXXXXXX00000000000000000000000000000000000
0000000000000000000000000000000000000000000000000000000000000000000000000000XXXXXXXXXXXXXXXX00000000000000000000000000000000000
0000000000000000000000000000000000000000000000000000000000000000000000000000----------------00000000000000000000000000000000000
0000000000000000000000000000000000000000000000000000000000000000000000000000------TTTT------00000000000000000000000000000000000
0000000000000000000000000000000000000000000000000000000000000000000000000000----XXXX-TTT----00000000000000000000000000000000000
0000000000000000000000000000000000000000000000000000000000000000000000000000----XXXX--XXXX--00000000000000000000000000000000000
0000000000000000000000000000000000000000000000000000000000000000000000000000----XXXX--XXXX--00000000000000000000000000000000000
0000000000000000000000000000000000000000000000000000000000000000000000000000----XTTTT-XXXX--00000000000000000000000000000000000
00000000000000000000000000000000000000000000000000000000------------------------------XXXX--00000000000000000000000000000000000
00000000000000000000000000000000000000000000000000000000------------------------------XXXX--00000000000000000000000000000000000
00000000000000000000000000000000000000000000000000000000-----------------------------TTTXX--00000000000000000000000000000000000
00000000000000000000000000000000000000000000000000000000------------------------------------00000000000000000000000000000000000
00000000000000000000000000000000000000000000000000000000--------------------MMMMMMMMMMMMMMMM00000000000000000000000000000000000
00000000000000000000000000000000000000000000000000000000------------------------------------00000000000000000000000000000000000
00000000000000000000000000000000000000000000000000000000------------------------------------00000000000000000000000000000000000
00000000000000000000000000000000000000000000000000000000--------------------XX----------XXXX00000000000000000000000000000000000
00000000000000000000000000000000000000000000000000000000--------------------XX-----------XXX00000000000000000000000000000000000
00000000000000000000000000000000000000000000000000000000--------------------XX-----------XXX00000000000000000000000000000000000
00000000000000000000000000000000000000000000000000000000--------------------XD-----------XXX00000000000000000000000000000000000
00000000000000000000000000000000000000000000000000000000--------------------XD-----------XXX00000000000000000000000000000000000
00000000000000000000000000000000000000000000000000000000--------------------XXXXXXXXXXXXXXXX00000000000000000000000000000000000
00000000000000000000000000000000000000000000000000000000----------------X--XXXXXXXXXXXXXXXXX00000000000000000000000000000000000
0000000000000000000000000000000000000000-------------------EEE------------XX000000000000000000000000000000000000000000000000000
0000000000000000000000000000000000000000----------------XXXXXXXXXXXXXXXXXXXX000000000000000000000000000000000000000000000000000
0000000000000000000000000000000000000000TTTTTTTT--------00000000000000000000000000000000000000000000000000000000000000000000000
0000000000000000000000000000000000000000---------TTTT---00000000000000000000000000000000000000000000000000000000000000000000000
0000000000000000000000000000000000000000----------------00000000000000000000000000000000000000000000000000000000000000000000000
0000000000000000000000000000000000000000XXXX--------XXXX00000000000000000000000000000000000000000000000000000000000000000000000
0000000000000000000000000000000000000000-----E----------00000000000000000000000000000000000000000000000000000000000000000000000
0000000000000000000000000000000000000000----TTT---------00000000000000000000000000000000000000000000000000000000000000000000000
0000000000000000000000000000000000000000----------------00000000000000000000000000000000000000000000000000000000000000000000000
0000000000000000000000000000000000000000------XXXX------00000000000000000000000000000000000000000000000000000000000000000000000
0000000000000000000000000000000000000000----------------00000000000000000000000000000000000000000000000000000000000000000000000
0000000000000000000000000000000000000000---------XXXX---00000000000000000000000000000000000000000000000000000000000000000000000
0000000000000000000000000000000000000000----------------00000000000000000000000000000000000000000000000000000000000000000000000
0000000000000000000000000000000000000000XX----------XXXX00000000000000000000000000000000000000000000000000000000000000000000000
0000000000000000000000000000000000000000XX-----------XXX00000000000000000000000000000000000000000000000000000000000000000000000
0000000000000000000000000000000000000000XX-----------XXX00000000000000000000000000000000000000000000000000000000000000000000000
0000000000000000000000000000000000000000XD-----------XXX00000000000000000000000000000000000000000000000000000000000000000000000
0000000000000000000000000000000000000000XD-----------XXX00000000000000000000000000000000000000000000000000000000000000000000000
0000000000000000000000000000000000000000XXXXXXXXXXXXXXXX00000000000000000000000000000000000000000000000000000000000000000000000
0000000000000000000000000000000000000000XXXXXXXXXXXXXXXX00000000000000000000000000000000000000000000000000000000000000000000000
0000000000000000000000000000000000000000X-------------XX00000000000000000000000000000000000000000000000000000000000000000000000
0000000000000000000000000000000000000000X-------------XX00000000000000000000000000000000000000000000000000000000000000000000000
0000000000000000000000000000000000000000X-------------XX00000000000000000000000000000000000000000000000000000000000000000000000
0000000000000000000000000000000000000000X-------------XX00000000000000000000000000000000000000000000000000000000000000000000000
0000000000000000000000000000000000000000X-------------XX00000000000000000000000000000000000000000000000000000000000000000000000
0000000000000000000000000000000000000000X-------------XX00000000000000000000000000000000000000000000000000000000000000000000000
0000000000000000000000000000000000000000X-------------XX00000000000000000000000000000000000000000000000000000000000000000000000
0000000000000000000000000000000000000000X------X------XX00000000000000000000000000000000000000000000000000000000000000000000000
----------------------------------------XXXX--XXXXXXXXXX00000000000000000000000000000000000000000000000000000000000000000000000
----------------------------------------XXXX--------XXXX00000000000000000000000000000000000000000000000000000000000000000000000
----------------------------------------XXXX-----TTTT---00000000000000000000000000000000000000000000000000000000000000000000000
----------------------------------------XXXX--------XXXX00000000000000000000000000000000000000000000000000000000000000000000000
----------------------------------------XX-----------XXX00000000000000000000000000000000000000000000000000000000000000000000000
----------------------------------------XX-----XXXX--XXX00000000000000000000000000000000000000000000000000000000000000000000000
----------------------------------------XX-----------XXX00000000000000000000000000000000000000000000000000000000000000000000000
------------------------SSS-------------XX-----------XXX00000000000000000000000000000000000000000000000000000000000000000000000
----------------------------------------XD-----------XXX00000000000000000000000000000000000000000000000000000000000000000000000
----------------------------------------XD-----------XXX00000000000000000000000000000000000000000000000000000000000000000000000
----------------------------------------XXXXXXXXXXXXXXXX00000000000000000000000000000000000000000000000000000000000000000000000
---------------------------------------XXXXXXXXXXXXXXXXX00000000000000000000000000000000000000000000000000000000000000000000000
---------------E----------------------XX000000000000000000000000000000000000000000000000000000000000000000000000000000000000000
--------------<>---------------------XXX000000000000000000000000000000000000000000000000000000000000000000000000000000000000000
-----EEE------[]-----------EE-------XXXX000000000000000000000000000000000000000000000000000000000000000000000000000000000000000
XXXXXXXXXXXXXXXXXXXXXXXXXXXXXXXXXXXXXXXX000000000000000000000000000000000000000000000000000000000000000000000000000000000000000
0000000000000000000000000000000000000000000000000000000000000000000000000000000000000000000000000000000000000000000000000000000