000000000000000000000000000000000000000000000000000000000000000000000000000000000000000000000000000000000000000000000000000000000000000000000000--------------------000000000000000
000000000000000000000000000000000000000000000000000000000000000000000000000000000000000000000000000000000000000000000000000000000000000000000000--------------------000000000000000
000000000000000000000000000000000000000000000000000000000000000000000000000000000000000000000000000000000000000000000000000000000000000000000000--------------------000000000000000
000000000000000000000000000000000000000000000000000000000000000000000000000000000000000000000000000000000000000000000000000000000000000000000000--------------------000000000000000
00000000000000000000000000000000000000000000000000000000000000000000000000000000000000000000000000000000000000000000000000000000----------------S-------------------000000000000000
00000000000000000000000000000000000000000000000000000000000000000000000000000000000000000000000000000000000000000000000000000000---E---E--------S-------------------000000000000000
00000000000000000000000000000000000000000000000000000000000000000000000000000000000000000000000000000000000000000000000000000000MMMMMMMMMMMMMMMMS-------------------000000000000000
00000000000000000000000000000000000000000000000000000000000000000000000000000000000000000000000000000000000000000000000000000000----------------S---SS-------<E-----000000000000000
00000000000000000000000000000000000000000000000000000000000000000000000000000000000000000000000000000000000000000000000000000000----------------S------------[>-----000000000000000
00000000000000000000000000000000000000000000000000000000000000000000000000000000000000000000000000000000000000000000000000000000X-----------XXXXS------------[]-----000000000000000
00000000000000000000000000000000000000000000000000000000000000000000000000000000000000000000000000000000000000000000000000000000X---XXXXXXXXXXXXS------------X]-----000000000000000
00000000000000000000000000000000000000000000000000000000000000000000000000000000000000000000000000000000000000000000000000000000X-------------XXS------------X------000000000000000
00000000000000000000000000000000000000000000000000000000000000000000000000000000000000000000000000000000000000000000000000000000X-------------XXS-------------------000000000000000
00000000000000000000000000000000000000000000000000000000000000000000000000000000000000000000000000000000000000000000000000000000X-------------XXS--X----------------000000000000000
00000000000000000000000000000000000000000000000000000000000000000000000000000000000000000000000000000000000000000000000000000000X-------------XXS--X-------------E--000000000000000
00000000000000000000000000000000000000000000000000000000000000000000000000000000000000000000000000000000000000000000000000000000X------XXXX---XXXXEXXXXXXXXXXXXXXXXX000000000000000
000000000000000000000000000000000000000000000000000000000000000000000000000000000000000000000000000000000000--------------------X-------------XX00000000000000000000000000000000000
000000000000000000000000000000000000000000000000000000000000000000000000000000000000000000000000000000000000--------------------XXXX----------XX00000000000000000000000000000000000
00000000000000000000000000000000000000000000000000000000000000000000000000000000000000000000MMMMMMMMMMMMMMMM--------------------XXXXXXXX------XX00000000000000000000000000000000000
00000000000000000000000000000000000000000000000000000000000000000000000000000000000000000000------------------------------------XXXXXXXXXXXX--XX00000000000000000000000000000000000
00000000000000000000000000000000000000000000000000000000000000000000000000000000000000000000----------------S-------------------XD-----------TXX00000000000000000000000000000000000
00000000000000000000000000000000000000000000000000000000000000000000000000000000000000000000XX----------XXXXS-------------------XD------------XX00000000000000000000000000000000000
00000000000000000000000000000000000000000000000000000000000000000000000000000000000000000000XX----------XXXXS-------------------XXXXX-------XXXX00000000000000000000000000000000000
00000000000000000000000000000000000000000000000000000000000000000000000000000000000000000000XXXXXXX-----XXXXS--------------SSSSSXXXXXXXXXXXXXXXX00000000000000000000000000000000000
00000000000000000000000000000000000000000000000000000000000000000000000000000000000000000000XX----------XXXXS-------------------000000000000000000000000000000000000000000000000000
00000000000000000000000000000000000000000000000000000000000000000000000000000000000000000000XX----------XXXXS-------------------000000000000000000000000000000000000000000000000000
00000000000000000000000000000000000000000000000000000000000000000000000000000000000000000000XXTTTT------XXXXS-------------------000000000000000000000000000000000000000000000000000
00000000000000000000000000000000000000000000000000000000000000000000000000000000000000000000XXXX--------XXXXS-----------------S-000000000000000000000000000000000000000000000000000
00000000000000000000000000000000000000000000000000000000000000000000000000000000000000000000XXXX--------XXXXS-------------------000000000000000000000000000000000000000000000000000
00000000000000000000000000000000000000000000000000000000000000000000000000000000000000000000XXTTTT------XXXXS-------------------000000000000000000000000000000000000000000000000000
00000000000000000000000000000000000000000000000000000000000000000000000000000000000000000000XXXX------T-XXXXS------------------E000000000000000000000000000000000000000000000000000
00000000000000000000000000000000000000000000000000000000000000000000000000000000000000000000XX----------XXXXXXXXXXXXXXXXXXXXXXXX000000000000000000000000000000000000000000000000000
00000000000000000000000000000000000000000000000000000000000000000000000000000000000000000000XX----------XXXX00000000000000000000000000000000000000000000000000000000000000000000000
00000000000000000000000000000000000000000000000000000000000000000000000000000000000000000000XX----XXXXXXXXXX00000000000000000000000000000000000000000000000000000000000000000000000
00000000000000000000000000000000000000000000000000000000000000000000000000000000000000000000XD------------XX00000000000000000000000000000000000000000000000000000000000000000000000
00000000000000000000000000000000000000000000000000000000000000000000000000000000000000000000XD------------XX00000000000000000000000000000000000000000000000000000000000000000000000
00000000000000000000000000000000000000000000000000000000000000000000000000000000000000000000XXXXX-------XXXX00000000000000000000000000000000000000000000000000000000000000000000000
00000000000000000000000000000000000000000000000000000000000000000000000000000000000000000000XXXXXXXXXXXXXXXX00000000000000000000000000000000000000000000000000000000000000000000000
00000000000000000000000000000000000000000000000000000000000000000000000000000000000000000000XT-X-----------X00000000000000000000000000000000000000000000000000000000000000000000000
00000000000000000000000000000000000000000000000000000000000000000000000000000000000000000000X--XXXXX-------X00000000000000000000000000000000000000000000000000000000000000000000000
00000000000000000000000000000000000000000000000000000000000000000000000000000000000000000000X--X-----------X00000000000000000000000000000000000000000000000000000000000000000000000
00000000000000000000000000000000000000000000000000000000000000000000000000000000000000000000X--X----XXXX---X00000000000000000000000000000000000000000000000000000000000000000000000
00000000000000000000000000000000000000000000000000000000000000000000000000000000000000000000X--X-------D---X00000000000000000000000000000000000000000000000000000000000000000000000
00000000000000000000000000000000000000000000000000000000000000000000000000000000000000000000X--X-----------X00000000000000000000000000000000000000000000000000000000000000000000000
00000000000000000000000000000000000000000000000000000000000000000000000000000000000000000000X--XXXXX---XX--X00000000000000000000000000000000000000000000000000000000000000000000000
00000000000000000000000000000000000000000000000000000000000000000000000000000000000000000000X--X-----------X00000000000000000000000000000000000000000000000000000000000000000000000
00000000000000000000000000000000000000000000000000000000000000000000000000000000000000000000X--X----XXXXXXXX00000000000000000000000000000000000000000000000000000000000000000000000
000000000000000000000000000000000000000000000000000000000000000000000000--------------------X-TX-----------X00000000000000000000000000000000000000000000000000000000000000000000000
000000000000000000000000000000000000000000000000000000000000000000000000--------------------X--X-----------X00000000000000000000000000000000000000000000000000000000000000000000000
000000000000000000000000000000000000000000000000000000000000000000000000--------------------X--X-----------X00000000000000000000000000000000000000000000000000000000000000000000000
000000000000000000000000000000000000000000000000000000000000000000000000--------------------X---TT---------X00000000000000000000000000000000000000000000000000000000000000000000000
00000000000000000000000000000000000000000000000000000000XXXX---------XXXS-------------------X--------------X00000000000000000000000000000000000000000000000000000000000000000000000
00000000000000000000000000000000000000000000000000000000XXXX-----XXXXXXXS-------------------XX-------------X00000000000000000000000000000000000000000000000000000000000000000000000
00000000000000000000000000000000000000000000000000000000XXXX---------XXXS-------------------XX-XXXX----XXXXX00000000000000000000000000000000000000000000000000000000000000000000000
00000000000000000000000000000000000000000000000000000000XXXX---------XXXS-------------------XD-------------X00000000000000000000000000000000000000000000000000000000000000000000000
0000000000000000-----------------------------------------XXXX------XXXX-S-------------------XD------------DX00000000000000000000000000000000000000000000000000000000000000000000000
0000000000000000----------------------------------------XXXXXXXEEEXXXXX-S-------------------XXXXX-------XXXX00000000000000000000000000000000000000000000000000000000000000000000000
0000000000000000----------------------------------------XXXX------XXXX--S---------------ooooXXXXXXXXXXXXXXXX00000000000000000000000000000000000000000000000000000000000000000000000
0000000000000000----------------------------------------XXXX------XXXX--S-----S----E--oo----000000000000000000000000000000000000000000000000000000000000000000000000000000000000000
----XXXX--XXXX--S-------------------S-------------------XXXX------XXXX--S---------<>--------000000000000000000000000000000000000000000000000000000000000000000000000000000000000000
----XTTTT-XXXX--S-------------------S-------------------XXXX-----XXXX---S---------[]--------000000000000000000000000000000000000000000000000000000000000000000000000000000000000000
----------XXXX--S-------------------S-------------------XXXX--------XXXXS---------[]--------000000000000000000000000000000000000000000000000000000000000000000000000000000000000000
----------XXXX--S-------------------S-------------------XXXX-------XXXXXXXXXXXXXXXXXXXXXXXXX000000000000000000000000000000000000000000000000000000000000000000000000000000000000000
---------TTTXX--S-------------------S-------------------XXXX-----XXXXXXX00000000000000000000000000000000000000000000000000000000000000000000000000000000000000000000000000000000000
-------E--------S-------------------S-------------------XXXX--------XXXX00000000000000000000000000000000000000000000000000000000000000000000000000000000000000000000000000000000000
MMMMMMMMMMMMMMMMS--------------<E--<S--------E----------XX------------XX00000000000000000000000000000000000000000000000000000000000000000000000000000000000000000000000000000000000
----------------S----o---E-----[>--[S-------->----------XX----XXXXX---XX00000000000000000000000000000000000000000000000000000000000000000000000000000000000000000000000000000000000
----------------S-------<>-----[]--[S-----E-<]----------XD------------XX00000000000000000000000000000000000000000000000000000000000000000000000000000000000000000000000000000000000
TTTTTTTT-------XS-E-----[]-----[]--[S----<>-[]----------XD------------XX00000000000000000000000000000000000000000000000000000000000000000000000000000000000000000000000000000000000
---------TTTT---S-------[]----E[]--[S----[]-[]--------E-XXXXX-------XXXX00000000000000000000000000000000000000000000000000000000000000000000000000000000000000000000000000000000000
----------------XXXXXXXXXXXXXXXXXXXXXXXXXXXXXXXXXXXXXXXXXXXXXXXXXXXXXXXX00000000000000000000000000000000000000000000000000000000000000000000000000000000000000000000000000000000000
XXXXX-------XXXX0000000000000000000000000000000000000000000000000000000000000000000000000000000000000000000000000000000000000000000000000000000000000000000000000000000000000000000
XX--------------0000000000000000000000000000000000000000000000000000000000000000000000000000000000000000000000000000000000000000000000000000000000000000000000000000000000000000000
XX--------------0000000000000000000000000000000000000000000000000000000000000000000000000000000000000000000000000000000000000000000000000000000000000000000000000000000000000000000
XX--------TTT---0000000000000000000000000000000000000000000000000000000000000000000000000000000000000000000000000000000000000000000000000000000000000000000000000000000000000000000
XD--------------0000000000000000000000000000000000000000000000000000000000000000000000000000000000000000000000000000000000000000000000000000000000000000000000000000000000000000000
XD-------------X0000000000000000000000000000000000000000000000000000000000000000000000000000000000000000000000000000000000000000000000000000000000000000000000000000000000000000000
XXXXX-------XXXX0000000000000000000000000000000000000000000000000000000000000000000000000000000000000000000000000000000000000000000000000000000000000000000000000000000000000000000
XXXXXXXXXXXXXXXX0000000000000000000000000000000000000000000000000000000000000000000000000000000000000000000000000000000000000000000000000000000000000000000000000000000000000000000