0000000000000000000000000000000000000000000000000000--------------------000000000000000
0000000000000000000000000000000000000000000000000000--------------------000000000000000
0000000000000000000000000000000000000000000000000000--------------------000000000000000
0000000000000000000000000000000000000000000000000000--------------------000000000000000
0000000000000000000000000000000000000000000000000000--------------------000000000000000
0000000000000000000000000000000000000000000000000000--------------------000000000000000
0000000000000000000000000000000000000000000000000000--------------------000000000000000
0000000000000000000000000000000000000000000000000000--------------------000000000000000
0000000000000000000000000000000000000000000000000000--------------------000000000000000
0000000000000000000000000000000000000000000000000000--------------------000000000000000
0000000000000000000000000000000000000000000000000000--------------------000000000000000
0000000000000000000000000000000000000000000000000000--------------------000000000000000
0000000000000000000000000000000000000000000000000000--------------------000000000000000
000000000000000000000000000000000000-----------TTTT---------------------000000000000000
000000000000000000000000000000000000-----------------------------E------000000000000000
000000000000000000000000000000000000----------------XXXXXXXXXXXXXXXXXXX-000000000000000
000000000000000000000000000000000000XX------TTTTTTXX00000000000000000000000000000000000
000000000000000000000000000000000000XX------------XX00000000000000000000000000000000000
000000000000000000000000000000000000XX------------XX00000000000000000000000000000000000
000000000000000000000000000000000000XX-----XXXX---XX00000000000000000000000000000000000
000000000000000000000000000000000000XX------------XX00000000000000000000000000000000000
000000000000000000000000000000000000XXXX--------XXXX00000000000000000000000000000000000
000000000000000000000000000000000000XXXX--------XXXX00000000000000000000000000000000000
000000000000000000000000000000000000XXXX--------XXXX00000000000000000000000000000000000
000000000000000000000000000000000000XX----TTTTTTTTXX00000000000000000000000000000000000
000000000000000000000000000000000000XX------------XX00000000000000000000000000000000000
000000000000000000000000000000000000XX------------XX00000000000000000000000000000000000
000000000000000000000000000000000000XX--------XXXXXX00000000000000000000000000000000000
000000000000000000000000000000000000XD-------------X00000000000000000000000000000000000
000000000000000000000000000000000000XD-------------X00000000000000000000000000000000000
000000000000000000000000000000000000TTTTXXXXXXXX--DX00000000000000000000000000000000000
000000000000000000000000000000000000--TTTTTTTT----DX00000000000000000000000000000000000
000000000000000000000000000000000000---------TTTTTTT00000000000000000000000000000000000
000000000000000000000000000000000000----------------00000000000000000000000000000000000
000000000000000000000000000000000000XX------TTTTTTXX00000000000000000000000000000000000
000000000000000000000000000000000000XX------------XX00000000000000000000000000000000000
000000000000000000000000000000000000XX------------XX00000000000000000000000000000000000
000000000000000000000000000000000000XX-----XXXX---XX00000000000000000000000000000000000
000000000000000000000000000000000000XX------------XX00000000000000000000000000000000000
000000000000000000000000000000000000XXXX--------XXXX00000000000000000000000000000000000
000000000000000000000000000000000000XXXX--------XXXX00000000000000000000000000000000000
000000000000000000000000000000000000XXXX--------XXXX00000000000000000000000000000000000
000000000000000000000000000000000000XX-----------XXX00000000000000000000000000000000000
000000000000000000000000000000000000XX-------------X00000000000000000000000000000000000
000000000000000000000000000000000000XX-------TTTT--X00000000000000000000000000000000000
000000000000000000000000000000000000XX------------XX00000000000000000000000000000000000
000000000000000000000000000000000000XX------------XX00000000000000000000000000000000000
000000000000000000000000000000000000XX--------XXXXXX00000000000000000000000000000000000
000000000000000000000000000000000000XD-------------X00000000000000000000000000000000000
000000000000000000000000000000000000XD-------------X00000000000000000000000000000000000
000000000000000000000000000000000000TTTTXXXXXXXX--DX00000000000000000000000000000000000
000000000000000000000000000000000000--TTTTTTTT----DX00000000000000000000000000000000000
000000000000000000000000000000000000---------TTTTTTT00000000000000000000000000000000000
000000000000000000000000000000000000--XXXX------XXXX00000000000000000000000000000000000
000000000000000000000000000000000000XXXXE-EXXXXXXX--00000000000000000000000000000000000
000000000000000000000000000000000000XXXX----EXXXXX--00000000000000000000000000000000000
000000000000000000000000000000000000XX-----------XXX00000000000000000000000000000000000
000000000000000000000000000000000000XX--TT-------XXX00000000000000000000000000000000000
000000000000000000000000000000000000XX-----------XXX00000000000000000000000000000000000
000000000000000000000000000000000000XX-----------XXX00000000000000000000000000000000000
000000000000000000000000000000000000-XXXXXXXE--XXXX-00000000000000000000000000000000000
000000000000000000000000000000000000-XXXX------XXXX-00000000000000000000000000000000000
000000000000000000000000000000000000-XXXX------XXXX-00000000000000000000000000000000000
000000000000000000000000000000000000-XXXX----EXXXXX-00000000000000000000000000000000000
000000000000000000000000000000000000XX----------XXXX00000000000000000000000000000000000
000000000000000000000000000000000000XX----------XXXX00000000000000000000000000000000000
000000000000000000000000000000000000XXXXXXXXE---XXXX00000000000000000000000000000000000
000000000000000000000000000000000000XXXX------XXXXXX00000000000000000000000000000000000
000000000000000000000000000000000000XD------------TX00000000000000000000000000000000000
000000000000000000000000000000000000XD-------------X00000000000000000000000000000000000
000000000000000000000000000000000000TTTTXXXXXXXX--DX00000000000000000000000000000000000
000000000000000000000000000000000000--TTTTTTTT----DX00000000000000000000000000000000000
000000000000000000000000000000000000---------TTTTTTT00000000000000000000000000000000000
000000000000000000000000000000000000----------------00000000000000000000000000000000000
000000000000000000000000000000000000----X-----------00000000000000000000000000000000000
000000000000000000000000000000000000----------------00000000000000000000000000000000000
000000000000000000000000000000000000----------------00000000000000000000000000000000000
000000000000000000000000000000000000XXXX------------00000000000000000000000000000000000
000000000000000000000000000000000000XXXX------------00000000000000000000000000000000000
000000000000000000000000000000000000XXXXEEEX--------00000000000000000000000000000000000
000000000000000000000000000000000000XXXXXX-XX-------00000000000000000000000000000000000
000000000000000000000000000000000000----------------00000000000000000000000000000000000
000000000000000000000000000000000000----------------00000000000000000000000000000000000
000000000000000000000000000000000000--------TTTT----00000000000000000000000000000000000
000000000000000000000000000000000000----------------00000000000000000000000000000000000
000000000000000000000000000000000000XXXX--------TTTT00000000000000000000000000000000000
000000000000000000000000000000000000XXXX--------TTTT00000000000000000000000000000000000
000000000000000000000000000000000000XX----------TTTT00000000000000000000000000000000000
000000000000000000000000000000000000XD-------------X00000000000000000000000000000000000
000000000000000000000000000000000000XD-------------X00000000000000000000000000000000000
000000000000000000000000000000000000TTTTXXXXXXXX--DX00000000000000000000000000000000000
000000000000000000000000000000000000--TTTTTTTT----DX00000000000000000000000000000000000
000000000000000000000000000000000000---------TTTTTTT00000000000000000000000000000000000
000000000000000000000000000000000000----------------00000000000000000000000000000000000
000000000000000000000000000000000000----------------00000000000000000000000000000000000
000000000000000000000000000000000000TTTTTTTT--------00000000000000000000000000000000000
000000000000000000000000000000000000---------TTTT---00000000000000000000000000000000000
000000000000000000000000000000000000----------------00000000000000000000000000000000000
000000000000000000000000000000000000XXXX--------XXXX00000000000000000000000000000000000
000000000000000000000000000000000000----------------00000000000000000000000000000000000
000000000000000000000000000000000000---------TTT----00000000000000000000000000000000000
000000000000000000000000000000000000----------------00000000000000000000000000000000000
000000000000000000000000000000000000X-----------TTTT00000000000000000000000000000000000
000000000000000000000000000000000000X--------------X00000000000000000000000000000000000
000000000000000000000000000000000000X--------------X00000000000000000000000000000000000
000000000000000000000000000000000000XXXXXXXXX------X00000000000000000000000000000000000
000000000000000000000000000000000000XX-------------X00000000000000000000000000000000000
000000000000000000000000000000000000XX---------TTTTT00000000000000000000000000000000000
000000000000000000000000000000000000XD-------------X00000000000000000000000000000000000
000000000000000000000000000000000000XD-------------X00000000000000000000000000000000000
000000000000000000000000000000000000TTTTXXXXXXXX--DX00000000000000000000000000000000000
000000000000000000000000000000000000--TTTTTTTT----DX00000000000000000000000000000000000
000000000000000000000000000000000000---------TTTTTTT00000000000000000000000000000000000
000000000000000000000000000000000000------X---------00000000000000000000000000000000000
000000000000000000000000000000000000----------------00000000000000000000000000000000000
000000000000000000000000000000000000----------------00000000000000000000000000000000000
000000000000000000000000000000000000XXXXXX----------00000000000000000000000000000000000
000000000000000000000000000000000000----------------00000000000000000000000000000000000
000000000000000000000000000000000000------TTTT------00000000000000000000000000000000000
000000000000000000000000000000000000----------------00000000000000000000000000000000000
000000000000000000000000000000000000---------TTTT---00000000000000000000000000000000000
000000000000000000000000000000000000----------------00000000000000000000000000000000000
000000000000000000000000000000000000----------------00000000000000000000000000000000000
000000000000000000000000000000000000-XXXX--------XXX00000000000000000000000000000000000
000000000000000000000000000000000000XXXX--------XXXX00000000000000000000000000000000000
000000000000000000000000000000000000XXXX------------00000000000000000000000000000000000
000000000000000000000000000000000000XX-------------X00000000000000000000000000000000000
000000000000000000000000000000000000XX----------TTTT00000000000000000000000000000000000
000000000000000000000000000000000000XD-------------X00000000000000000000000000000000000
000000000000000000000000000000000000XD-------------X00000000000000000000000000000000000
000000000000000000000000000000000000TTTTXXXXXXXX--DX00000000000000000000000000000000000
000000000000000000000000000000000000--TTTTTTTT----DX00000000000000000000000000000000000
000000000000000000000000000000000000---------TTTTTTT00000000000000000000000000000000000
000000000000000000000000000000000000--XX-----------X00000000000000000000000000000000000
000000000000000000000000000000000000XX-------------X00000000000000000000000000000000000
000000000000000000000000000000000000XX------XXXXXXXX00000000000000000000000000000000000
000000000000000000000000000000000000XXXX--------XXXX00000000000000000000000000000000000
000000000000000000000000000000000000XXXX--------XXXX00000000000000000000000000000000000
000000000000000000000000000000000000XXXX--------XXXX00000000000000000000000000000000000
000000000000000000000000000000000000XXXX--------XXXX00000000000000000000000000000000000
0000000000000000--------------------XXXX--------XXXX00000000000000000000000000000000000
0000000000000000--------------------XXXX--------XXXX00000000000000000000000000000000000
0000000000000000--------------------XXXX--------XXXX00000000000000000000000000000000000
0000000000000000--------------------XXXX--------XXXX00000000000000000000000000000000000
0000000000000000--------------------XXXX--------XXXX00000000000000000000000000000000000
0000000000000000--------------------XX----TTTTTTTTXX00000000000000000000000000000000000
0000000000000000--------------------XX------------XX00000000000000000000000000000000000
0000000000000000--------------------XX------------XX00000000000000000000000000000000000
0000000000000000--------------------XD------------XX00000000000000000000000000000000000
0000000000000000--------------------XD-------------X00000000000000000000000000000000000
0000000000000000--------------------TTTTXXXXXXXX--DX00000000000000000000000000000000000
0000000000000000----------------XXX---TTTTTTTT----DX00000000000000000000000000000000000
0000000000000000-------------------X---------TTTTTTT00000000000000000000000000000000000
0000000000000000--------------------000000000000000000000000000000000000000000000000000
--------------------E-----EEE-------000000000000000000000000000000000000000000000000000
----------------XXXXXXXXXXXXXXXX----000000000000000000000000000000000000000000000000000
------TT--------00000000000000000000000000000000000000000000000000000000000000000000000
----------------00000000000000000000000000000000000000000000000000000000000000000000000
----------------00000000000000000000000000000000000000000000000000000000000000000000000
-----TT--TT-----00000000000000000000000000000000000000000000000000000000000000000000000
----------------00000000000000000000000000000000000000000000000000000000000000000000000
----------------00000000000000000000000000000000000000000000000000000000000000000000000
----XXXX--------00000000000000000000000000000000000000000000000000000000000000000000000
XX--------------00000000000000000000000000000000000000000000000000000000000000000000000
XX--------------00000000000000000000000000000000000000000000000000000000000000000000000
XXXX--TTTT------00000000000000000000000000000000000000000000000000000000000000000000000
XXXX------------00000000000000000000000000000000000000000000000000000000000000000000000
XX-------------X00000000000000000000000000000000000000000000000000000000000000000000000
XX----------TTTT00000000000000000000000000000000000000000000000000000000000000000000000
XD-------------X00000000000000000000000000000000000000000000000000000000000000000000000
XD-------------X00000000000000000000000000000000000000000000000000000000000000000000000
TTTTXXXXXXXX--DX00000000000000000000000000000000000000000000000000000000000000000000000
--TTTTTTTT----DX00000000000000000000000000000000000000000000000000000000000000000000000
---------TTTTTTT00000000000000000000000000000000000000000000000000000000000000000000000