0000000000000000000000000000000000000000000000000000000000000000000000000000000000000000000000000000000000000000000000000000----------------------------------------000000000000000
0000000000000000000000000000000000000000000000000000000000000000000000000000000000000000000000000000000000000000000000000000----------------------------------------000000000000000
0000000000000000000000000000000000000000000000000000000000000000000000000000000000000000000000000000000000000000000000000000----------------------------------------000000000000000
0000000000000000000000000000000000000000000000000000000000000000000000000000000000000000000000000000000000000000000000000000----------------------------------------000000000000000
000000000000000000000000000000000000000000000000000000000000000000000000000000000000000000000000000000000000---------X------S-------------------S-------------------000000000000000
000000000000000000000000000000000000000000000000000000000000000000000000000000000000000000000000000000000000---------X------S-------------------S-------------------000000000000000
000000000000000000000000000000000000000000000000000000000000000000000000000000000000000000000000000000000000---------X------S-------------------S-------------------000000000000000
000000000000000000000000000000000000000000000000000000000000000000000000000000000000000000000000000000000000---------X------S-------------------S-------------------000000000000000
0000000000000000000000000000000000000000000000000000000000000000000000000000000000000000-----------------------------X------S-------------------S-------------------000000000000000
0000000000000000000000000000000000000000000000000000000000000000000000000000000000000000------------------------------------S-------------------S-------------------000000000000000
0000000000000000000000000000000000000000000000000000000000000000000000000000000000000000------------------------------------S-------------------S-------------------000000000000000
0000000000000000000000000000000000000000000000000000000000000000000000000000000000000000------------------------------------S--------XXXXXXXXXXXS----------XXXXXXXXX000000000000000
000000000000000000000000000000000000000000000000000000000000000000000000XXXX----------XXS----------------------------T------S-------------------S-------------------000000000000000
000000000000000000000000000000000000000000000000000000000000000000000000XXXX----------XXS--X--------------------------------S-------------------S-------------------000000000000000
000000000000000000000000000000000000000000000000000000000000000000000000XXXX----------XXS-----------------------------------S-------------------S-------------------000000000000000
000000000000000000000000000000000000000000000000000000000000000000000000XXXX------------S-------------------XX----------XXXXXXXXXXXXX-----------XXXXXXXXXXX-X-------000000000000000
0000000000000000000000000000000000000000000000000000--------------------XXXX------------S-------------------------------XXX-0000000000000000000000000000000000000000000000000000000
0000000000000000000000000000000000000000000000000000--------------------XXXXXXXXX-------S-----------------------------------0000000000000000000000000000000000000000000000000000000
0000000000000000000000000000000000000000000000000000--------------------XXXX------------S-----------oo------XX-----------XXX0000000000000000000000000000000000000000000000000000000
0000000000000000000000000000000000000000000000000000--------------------XXXX----X-------S-----E-------------XX----XXXXXXXXXX0000000000000000000000000000000000000000000000000000000
000000000000000000000000000000000000X---------------S----------------------------TTTT---S-------------------XD-----------T-X0000000000000000000000000000000000000000000000000000000
000000000000000000000000000000000000XXXX--------XXXXS-----------------------------------S-------------------XD------------XX0000000000000000000000000000000000000000000000000000000
000000000000000000000000000000000000XXXX--------XXXXS-----------------------------------S-------------------XXXXX-------XXXX0000000000000000000000000000000000000000000000000000000
000000000000000000000000000000000000XXXX-----TTTTXXXS-------------------XX-----TTTT---XXXXEXXXXXXXXXXXXXXXXXXXXXXXXXXXXXXXXX0000000000000000000000000000000000000000000000000000000
000000000000000000000000000000000000XXXX--------XXXXS-------------------XX------------XX0000000000000000000000000000000000000000000000000000000000000000000000000000000000000000000
000000000000000000000000000000000000XXXX--------XXXXS-------------------XX------------XX0000000000000000000000000000000000000000000000000000000000000000000000000000000000000000000
000000000000000000000000000000000000XXXX--XXXXXXXXXXS-------------------XXXXXXXX------XX0000000000000000000000000000000000000000000000000000000000000000000000000000000000000000000
000000000000000000000000000000000000XXXX--------XXXXS-----------ES------XX----XXXXX---XX0000000000000000000000000000000000000000000000000000000000000000000000000000000000000000000
000000000000000000000000000000000000XXXX--------XXXXS---------------E---XD------------XX0000000000000000000000000000000000000000000000000000000000000000000000000000000000000000000
000000000000000000000000000000000000XXXX--XXXXXXXXXXS-------------------XD------------XX0000000000000000000000000000000000000000000000000000000000000000000000000000000000000000000
000000000000000000000000000000000000XXXX--------XXXXS-------------------XXXXX-------XXXX0000000000000000000000000000000000000000000000000000000000000000000000000000000000000000000
000000000000000000000000000000000000XXXX--------XXXXXXXXXXXXXXXXXXXXXXXXXXXXXXXXXXXXXXXX0000000000000000000000000000000000000000000000000000000000000000000000000000000000000000000
000000000000000000000000000000000000XXXX--XXXXXXXXXX0000000000000000000000000000000000000000000000000000000000000000000000000000000000000000000000000000000000000000000000000000000
000000000000000000000000000000000000XXXX--------XXXX0000000000000000000000000000000000000000000000000000000000000000000000000000000000000000000000000000000000000000000000000000000
000000000000000000000000000000000000XX-----------XXX0000000000000000000000000000000000000000000000000000000000000000000000000000000000000000000000000000000000000000000000000000000
000000000000000000000000000000000000XX----XXXXXXXXXX0000000000000000000000000000000000000000000000000000000000000000000000000000000000000000000000000000000000000000000000000000000
000000000000000000000000000000000000XD-----------TXX0000000000000000000000000000000000000000000000000000000000000000000000000000000000000000000000000000000000000000000000000000000
000000000000000000000000000000000000XD------------XX0000000000000000000000000000000000000000000000000000000000000000000000000000000000000000000000000000000000000000000000000000000
000000000000000000000000000000000000XXXXX-------XXXX0000000000000000000000000000000000000000000000000000000000000000000000000000000000000000000000000000000000000000000000000000000
000000000000000000000000000000000000XXXXXXXXXXXXXXXX0000000000000000000000000000000000000000000000000000000000000000000000000000000000000000000000000000000000000000000000000000000
000000000000000000000000000000000000XXXX--------XXXX0000000000000000000000000000000000000000000000000000000000000000000000000000000000000000000000000000000000000000000000000000000
000000000000000000000000000000000000XXXX--------XXXX0000000000000000000000000000000000000000000000000000000000000000000000000000000000000000000000000000000000000000000000000000000
000000000000000000000000000000000000XXXXXXX-----XXXX0000000000000000000000000000000000000000000000000000000000000000000000000000000000000000000000000000000000000000000000000000000
000000000000000000000000000000000000XXXX--------XXXX0000000000000000000000000000000000000000000000000000000000000000000000000000000000000000000000000000000000000000000000000000000
0000000000000000--------------------XX------------XX0000000000000000000000000000000000000000000000000000000000000000000000000000000000000000000000000000000000000000000000000000000
0000000000000000--------------------XX-----XXXX---DX0000000000000000000000000000000000000000000000000000000000000000000000000000000000000000000000000000000000000000000000000000000
0000000000000000--------------------XX------------DX0000000000000000000000000000000000000000000000000000000000000000000000000000000000000000000000000000000000000000000000000000000
---------TTTT-----------------------XXXX--------XXXX0000000000000000000000000000000000000000000000000000000000000000000000000000000000000000000000000000000000000000000000000000000
----------------S-------------------XXXXXX------XXXX0000000000000000000000000000000000000000000000000000000000000000000000000000000000000000000000000000000000000000000000000000000
XXXX--------XXXXS-------------------XXXX--------XXXX0000000000000000000000000000000000000000000000000000000000000000000000000000000000000000000000000000000000000000000000000000000
----------------S-------------------XXXX--------XXXX0000000000000000000000000000000000000000000000000000000000000000000000000000000000000000000000000000000000000000000000000000000
---------TTTT---S-------------------XX----TTTTTTTTXX0000000000000000000000000000000000000000000000000000000000000000000000000000000000000000000000000000000000000000000000000000000
----------------S-------------------XX------------XX0000000000000000000000000000000000000000000000000000000000000000000000000000000000000000000000000000000000000000000000000000000
----------------S-------------------XX------------XX0000000000000000000000000000000000000000000000000000000000000000000000000000000000000000000000000000000000000000000000000000000
XX------TTTTTTXXS-------------------XXXXXXXX------XX0000000000000000000000000000000000000000000000000000000000000000000000000000000000000000000000000000000000000000000000000000000
XX------------XXS------------X------XX----XXXXX---XX0000000000000000000000000000000000000000000000000000000000000000000000000000000000000000000000000000000000000000000000000000000
XX------------XXS----------XXX------XD------------XX0000000000000000000000000000000000000000000000000000000000000000000000000000000000000000000000000000000000000000000000000000000
XXXXXXXX------XXS-------------------XD------------XX0000000000000000000000000000000000000000000000000000000000000000000000000000000000000000000000000000000000000000000000000000000
XXXX----------XXS-------------------XXXXX-------XXXX0000000000000000000000000000000000000000000000000000000000000000000000000000000000000000000000000000000000000000000000000000000
XXXX----------XXXXXXXXXXXXXXXXXXXXXXXXXXXXXXXXXXXXXX0000000000000000000000000000000000000000000000000000000000000000000000000000000000000000000000000000000000000000000000000000000
XXXX----------X-0000000000000000000000000000000000000000000000000000000000000000000000000000000000000000000000000000000000000000000000000000000000000000000000000000000000000000000
XXXX------------0000000000000000000000000000000000000000000000000000000000000000000000000000000000000000000000000000000000000000000000000000000000000000000000000000000000000000000
XXXX------------0000000000000000000000000000000000000000000000000000000000000000000000000000000000000000000000000000000000000000000000000000000000000000000000000000000000000000000
XD--------------0000000000000000000000000000000000000000000000000000000000000000000000000000000000000000000000000000000000000000000000000000000000000000000000000000000000000000000
XD-------------X0000000000000000000000000000000000000000000000000000000000000000000000000000000000000000000000000000000000000000000000000000000000000000000000000000000000000000000
XXXXX-------XXXX0000000000000000000000000000000000000000000000000000000000000000000000000000000000000000000000000000000000000000000000000000000000000000000000000000000000000000000
XXXXXXXXXXXXXXXX0000000000000000000000000000000000000000000000000000000000000000000000000000000000000000000000000000000000000000000000000000000000000000000000000000000000000000000