00000000000000000000000000000000000000000000000000000000000000000000000000000000000000000000--------------------000000000000000
00000000000000000000000000000000000000000000000000000000000000000000000000000000000000000000--------------------000000000000000
00000000000000000000000000000000000000000000000000000000000000000000000000000000000000000000--------------------000000000000000
00000000000000000000000000000000000000000000000000000000000000000000000000000000000000000000--------------------000000000000000
0000000000000000000000000000000000000000000000000000000000000000000000000000----------------S-------------------000000000000000
0000000000000000000000000000000000000000000000000000000000000000000000000000X-----------TTTTS-------------------000000000000000
0000000000000000000000000000000000000000000000000000000000000000000000000000X--------------XS-------------------000000000000000
0000000000000000000000000000000000000000000000000000000000000000000000000000X--------------XS----SSQQQ----------000000000000000
0000000000000000000000000000000000000000000000000000000000000000000000000000X---------XXXXXXS-------------------000000000000000
0000000000000000000000000000000000000000000000000000000000000000000000000000X----------D---XS-------------------000000000000000
0000000000000000000000000000000000000000000000000000000000000000000000000000X---------XXXXXXS-------------------000000000000000
0000000000000000000000000000000000000000000000000000000000000000000000000000X--------DXX---XS---S-SSSQS-X-------000000000000000
0000000000000000000000000000000000000000000000000000000000000000000000000000X----------D---XS-----------X-------000000000000000
0000000000000000000000000000000000000000000000000000000000000000000000000000X---XXXXXXXX---XS-----------X-------000000000000000
0000000000000000000000000000000000000000000000000000000000000000000000000000X------XXXXXXXXXS--EE-------X-------000000000000000
0000000000000000000000000000000000000000000000000000000000000000000000000000XX--------------XXXXXXXXXXXXXXXXXXXX000000000000000
0000000000000000000000000000000000000000000000000000000000000000000000000000XX--------------00000000000000000000000000000000000
0000000000000000000000000000000000000000000000000000000000000000000000000000XXXX--------XXXX00000000000000000000000000000000000
0000000000000000000000000000000000000000000000000000000000000000000000000000XX----------XXXX00000000000000000000000000000000000
0000000000000000000000000000000000000000000000000000000000000000000000000000XX-----XXXXX--XX00000000000000000000000000000000000
0000000000000000000000000000000000000000000000000000000000000000000000000000XD------------XX00000000000000000000000000000000000
0000000000000000000000000000000000000000000000000000000000000000000000000000XD------------DX00000000000000000000000000000000000
0000000000000000000000000000000000000000000000000000000000000000000000000000XXXXX-------XXXX00000000000000000000000000000000000
0000000000000000000000000000000000000000000000000000000000000000000000000000XXXXXXXXXXXXXXXX00000000000000000000000000000000000
0000000000000000000000000000000000000000000000000000000000000000000000000000XXXX----------XX00000000000000000000000000000000000
0000000000000000000000000000000000000000000000000000000000000000000000000000XXXX----------DX00000000000000000000000000000000000
0000000000000000000000000000000000000000000000000000000000000000000000000000XXXX---------XXX00000000000000000000000000000000000
0000000000000000000000000000000000000000000000000000000000000000000000000000XXXX----XXXXXXXX00000000000000000000000000000000000
0000000000000000000000000000000000000000000000000000000000000000000000000000XXXX--------XXXX00000000000000000000000000000000000
0000000000000000000000000000000000000000000000000000000000000000000000000000XXXX--------XXXX00000000000000000000000000000000000
0000000000000000000000000000000000000000000000000000000000000000000000000000XXXX-----TTTTXXX00000000000000000000000000000000000
0000000000000000000000000000000000000000000000000000000000000000000000000000XXXX--------XXXX00000000000000000000000000000000000
0000000000000000000000000000000000000000000000000000000000000000000000000000XXXX--------XXXX00000000000000000000000000000000000
0000000000000000000000000000000000000000000000000000000000000000000000000000XTTTTTTTT---XXXX00000000000000000000000000000000000
0000000000000000000000000000000000000000000000000000000000000000000000000000XXXX--------XXXX00000000000000000000000000000000000
0000000000000000000000000000000000000000000000000000000000000000000000000000XXXX--------XXXX00000000000000000000000000000000000
0000000000000000000000000000000000000000000000000000000000000000000000000000XXXX-----TTTTXXX00000000000000000000000000000000000
0000000000000000000000000000000000000000000000000000000000000000000000000000XXXX--------XXXX00000000000000000000000000000000000
0000000000000000000000000000000000000000000000000000000000000000000000000000XX-----------XXX00000000000000000000000000000000000
0000000000000000000000000000000000000000000000000000000000000000000000000000XX----XXXXXXXXXX00000000000000000000000000000000000
0000000000000000000000000000000000000000000000000000000000000000000000000000XD-----------T-X00000000000000000000000000000000000
0000000000000000000000000000000000000000000000000000000000000000000000000000XD------------XX00000000000000000000000000000000000
0000000000000000000000000000000000000000000000000000000000000000000000000000XXXXX-------XXXX00000000000000000000000000000000000
0000000000000000000000000000000000000000000000000000000000000000000000000000XXXXXXXXXXXXXXXX00000000000000000000000000000000000
0000000000000000000000000000000000000000000000000000000000000000000000000000TTTTTTTT--------00000000000000000000000000000000000
0000000000000000000000000000000000000000000000000000000000000000000000000000X---------------00000000000000000000000000000000000
0000000000000000000000000000000000000000000000000000000000000000000000000000X---------------00000000000000000000000000000000000
0000000000000000000000000000000000000000000000000000000000000000000000000000X------TTTT-----00000000000000000000000000000000000
0000000000000000000000000000000000000000000000000000000000000000000000000000X---------------00000000000000000000000000000000000
0000000000000000000000000000000000000000000000000000000000000000000000000000XX--------------00000000000000000000000000000000000
0000000000000000000000000000000000000000000000000000000000000000000000000000XTTTTTTTT-------00000000000000000000000000000000000
0000000000000000000000000000000000000000000000000000000000000000000000000000X---------------00000000000000000000000000000000000
0000000000000000000000000000000000000000000000000000000000000000000000000000X---------------00000000000000000000000000000000000
0000000000000000000000000000000000000000000000000000000000000000000000000000X-----------XXXX00000000000000000000000000000000000
0000000000000000000000000000000000000000000000000000000000000000000000000000X---------------00000000000000000000000000000000000
0000000000000000000000000000000000000000000000000000000000000000000000000000----------------00000000000000000000000000000000000
0000000000000000000000000000000000000000000000000000000000000000000000000000------------TTTT00000000000000000000000000000000000
0000000000000000000000000000000000000000000000000000000000000000000000000000----------------00000000000000000000000000000000000
0000000000000000000000000000000000000000000000000000000000000000000000000000XX-----------XXX00000000000000000000000000000000000
0000000000000000000000000000000000000000000000000000000000000000000000000000XX----XXXXXXXXXX00000000000000000000000000000000000
0000000000000000000000000000000000000000000000000000000000000000000000000000XD------------XX00000000000000000000000000000000000
0000000000000000000000000000000000000000000000000000000000000000000000000000XD------------XX00000000000000000000000000000000000
0000000000000000000000000000000000000000000000000000000000000000000000000000XXXXX-------XXXX00000000000000000000000000000000000
0000000000000000000000000000000000000000000000000000000000000000000000000000XXXXXXXXXXXXXXXX00000000000000000000000000000000000
0000000000000000000000000000000000000000000000000000000000000000000000000000XXXX--------XXXX00000000000000000000000000000000000
0000000000000000000000000000000000000000000000000000000000000000000000000000XXXX--------XXXX00000000000000000000000000000000000
0000000000000000000000000000000000000000000000000000000000000000000000000000XX------------XX00000000000000000000000000000000000
0000000000000000000000000000000000000000000000000000000000000000000000000000XX-----XXXX---DX00000000000000000000000000000000000
0000000000000000------------------------------------------------------------XX------------DX00000000000000000000000000000000000
0000000000000000------------------------------------------------------------XXXX--------XXXX00000000000000000000000000000000000
0000000000000000------------------------------------------------------------XXXXXX------XXXX00000000000000000000000000000000000
0000000000000000------------------------------------------------------------XXXX--------XXXX00000000000000000000000000000000000
----------------S-------------------S-------------------S-------------------XXXX--------XXXX00000000000000000000000000000000000
-----T----------S-------------------S-------------------S-------------------XX----TTTTTTTTXX00000000000000000000000000000000000
----------------S-------------------S-------------------S-------------------XX------------XX00000000000000000000000000000000000
----------------S-------------------S-------------------S-------------------XX------------XX00000000000000000000000000000000000
------TTTTTTT---S-------------------S-------------------S-------------------XXXXXXXXXX----XX00000000000000000000000000000000000
----------------S-------X-----------S-------------------S-------------------XX------------XX00000000000000000000000000000000000
--------------T-S--E----X-------E---S-------------------S-------------------XX------------XX00000000000000000000000000000000000
----------------S-<>--XXX------<>---S------SS-----------S------E------------XX----XXXXXXXXXX00000000000000000000000000000000000
----------------S-[]--XXX------[]---S-------------------S-----<>------------XD------------XX00000000000000000000000000000000000
----------------S-[]--XXX------[]---S-------------------S-----[]------------XD------------XX00000000000000000000000000000000000
----TTTT--------S-[]--XXX------[]---S---------------EE-ES-----[]E-----------XXXXX-------XXXX00000000000000000000000000000000000
----------TTT---XXXXXXXXXXXXXXXXXXXXXXXXXXXXXXXXXXXXXXXXXXXXXXXXXXXXXXXXXXXXXXXXXXXXXXXXXXXX00000000000000000000000000000000000
----------------000000000000000000000000000000000000000000000000000000000000000000000000000000000000000000000000000000000000000
----------------000000000000000000000000000000000000000000000000000000000000000000000000000000000000000000000000000000000000000
XX-----TTTT---XX000000000000000000000000000000000000000000000000000000000000000000000000000000000000000000000000000000000000000
XX------------XX000000000000000000000000000000000000000000000000000000000000000000000000000000000000000000000000000000000000000
XD------------DX000000000000000000000000000000000000000000000000000000000000000000000000000000000000000000000000000000000000000
XD------------DX000000000000000000000000000000000000000000000000000000000000000000000000000000000000000000000000000000000000000
XXXXX-------XXXX000000000000000000000000000000000000000000000000000000000000000000000000000000000000000000000000000000000000000
XXXXXXXXXXXXXXXX000000000000000000000000000000000000000000000000000000000000000000000000000000000000000000000000000000000000000
---------X------000000000000000000000000000000000000000000000000000000000000000000000000000000000000000000000000000000000000000
----------X-----000000000000000000000000000000000000000000000000000000000000000000000000000000000000000000000000000000000000000
------X---------000000000000000000000000000000000000000000000000000000000000000000000000000000000000000000000000000000000000000
------X---------000000000000000000000000000000000000000000000000000000000000000000000000000000000000000000000000000000000000000
------X---------000000000000000000000000000000000000000000000000000000000000000000000000000000000000000000000000000000000000000
------X---X-----000000000000000000000000000000000000000000000000000000000000000000000000000000000000000000000000000000000000000
-------XX-------000000000000000000000000000000000000000000000000000000000000000000000000000000000000000000000000000000000000000
----X-----------000000000000000000000000000000000000000000000000000000000000000000000000000000000000000000000000000000000000000
----------------000000000000000000000000000000000000000000000000000000000000000000000000000000000000000000000000000000000000000
XX----------XXXX000000000000000000000000000000000000000000000000000000000000000000000000000000000000000000000000000000000000000
XX--------------000000000000000000000000000000000000000000000000000000000000000000000000000000000000000000000000000000000000000
XX--------------000000000000000000000000000000000000000000000000000000000000000000000000000000000000000000000000000000000000000
XXD---------TTTT000000000000000000000000000000000000000000000000000000000000000000000000000000000000000000000000000000000000000
XX--------------000000000000000000000000000000000000000000000000000000000000000000000000000000000000000000000000000000000000000
XX--------------000000000000000000000000000000000000000000000000000000000000000000000000000000000000000000000000000000000000000
XX--------TTT---000000000000000000000000000000000000000000000000000000000000000000000000000000000000000000000000000000000000000
XD--------------000000000000000000000000000000000000000000000000000000000000000000000000000000000000000000000000000000000000000
XD-------------X000000000000000000000000000000000000000000000000000000000000000000000000000000000000000000000000000000000000000
XXXXX-------XXXX000000000000000000000000000000000000000000000000000000000000000000000000000000000000000000000000000000000000000
XXXXXXXXXXXXXXXX000000000000000000000000000000000000000000000000000000000000000000000000000000000000000000000000000000000000000