000000000000000000000000000000000000000000000000000000000000000000000000000000000000000000000000XXXX--------XXXX
000000000000000000000000000000000000000000000000000000000000000000000000000000000000000000000000----------------
000000000000000000000000000000000000000000000000000000000000000000000000000000000000000000000000----------TTTT--
000000000000000000000000000000000000000000000000000000000000000000000000000000000000000000000000--------D-------
000000000000000000000000000000000000000000000000000000000000000000000000000000000000000000000000------XXXX------
000000000000000000000000000000000000000000000000000000000000000000000000000000000000000000000000----------------
000000000000000000000000000000000000000000000000000000000000000000000000000000000000000000000000---XXXX---------
000000000000000000000000000000000000000000000000000000000000000000000000000000000000000000000000----------------
000000000000000000000000000000000000000000000000000000000000000000000000000000000000000000000000----------------
000000000000000000000000000000000000000000000000000000000000000000000000000000000000000000000000----------------
000000000000000000000000000000000000000000000000000000000000000000000000000000000000000000000000XX----------XXXX
000000000000000000000000000000000000000000000000000000000000000000000000000000000000000000000000XX----------XXXX
000000000000000000000000000000000000000000000000000000000000000000000000000000000000000000000000XXXXXXX-----XXXX
000000000000000000000000000000000000000000000000000000000000000000000000000000000000000000000000XX----------XXXX
000000000000000000000000000000000000000000000000000000000000000000000000000000000000000000000000XX----------XXXX
000000000000000000000000000000000000000000000000000000000000000000000000000000000000000000000000XX-----------XXX
000000000000000000000000000000000000000000000000000000000000000000000000000000000000000000000000XD-----------XXX
000000000000000000000000000000000000000000000000000000000000000000000000000000000000000000000000XD-----------XXX
000000000000000000000000000000000000000000000000000000000000000000000000000000000000000000000000XXXXXXXXXXXXXXXX
000000000000000000000000000000000000000000000000000000000000000000000000000000000000000000000000XXXXXXXXXXXXXXXX
000000000000000000000000000000000000000000000000000000000000000000000000000000000000000000000000----------------
000000000000000000000000000000000000000000000000000000000000000000000000000000000000000000000000---------TTTT---
000000000000000000000000000000000000000000000000000000000000000000000000000000000000000000000000----------------
000000000000000000000000000000000000000000000000000000000000000000000000000000000000000000000000XXXXXXX-----XXXX
0000000000000000--------------------------------------------------------------------------------XXXX--------XXXX
0000000000000000--------------------------------------------------------------------------------XX-----------XXX
0000000000000000--------------------------------------------------------------------------------XX-----XXXX--XXX
0000000000000000--------------------------------------------------------------------------------XX-----------XXX
0000000000000000-----------E----------------------o---------------------------------------------XX-----------XXX
0000000000000000--------------------------------------------------------------------------------XX-----------XXX
0000000000000000-----------------------------------oo--------------------------------ooo--------XX-----------XXX
0000000000000000----------------------------SSS---X---------------------------------XXXXX-o-----XXXX---------XXX
0000000000000000--------------------------------------------------------oooo---------------o----XX-----------XXX
0000000000000000-----------------------------------X--------------------------------------------XX------XXXXXXXX
0000000000000000------------------------------------------------------E-------------------------XX-----------XXX
0000000000000000------------------------------------XXX------E-------<>------------S------------XX-----------XXX
0000000000000000--------------------------------------------<>-------[]-------------------------XD-----------XXX
0000000000000000--------------------------------------------[]-------[]-------------------------XD-----------XXX
------------------E--------XXX----------------E-------------[]-------[]--E----------------------XXXXXXXXXXXXXXXX
----------------XXXXXXXXXXXXXXXXXXXXXXXXXXXXXXXXXX------XXXXXXXXXXXXXXXXXXXXXXXXXXXXXXXXXXXXXXXXXXXXXXXXXXXXXXXX
------------TTTT000000000000000000000000000000000000000000000000000000000000000000000000000000000000000000000000
XXXX------------000000000000000000000000000000000000000000000000000000000000000000000000000000000000000000000000
----------------000000000000000000000000000000000000000000000000000000000000000000000000000000000000000000000000
--TTTTTTTT------000000000000000000000000000000000000000000000000000000000000000000000000000000000000000000000000
----------------000000000000000000000000000000000000000000000000000000000000000000000000000000000000000000000000
----------------000000000000000000000000000000000000000000000000000000000000000000000000000000000000000000000000
-TTTTTTTT-------000000000000000000000000000000000000000000000000000000000000000000000000000000000000000000000000
----------------000000000000000000000000000000000000000000000000000000000000000000000000000000000000000000000000
----------------000000000000000000000000000000000000000000000000000000000000000000000000000000000000000000000000
XX----------XXXX000000000000000000000000000000000000000000000000000000000000000000000000000000000000000000000000
XX----------XXXX000000000000000000000000000000000000000000000000000000000000000000000000000000000000000000000000
XX-----------XXX000000000000000000000000000000000000000000000000000000000000000000000000000000000000000000000000
XX-----------XXX000000000000000000000000000000000000000000000000000000000000000000000000000000000000000000000000
XX-----------XXX000000000000000000000000000000000000000000000000000000000000000000000000000000000000000000000000
XD-----------XXX000000000000000000000000000000000000000000000000000000000000000000000000000000000000000000000000
XD-----------XXX000000000000000000000000000000000000000000000000000000000000000000000000000000000000000000000000
XXXXXXXXXXXXXXXX000000000000000000000000000000000000000000000000000000000000000000000000000000000000000000000000
XXXXXXXXXXXXXXXX000000000000000000000000000000000000000000000000000000000000000000000000000000000000000000000000
XXXX--------XXXX000000000000000000000000000000000000000000000000000000000000000000000000000000000000000000000000
XXXX--XXXXXXXXXX000000000000000000000000000000000000000000000000000000000000000000000000000000000000000000000000
XXXX--------XXXX000000000000000000000000000000000000000000000000000000000000000000000000000000000000000000000000
XXXX--------XXXX000000000000000000000000000000000000000000000000000000000000000000000000000000000000000000000000
XTTTTTTTT---XXXX000000000000000000000000000000000000000000000000000000000000000000000000000000000000000000000000
XXXX--------XXXX000000000000000000000000000000000000000000000000000000000000000000000000000000000000000000000000
XXXX--------XXXX000000000000000000000000000000000000000000000000000000000000000000000000000000000000000000000000
XTTTTTTTT---XXXX000000000000000000000000000000000000000000000000000000000000000000000000000000000000000000000000
XXXX--------XXXX000000000000000000000000000000000000000000000000000000000000000000000000000000000000000000000000
XXXX--------XXXX000000000000000000000000000000000000000000000000000000000000000000000000000000000000000000000000
XXXXXXX-----XXXX000000000000000000000000000000000000000000000000000000000000000000000000000000000000000000000000
XXXX--------XXXX000000000000000000000000000000000000000000000000000000000000000000000000000000000000000000000000
XX-----------XXX000000000000000000000000000000000000000000000000000000000000000000000000000000000000000000000000
XX-----XXXX--XXX000000000000000000000000000000000000000000000000000000000000000000000000000000000000000000000000
XX-----------XXX000000000000000000000000000000000000000000000000000000000000000000000000000000000000000000000000
XX-----------XXX000000000000000000000000000000000000000000000000000000000000000000000000000000000000000000000000
XD-----------XXX000000000000000000000000000000000000000000000000000000000000000000000000000000000000000000000000
XD-----------XXX000000000000000000000000000000000000000000000000000000000000000000000000000000000000000000000000
XXXXXXXXXXXXXXXX000000000000000000000000000000000000000000000000000000000000000000000000000000000000000000000000
XXXXXXXXXXXXXXXX000000000000000000000000000000000000000000000000000000000000000000000000000000000000000000000000
XXXX------XXXX--000000000000000000000000000000000000000000000000000000000000000000000000000000000000000000000000
XXXXE-EXXXXXXX--000000000000000000000000000000000000000000000000000000000000000000000000000000000000000000000000
XXXX------XXXX--000000000000000000000000000000000000000000000000000000000000000000000000000000000000000000000000
XX-----------XXX000000000000000000000000000000000000000000000000000000000000000000000000000000000000000000000000
XX--TT-------XXX000000000000000000000000000000000000000000000000000000000000000000000000000000000000000000000000
XX-----------XXX000000000000000000000000000000000000000000000000000000000000000000000000000000000000000000000000
XX-----------XXX000000000000000000000000000000000000000000000000000000000000000000000000000000000000000000000000
-XXXXXXXE--XXXX-000000000000000000000000000000000000000000000000000000000000000000000000000000000000000000000000
-XXXX------XXXX-000000000000000000000000000000000000000000000000000000000000000000000000000000000000000000000000
-XXXX------XXXX-000000000000000000000000000000000000000000000000000000000000000000000000000000000000000000000000
-XXXX----EXXXXX-000000000000000000000000000000000000000000000000000000000000000000000000000000000000000000000000
XX----------XXXX000000000000000000000000000000000000000000000000000000000000000000000000000000000000000000000000
XX----------XXXX000000000000000000000000000000000000000000000000000000000000000000000000000000000000000000000000
XXXXXXX-----XXXX000000000000000000000000000000000000000000000000000000000000000000000000000000000000000000000000
XX----------XXXX000000000000000000000000000000000000000000000000000000000000000000000000000000000000000000000000
XX-----------XXX000000000000000000000000000000000000000000000000000000000000000000000000000000000000000000000000
XD-----------XXX000000000000000000000000000000000000000000000000000000000000000000000000000000000000000000000000
XD-----------XXX000000000000000000000000000000000000000000000000000000000000000000000000000000000000000000000000
XXXXXXXXXXXXXXXX000000000000000000000000000000000000000000000000000000000000000000000000000000000000000000000000
XXXXXXXXXXXXXXXX000000000000000000000000000000000000000000000000000000000000000000000000000000000000000000000000
XX--------------000000000000000000000000000000000000000000000000000000000000000000000000000000000000000000000000
XXTTTT----------000000000000000000000000000000000000000000000000000000000000000000000000000000000000000000000000
XX--------------000000000000000000000000000000000000000000000000000000000000000000000000000000000000000000000000
----------------000000000000000000000000000000000000000000000000000000000000000000000000000000000000000000000000
------TTTT------000000000000000000000000000000000000000000000000000000000000000000000000000000000000000000000000
----------------000000000000000000000000000000000000000000000000000000000000000000000000000000000000000000000000
---------TTTT---000000000000000000000000000000000000000000000000000000000000000000000000000000000000000000000000
----------------000000000000000000000000000000000000000000000000000000000000000000000000000000000000000000000000
----------------000000000000000000000000000000000000000000000000000000000000000000000000000000000000000000000000
-----TTTT-------000000000000000000000000000000000000000000000000000000000000000000000000000000000000000000000000
----------------000000000000000000000000000000000000000000000000000000000000000000000000000000000000000000000000
----------------000000000000000000000000000000000000000000000000000000000000000000000000000000000000000000000000
XXXX-----TTTT---000000000000000000000000000000000000000000000000000000000000000000000000000000000000000000000000
XXXX---------XXX000000000000000000000000000000000000000000000000000000000000000000000000000000000000000000000000
XX-----------XXX000000000000000000000000000000000000000000000000000000000000000000000000000000000000000000000000
XX------XXXXXXXX000000000000000000000000000000000000000000000000000000000000000000000000000000000000000000000000
XD-----------XXX000000000000000000000000000000000000000000000000000000000000000000000000000000000000000000000000
XD-----------XXX000000000000000000000000000000000000000000000000000000000000000000000000000000000000000000000000
XXXXXXXXXXXXXXXX000000000000000000000000000000000000000000000000000000000000000000000000000000000000000000000000
XXXXXXXXXXXXXXXX000000000000000000000000000000000000000000000000000000000000000000000000000000000000000000000000