000000000000000000000000000000000000000000000000000000000000000000000000XXXX--------XXXX
000000000000000000000000000000000000000000000000000000000000000000000000XXXX--------XXXX
000000000000000000000000000000000000000000000000000000000000000000000000XXXXXXX-----XXXX
000000000000000000000000000000000000000000000000000000000000000000000000XXXX--------XXXX
000000000000000000000000000000000000000000000000000000000000000000000000XX------------XX
000000000000000000000000000000000000000000000000000000000000000000000000XX-----XXXX---DX
000000000000000000000000000000000000000000000000000000000000000000000000XX------------DX
000000000000000000000000000000000000000000000000000000000000000000000000XXXX--------XXXX
000000000000000000000000000000000000000000000000000000000000000000000000XXXXXX------XXXX
000000000000000000000000000000000000000000000000000000000000000000000000XXXX--------XXXX
000000000000000000000000000000000000000000000000000000000000000000000000XXXX--------XXXX
000000000000000000000000000000000000000000000000000000000000000000000000XX----TTTTTTTTXX
0000000000000000000000000000000000000000000000000000--------------------XX------------XX
0000000000000000000000000000000000000000000000000000--------------------XX------------XX
0000000000000000000000000000000000000000000000000000--------------------XXXXXXXX------XX
000000000000000000000000000000000000------TTTT--------------------------XX----XXXXX---XX
000000000000000000000000000000000000----------------S-------------------XD------------XX
000000000000000000000000000000000000---------XXXX---S-------------------XD------------XX
000000000000000000000000000000000000----------------S-------------------XXXXX-------XXXX
000000000000000000000000000000000000---E--------E---S------------------XXXXXXXXXXXXXXXXX
000000000000000000000000000000000000MMMMMMMMMMMMMMMMS-------------------0000000000000000
0000000000000000------------------------------------S-------------------0000000000000000
0000000000000000------------------------------------S-------------------0000000000000000
---------TTTT--------------------------------TTT----S----------------E--0000000000000000
----------------------------------------------------S--E------------<>--0000000000000000
----------------S-------------------X-----------TTTTS-<>------------[]--0000000000000000
XX----------XXXXS-------------------X--------------XS-[]------------[]--0000000000000000
XX----------X---S-------------------X--------------XXXXXXXXXXXXXXXXXXXXX0000000000000000
XX----------X---S--------------SQQ--XXXXXXXXX------X000000000000000000000000000000000000
XX----------X---S-------------------XX-------------X000000000000000000000000000000000000
XX----------X---S-------------------XX--------TTTTTT000000000000000000000000000000000000
XX----------X---S-------------------XD-------------X000000000000000000000000000000000000
XX----------XX--S--------------SSS--XD-------------X000000000000000000000000000000000000
XX----------X---S--E----------------XXXXX-------XXXX000000000000000000000000000000000000
XX----------X---S-<>---------------SXXXXXXXXXXXXXXXX000000000000000000000000000000000000
XX----------X---S-------------------0000000000000000000000000000000000000000000000000000
XX------------X-XXXXXXXXXXXXXXXXXXXX0000000000000000000000000000000000000000000000000000
XX--------------000000000000000000000000000000000000000000000000000000000000000000000000
XX--------TTT---000000000000000000000000000000000000000000000000000000000000000000000000
XD--------------000000000000000000000000000000000000000000000000000000000000000000000000
XD-------------X000000000000000000000000000000000000000000000000000000000000000000000000
XXXXX-------XXXX000000000000000000000000000000000000000000000000000000000000000000000000
XXXXXXXXXXXXXXXX000000000000000000000000000000000000000000000000000000000000000000000000
----------TTTT--000000000000000000000000000000000000000000000000000000000000000000000000
----------------000000000000000000000000000000000000000000000000000000000000000000000000
----------------000000000000000000000000000000000000000000000000000000000000000000000000
TTT-------------000000000000000000000000000000000000000000000000000000000000000000000000
----------------000000000000000000000000000000000000000000000000000000000000000000000000
----------------000000000000000000000000000000000000000000000000000000000000000000000000
---XXXX---------000000000000000000000000000000000000000000000000000000000000000000000000
XXXX---------XXX000000000000000000000000000000000000000000000000000000000000000000000000
XXXX----XXXXXXXX000000000000000000000000000000000000000000000000000000000000000000000000
---X-X----------000000000000000000000000000000000000000000000000000000000000000000000000
---X------------000000000000000000000000000000000000000000000000000000000000000000000000
XXX-----------XX000000000000000000000000000000000000000000000000000000000000000000000000
XXXXXXXXXX----XX000000000000000000000000000000000000000000000000000000000000000000000000
XX------------XX000000000000000000000000000000000000000000000000000000000000000000000000
XX------------XX000000000000000000000000000000000000000000000000000000000000000000000000
XX----XXXXXXXXXX000000000000000000000000000000000000000000000000000000000000000000000000
XD------------XX000000000000000000000000000000000000000000000000000000000000000000000000
XD------------XX000000000000000000000000000000000000000000000000000000000000000000000000
XXXXX-------XXXX000000000000000000000000000000000000000000000000000000000000000000000000
XXXXXXXXXXXXXXXX000000000000000000000000000000000000000000000000000000000000000000000000
--------TTTT----000000000000000000000000000000000000000000000000000000000000000000000000
----------------000000000000000000000000000000000000000000000000000000000000000000000000
--TTTTTTTT------000000000000000000000000000000000000000000000000000000000000000000000000
----------------000000000000000000000000000000000000000000000000000000000000000000000000
----------------000000000000000000000000000000000000000000000000000000000000000000000000
--------D-------000000000000000000000000000000000000000000000000000000000000000000000000
------XXXX------000000000000000000000000000000000000000000000000000000000000000000000000
----------------000000000000000000000000000000000000000000000000000000000000000000000000
---------TTT----000000000000000000000000000000000000000000000000000000000000000000000000
----------------000000000000000000000000000000000000000000000000000000000000000000000000
X-----------TTTT000000000000000000000000000000000000000000000000000000000000000000000000
X--------------X000000000000000000000000000000000000000000000000000000000000000000000000
X--------------X000000000000000000000000000000000000000000000000000000000000000000000000
XXXXXXXXX------X000000000000000000000000000000000000000000000000000000000000000000000000
XX-------------X000000000000000000000000000000000000000000000000000000000000000000000000
XX--------TTTTTT000000000000000000000000000000000000000000000000000000000000000000000000
XD-------------X000000000000000000000000000000000000000000000000000000000000000000000000
XD-------------X000000000000000000000000000000000000000000000000000000000000000000000000
XXXXX-------XXXX000000000000000000000000000000000000000000000000000000000000000000000000
XXXXXXXXXXXXXXXX000000000000000000000000000000000000000000000000000000000000000000000000
----------------000000000000000000000000000000000000000000000000000000000000000000000000
----XXXX--------000000000000000000000000000000000000000000000000000000000000000000000000
----------------000000000000000000000000000000000000000000000000000000000000000000000000
XXXX----------XX000000000000000000000000000000000000000000000000000000000000000000000000
--------------DX000000000000000000000000000000000000000000000000000000000000000000000000
--------------DX000000000000000000000000000000000000000000000000000000000000000000000000
X-----XXXXXXXXXX000000000000000000000000000000000000000000000000000000000000000000000000
X-----XXXXXXXXXX000000000000000000000000000000000000000000000000000000000000000000000000
XXXX----XXXX----000000000000000000000000000000000000000000000000000000000000000000000000
---X-X----------000000000000000000000000000000000000000000000000000000000000000000000000
---X------------000000000000000000000000000000000000000000000000000000000000000000000000
XXX-----------XX000000000000000000000000000000000000000000000000000000000000000000000000
XXXXXXXXXX----XX000000000000000000000000000000000000000000000000000000000000000000000000
XX------------XX000000000000000000000000000000000000000000000000000000000000000000000000
XX------------XX000000000000000000000000000000000000000000000000000000000000000000000000
XX----XXXXXXXXXX000000000000000000000000000000000000000000000000000000000000000000000000
XD------------XX000000000000000000000000000000000000000000000000000000000000000000000000
XD------------XX000000000000000000000000000000000000000000000000000000000000000000000000
XXXXX-------XXXX000000000000000000000000000000000000000000000000000000000000000000000000
XXXXXXXXXXXXXXXX000000000000000000000000000000000000000000000000000000000000000000000000
XX----------XXXX000000000000000000000000000000000000000000000000000000000000000000000000
XXXXXXXEEXXXXX--000000000000000000000000000000000000000000000000000000000000000000000000
XXXX------XXXX--000000000000000000000000000000000000000000000000000000000000000000000000
XXXX------XXXX--000000000000000000000000000000000000000000000000000000000000000000000000
XXXX------XXXX--000000000000000000000000000000000000000000000000000000000000000000000000
XXXX------XXXX--000000000000000000000000000000000000000000000000000000000000000000000000
XXXX------XXXX--000000000000000000000000000000000000000000000000000000000000000000000000
XXXX------XXXX--000000000000000000000000000000000000000000000000000000000000000000000000
XX--------XXXX--000000000000000000000000000000000000000000000000000000000000000000000000
XX-------XXXX---000000000000000000000000000000000000000000000000000000000000000000000000
XX----------XXXX000000000000000000000000000000000000000000000000000000000000000000000000
XXXX--------XXXX000000000000000000000000000000000000000000000000000000000000000000000000
XX--TT------XXXX000000000000000000000000000000000000000000000000000000000000000000000000
XX----------XXXX000000000000000000000000000000000000000000000000000000000000000000000000
XX-----------XXX000000000000000000000000000000000000000000000000000000000000000000000000
XX----XXXXXXXXXX000000000000000000000000000000000000000000000000000000000000000000000000
XD-------------X000000000000000000000000000000000000000000000000000000000000000000000000
XD------------DX000000000000000000000000000000000000000000000000000000000000000000000000
XXXXX-------XXXX000000000000000000000000000000000000000000000000000000000000000000000000
XXXXXXXXXXXXXXXX000000000000000000000000000000000000000000000000000000000000000000000000
----------------000000000000000000000000000000000000000000000000000000000000000000000000
----------------000000000000000000000000000000000000000000000000000000000000000000000000
----------------000000000000000000000000000000000000000000000000000000000000000000000000
-----TT--TT-----000000000000000000000000000000000000000000000000000000000000000000000000
----------------000000000000000000000000000000000000000000000000000000000000000000000000
----------------000000000000000000000000000000000000000000000000000000000000000000000000
--------TTTT----000000000000000000000000000000000000000000000000000000000000000000000000
----------------000000000000000000000000000000000000000000000000000000000000000000000000
--TTTTTTTT------000000000000000000000000000000000000000000000000000000000000000000000000
----------------000000000000000000000000000000000000000000000000000000000000000000000000
----------------000000000000000000000000000000000000000000000000000000000000000000000000
-TTTT-------XXXX000000000000000000000000000000000000000000000000000000000000000000000000
------------X---000000000000000000000000000000000000000000000000000000000000000000000000
----------------000000000000000000000000000000000000000000000000000000000000000000000000
XX-----------XXX000000000000000000000000000000000000000000000000000000000000000000000000
XX----XXXXXXXXXX000000000000000000000000000000000000000000000000000000000000000000000000
XD------------XX000000000000000000000000000000000000000000000000000000000000000000000000
XD------------XX000000000000000000000000000000000000000000000000000000000000000000000000
XXXXX-------XXXX000000000000000000000000000000000000000000000000000000000000000000000000
XXXXXXXXXXXXXXXX000000000000000000000000000000000000000000000000000000000000000000000000