000000000000000000000000000000000000000000000000000000000000000000000000000XXXX------XXXX--
000000000000000000000000000000000000000000000000000000000000000000000000000XXXX------XXXX--
000000000000000000000000000000000000000000000000000000000000000000000000000XXXX------XXXX--
000000000000000000000000000000000000000000000000000000000000000000000000000XXXX------XXXX--
000000000000000000000000000000000000000000000000000000000000000000000000000XXXX------XXXX--
000000000000000000000000000000000000000000000000000000000000000000000000000XXXX------XXXX--
000000000000000000000000000000000000000000000000000000000000000000000000000XXXX------XXXX--
000000000000000000000000000000000000000000000000000000000000000000000000000XXXX------XXXX--
000000000000000000000000000000000000000000000000000000000000000000000000000XXXX------XXXX--
000000000000000000000000000000000000000000000000000000000000000000000000000XXXX------XXXX--
000000000000000000000000000000000000000000000000000000000000000000000000000XXXX------XXXX--
000000000000000000000000000000000000000000000000000000000000000000000000000XXXX------XXXX--
000000000000000000000000000000000000000000000000000000000000000000000000000XXXX------XXXX--
000000000000000000000000000000000000000000000000000000000000000000000000000XXXX------XXXX--
000000000000000000000000000000000000000000000000000000000000000000000000000XXXX------XXXX--
000000000000000000000000000000000000000000000000000000000000000000000000000XXXX------XXXX--
000000000000000000000000000000000000000000000000000000000000000000000000000XXXX------XXXX--
000000000000000000000000000000000000000000000000000000000000000000000000000XXXX------XXXX--
000000000000000000000000000000000000000000000000000000000000000000000000000XXXX------XXXX--
000000000000000000000000000000000000000000000000000000000000000000000000000XXXX------XXXX--
000000000000000000000000000000000000000000000000000000000000000000000000000XXXX------XXXX--
000000000000000000000000000000000000000000000000000000000000000000000000000XXXX------XXXX--
000000000000000000000000000000000000000000000000000000000000000000000000000XXXX------XXXX--
000000000000000000000000000000000000000000000000000000000000000000000000000XXXX------XXXX--
000000000000000000000000000000000000000000000000000000000000000000000000000XXXX------XXXX--
000000000000000000000000000000000000000000000000000000000000000000000000000XXXX------XXXX--
000000000000000000000000000000000000000000000000000000000000000000000000000XXXX------XXXX--
000000000000000000000000000000000000000000000000000000000000000000000000000XXXX------XXXX--
000000000000000000000000000000000000000000000000000000000000000000000000000XXXX------XXXX--
000000000000000000000000000000000000000000000000000000000000000000000000000XXXX------XXXX--
000000000000000000000000000000000000000000000000000000000000000000000000000XXXX------XXXX--
000000000000000000000000000000000000000000000000000000000000000000000000000XXXX------XXXX--
000000000000000000000000000000000000000000000000000000000000000000000000000XXXX------XXXX--
000000000000000000000000000000000000000000000000000000000000000000000000000XXXX------XXXX--
000000000000000000000000000000000000000000000000000000000000000000000000000XXXX------XXXX--
000000000000000000000000000000000000000000000000000000000000000000000000000XXXX------XXXX--
000000000000000000000000000000000000000000000000000000000000000000000000000XXXX------XXXX--
000000000000000000000000000000000000000000000000000000000000000000000000000XXXX------XXXX--
000000000000000000000000000000000000000000000000000000000000000000000000000XXXX------XXXX--
000000000000000000000000000000000000000000000000000000000000000000000000000XXXX------XXXX--
000000000000000000000000000000000000000000000000000000000000000000000000000XXXX------XXXX--
000000000000000000000000000000000000000000000000000000000000000000000000000XXXX------XXXX--
000000000000000000000000000000000000000000000000000000000000000000000000000XXXX------XXXX--
000000000000000000000000000000000000000000000000000000000000000000000000000XXXX------XXXX--
000000000000000000000000000000000000000000000000000000000000000000000000000XXXX------XXXX--
000000000000000000000000000000000000000000000000000000000000000000000000000XXXX------XXXX--
000000000000000000000000000000000000000000000000000000000000000000000000000XXXX------XXXX--
000000000000000000000000000000000000000000000000000000000000000000000000000XXXX------XXXX--
000000000000000000000000000000000000000000000000000000000000000000000000000XXXX------XXXX--
000000000000000000000000000000000000000000000000000000000000000000000000000XXXX------XXXX--
000000000000000000000000000000000000000000000000000000000000000000000000000XXXX------XXXX--
000000000000000000000000000000000000000000000000000000000000000000000000000XXXX------XXXX--
000000000000000000000000000000000000000000000000000000000000000000000000000XXXX------XXXX--
000000000000000000000000000000000000000000000000000000000000000000000000000XXXX------XXXX--
000000000000000000000000000000000000000000000000000000000000000000000000000XXXX------XXXX--
000000000000000000000000000000000000000000000000000000000000000000000000000XXXX------XXXX--
000000000000000000000000000000000000000000000000000000000000000000000000000XXXX------XXXX--
000000000000000000000000000000000000000000000000000000000000000000000000000XXXX------XXXX--
000000000000000000000000000000000000000000000000000000000000000000000000000XXXX------XXXX--
000000000000000000000000000000000000000000000000000000000000000000000000000XXXX------XXXX--
000000000000000000000000000000000000000000000000000000000000000000000000000XXXX------XXXX--
000000000000000000000000000000000000000000000000000000000000000000000000000XXXX------XXXX--
000000000000000000000000000000000000000000000000000000000000000000000000000XXXX------XXXX--
000000000000000000000000000000000000000000000000000000000000000000000000000XXXX------XXXX--
000000000000000000000000000000000000000000000000000000000000000000000000000XXXX------XXXX--
000000000000000000000000000000000000000000000000000000000000000000000000000XXXX------XXXX--
000000000000000000000000000000000000000000000000000000000000000000000000000XXXX------XXXX--
000000000000000000000000000000000000000000000000000000000000000000000000000XXXX------XXXX--
000000000000000000000000000000000000000000000000000000000000000000000000000XXXX------XXXX--
000000000000000000000000000000000000000000000000000000000000000000000000000XXXX------XXXX--
000000000000000000000000000000000000000000000000000000000000000000000000000XXXX------XXXX--
000000000000000000000000000000000000000000000000000000000000000000000000000XXXX------XXXX--
000000000000000000000000000000000000000000000000000000000000000000000000000XXXX------XXXX--
000000000000000000000000000000000000000000000000000000000000000000000000000XXXX------XXXX--
000000000000000000000000000000000000000000000000000000000000000000000000000XXXX------XXXX--
000000000000000000000000000000000000000000000000000000000000000000000000000XXXX------XXXX--
000000000000000000000000000000000000000000000000000000000000000000000000000XXXX------XXXX--
000000000000000000000000000000000000000000000000000000000000000000000000000XXXX------XXXX--
000000000000000000000000000000000000000000000000000000000000000000000000000XXXX------XXXX--
000000000000000000000000000000000000000000000000000000000000000000000000000XXXX------XXXX--
000000000000000000000000000000000000000000000000000000000000000000000000000XXXX------XXXX--
000000000000000000000000000000000000000000000000000000000000000000000000000XXXX------XXXX--
000000000000000000000000000000000000000000000000000000000000000000000000000XXXX------XXXX--
000000000000000000000000000000000000000000000000000000000000000000000000000XXXX------XXXX--
000000000000000000000000000000000000000000000000000000000000000000000000000XXXX------XXXX--
000000000000000000000000000000000000000000000000000000000000000000000000000XXXX------XXXX--
000000000000000000000000000000000000000000000000000000000000000000000000000XXXX------XXXX--
000000000000000000000000000000000000000000000000000000000000000000000000000XXXX------XXXX--
000000000000000000000000000000000000000000000000000000000000000000000000000XXXX------XXXX--
000000000000000000000000000000000000000000000000000000000000000000000000000XXXX------XXXX--
000000000000000000000000000000000000000000000000000000000000000000000000000XXXX------XXXX--
000000000000000000000000000000000000000000000000000000000000000000000000000XXXX------XXXX--
000000000000000000000000000000000000000000000000000000000000000000000000000XXXX------XXXX--
000000000000000000000000000000000000000000000000000000000000000000000000000XXXX------XXXX--
000000000000000000000000000000000000000000000000000000000000000000000000000XXXX------XXXX--
000000000000000000000000000000000000000000000000000000000000000000000000000XXXX------XXXX--
000000000000000000000000000000000000000000000000000000000000000000000000000XXXX------XXXX--
000000000000000000000000000000000000000000000000000000000000000000000000000XXXX------XXXX--
000000000000000000000000000000000000000000000000000000000000000000000000000XXXX------XXXX--
000000000000000000000000000000000000000000000000000000000000000000000000000XXXX------XXXX--
000000000000000000000000000000000000000000000000000000000000000000000000000XXXX--XXXXXXXX--
000000000000000000000000000000000000000000000000000000000000000000000000000XXXX--------XXXX
000000000000000000000000000000000000000000000000000000000000000000000000000XXXX--------XXXX
000000000000000000000000000000000000000000000000000000000000000000000000000XXXX--------XXXX
000000000000000000000000000000000000000000000000000000000000000000000000000XXXX--------XXXX
000000000000000000000000000000000000000000000000000000000000000000000000000XXXX--------XXXX
000000000000000000000000000000000000000000000000000000000000000000000000000XXXX--------XXXX
000000000000000000000000000000000000000000000000000000000000000000000000000XXXX--------XXXX
000000000000000000000000000000000000000000000000000000000000000000000000000XXXX--------XXXX
000000000000000000000000000000000000000000000000000000000000000000000000000XXXX--------XXXX
000000000000000000000000000000000000000000000000000000000000000000000000000XXXX--------XXXX
000000000000000000000000000000000000000000000000000000000000000000000000000XXXX---------XXX
000000000000000000000000000000000000000000000000000000000000000000000000000XX------------XX
000000000000000000000000000000000000000000000000000000000000000000000000000XTTTT--XXXX---XX
000000000000000000000000000000000000000000000000000000000000000000000000000------XX--------
000000000000000000000000000000000000000000000000000000000000000000000000000---XXXXXE-------
000000000000000000000000000000000000000000000000000000000000000000000000000---XXXXX--------
000000000000000000000000000000000000000000000000000000000000000000000000000---X------------
000000000000000000000000000000000000000000000000000000000000000000000000000XXXX----------XX
000000000000000000000000000000000000000000000000000000000000000000000000000XXX-----------XX
000000000000000000000000000000000000000000000000000000000000000000000000000XXXXXXXXXX----XX
000000000000000000000000000000000000000000000000000000000000000000000000000XX------------XX
000000000000000000000000000000000000000000000000000000000000000000000000000XX------------XX
000000000000000000000000000000000000000000000000000000000000000000000000000XX------XXXXXXXX
000000000000000000000000000000000000000000000000000000000000000000000000000XXXX--------XXXX
000000000000000000000000000000000000000000000000000000000000000000000000000XXXX--------XXXX
000000000000000000000000000000000000000000000000000000000000000000000000000XXXX--------XXXX
000000000000000000000000000000000000000000000000000000000000000000000000000XXXX--------XXXX
000000000000000000000000000000000000000000000000000000000000000000000000000XXTTTT------XXXX
000000000000000000000000000000000000000000000000000000000000000000000000000XX-----------XXX
000000000000000000000000000000000000000000000000000000000000000000000000000----------------
000000000000000000000000000000000000000000000000000000000000000000000000000--------TTTT----
000000000000000000000000000000000000000000000000000000000000000000000000000----------------
000000000000000000000000000000000000000000000000000000000000000000000000000--TTTTTTTT------
000000000000000000000000000000000000000000000000000000000000000000000000000----------------
0000000000000000000000000000000000000000000000000000000-0000000000000000000----------------
0000000000000000000000000000000000000000000000000000000-0000000000000000000----------------
0000000000000000000000000000000000000000000000000000000-0000000000000000----------------X--
0000000000000000000000000000000000000000000000000000000-0000000000000000---0000000000000000
0000000000000000000000000000000000000000000000000000000-0000000000000000---0000000000000000
0000000000000000000000000000000000000000000000000000000-0000000000000000---0000000000000000
0000000000000000000000000000000000000000000000000000000-0000000000000000---0000000000000000
0000000000000000000000000000000000000000000000000000000-0000000000000000---0000000000000000
0000000000000000000000000000000000000000000000000000000-0000000000000000---0000000000000000
0000000000000000000000000000000000000000000000000000000-0000000000000000---0000000000000000
0000000000000000000000000000000000000000000000000000000-0000000000000000---0000000000000000
0000000000000000000000000000000000000000000000000000000-----------------X--0000000000000000
000000000000000000000000000000000000000XXXX--------XXXX-------XXXX------X--0000000000000000
000000000000000000000000000000000000000---------------------------------X--0000000000000000
000000000000000000000000000000000000000----------------E---TTTT---------X--0000000000000000
000000000000000000000000000000000000000MMMMMMMMMMMMMMMM-0000000000000000X--0000000000000000
000000000000000000000000000000000000000XMMMMMMMMMMMMMMM00000000000000000X--0000000000000000
000000000000000000000000000000000000000----------------00000000000000000X--0000000000000000
000000000000000000000000000000000000000----E--------E--000000000000000000000000000000000000
000000000000000000000000000000000000000MMMMMMMMMMMMMMMM000000000000000000000000000000000000
000000000000000000000000000000000000000----------------000000000000000000000000000000000000
000000000000000000000000000000000000000----------------000000000000000000000000000000000000
000000000000000000000000000000000000000MMMMMMMMMMMMMMMM000000000000000000000000000000000000
000000000000000000000000000000000000000XMMMMMMMMMMMMMMM000000000000000000000000000000000000
000000000000000000000000000000000000000----------------000000000000000000000000000000000000
000000000000000000000000000000000000000----E--------E--000000000000000000000000000000000000
---------------------------------------MMMMMMMMMMMMMMMM000000000000000000000000000000000000
---------------------------------------0000000000000000000000000000000000000000000000000000
---------------------------------------0000000000000000000000000000000000000000000000000000
---------------------------------------0000000000000000000000000000000000000000000000000000
---------------------------------------0000000000000000000000000000000000000000000000000000
---------------------------------------0000000000000000000000000000000000000000000000000000
---------------------------------------0000000000000000000000000000000000000000000000000000
---------------------------------------0000000000000000000000000000000000000000000000000000
---------------------------------------0000000000000000000000000000000000000000000000000000
---------------------------------------0000000000000000000000000000000000000000000000000000
---------------------------------------0000000000000000000000000000000000000000000000000000
---------------------------------------0000000000000000000000000000000000000000000000000000
---------------------------------------0000000000000000000000000000000000000000000000000000
---------------------------E-----------0000000000000000000000000000000000000000000000000000
-----------E--------------E------E-----0000000000000000000000000000000000000000000000000000
XXXXX---XXXXXXXXXXXXXXXXXXXXXXXXXXXX---0000000000000000000000000000000000000000000000000000
0000000000000000000000000000000000000000000000000000000000000000000000000000000000000000000