0000000000000000000000000000000000000000000000000000000000000000000000000000000000000000000000000000000000000000--------------XX
0000000000000000000000000000000000000000000000000000000000000000000000000000000000000000000000000000000000000000---XXXX-------XX
0000000000000000000000000000000000000000000000000000000000000000000000000000000000000000000000000000000000000000-----XX-------XX
0000000000000000000000000000000000000000000000000000000000000000000000000000000000000000000000000000000000000000-----XXXXX----XX
0000000000000000000000000000000000000000000000000000000000000000000000000000000000000000000000000000000000000000----------------
0000000000000000000000000000000000000000000000000000000000000000000000000000000000000000000000000000000000000000----------------
0000000000000000000000000000000000000000000000000000000000000000000000000000000000000000000000000000000000000000---------XXXX---
0000000000000000000000000000000000000000000000000000000000000000000000000000000000000000000000000000000000000000----------------
0000000000000000000000000000000000000000000000000000000000000000000000000000000000000000000000000000000000000000----------------
0000000000000000000000000000000000000000000000000000000000000000000000000000000000000000000000000000000000000000MMMMMMMMMMMMMMMM
0000000000000000000000000000000000000000000000000000000000000000000000000000000000000000000000000000000000000000----------------
0000000000000000000000000000000000000000000000000000000000000000000000000000000000000000000000000000000000000000----------------
0000000000000000000000000000000000000000000000000000000000000000000000000000000000000000000000000000000000000000XX----------XXXX
0000000000000000000000000000000000000000000000000000000000000000000000000000000000000000000000000000000000000000XX--------------
0000000000000000000000000000000000000000000000000000000000000000000000000000000000000000000000000000000000000000XX--------------
0000000000000000000000000000000000000000000000000000000000000000000000000000000000000000000000000000000000000000XX--------TTT---
0000000000000000000000000000000000000000000000000000000000000000000000000000000000000000000000000000000000000000XD--------------
0000000000000000000000000000000000000000000000000000000000000000000000000000000000000000000000000000000000000000XD-------------X
0000000000000000000000000000000000000000000000000000000000000000000000000000000000000000000000000000000000000000XXXXX-------XXXX
0000000000000000000000000000000000000000000000000000000000000000000000000000000000000000000000000000000000000000XXXXXXXXXXXXXXXX
0000000000000000000000000000000000000000000000000000000000000000000000000000000000000000000000000000000000000000----------------
0000000000000000000000000000000000000000000000000000000000000000000000000000000000000000000000000000000000000000-----T----------
0000000000000000000000000000000000000000000000000000000000000000000000000000000000000000000000000000000000000000----------------
0000000000000000000000000000000000000000000000000000000000000000000000000000000000000000000000000000000000000000----------------
0000000000000000000000000000000000000000000000000000000000000000000000000000000000000000000000000000000000000000--------TTT-----
0000000000000000000000000000000000000000000000000000000000000000000000000000000000000000000000000000000000000000----------------
0000000000000000000000000000000000000000000000000000000000000000000000000000000000000000000000000000000000000000----------------
0000000000000000000000000000000000000000000000000000000000000000000000000000000000000000000000000000000000000000----------------
0000000000000000000000000000000000000000000000000000000000000000000000000000000000000000000000000000000000000000------TTTT------
0000000000000000000000000000000000000000000000000000000000000000000000000000000000000000000000000000000000000000----------------
0000000000000000000000000000000000000000000000000000000000000000000000000000000000000000000000000000000000000000--------XXXX----
0000000000000000000000000000000000000000000000000000000000000000000000000000000000000000000000000000000000000000-------XXXXX----
0000000000000000000000000000000000000000000000000000000000000000000000000000000000000000000000000000000000000000XX----------XXXX
0000000000000000000000000000000000000000000000000000------------------------------------------------------------XX--------------
0000000000000000000000000000000000000000000000000000------------------------------------------------------------XX--------------
0000000000000000000000000000000000000000000000000000------------------------------------------------------------XX--------TTT---
000000000000000000000000000000000000------XXXXXXXX-X------------------------------------------------------------XD--------------
000000000000000000000000000000000000----------------S-------------------S-------------------S-------------------XD-------------X
000000000000000000000000000000000000------------XX--S-------------------S-------------------S-------------------XXXXX-------XXXX
000000000000000000000000000000000000----XXXX---XXXX-S-------------X-----S-------------------S------------EooooooXXXXXXXXXXXXXXXX
000000000000000000000000000000000000XXXX------XXXX--S------------XXXXXXXS-------------------S------------XXXXXXX0000000000000000
000000000000000000000000000000000000XXXX-----TTTTTTTS-----------XXXXXXXXS-------------------S-------------------0000000000000000
000000000000000000000000000000000000XXXX--------XXXXS-----------XXXXXXXXS-------------------S-------------------0000000000000000
000000000000000000000000000000000000XXXX--------XXXXS-----------XXXXXXXXS-------------------S-------------------0000000000000000
000000000000000000000000000000000000XX------------XXS---------X-XXXXXXXXS---XXXXXXXXXXXXXXXXS-XXXXXXXXXXXXXXXXXX0000000000000000
000000000000000000000000000000000000XX-----XXXX---DXS---------X--XXXXXXXS-------------------S-------------------0000000000000000
000000000000000000000000000000000000XX------------DXS--------XX---XXXXXXS-------------------S-------------------0000000000000000
000000000000000000000000000000000000XXXX--------XXXXS------XXXX---XXXXXXS-------------------S-------------------0000000000000000
000000000000000000000000000000000000XXXXXX------XXXXXXXXXXXXXXXXXXXXXXXXXXXX----------------XX------------------0000000000000000
000000000000000000000000000000000000XXXX--------XXXX0000000000000000000000000000000000000000000000000000000000000000000000000000
000000000000000000000000000000000000XX-----------XXX0000000000000000000000000000000000000000000000000000000000000000000000000000
000000000000000000000000000000000000XX-----TTTTTTTTT0000000000000000000000000000000000000000000000000000000000000000000000000000
000000000000000000000000000000000000XD-------------X0000000000000000000000000000000000000000000000000000000000000000000000000000
000000000000000000000000000000000000XD------------DX0000000000000000000000000000000000000000000000000000000000000000000000000000
000000000000000000000000000000000000XXXXX-------XXXX0000000000000000000000000000000000000000000000000000000000000000000000000000
000000000000000000000000000000000000XXXXXXXXXXXXXXXX0000000000000000000000000000000000000000000000000000000000000000000000000000
000000000000000000000000000000000000----------XXXX--0000000000000000000000000000000000000000000000000000000000000000000000000000
000000000000000000000000000000000000----------XXXX--0000000000000000000000000000000000000000000000000000000000000000000000000000
000000000000000000000000000000000000----------XXXX--0000000000000000000000000000000000000000000000000000000000000000000000000000
000000000000000000000000000000000000----------XXXX--0000000000000000000000000000000000000000000000000000000000000000000000000000
000000000000000000000000000000000000----------XXXX--0000000000000000000000000000000000000000000000000000000000000000000000000000
000000000000000000000000000000000000----------XXXX--0000000000000000000000000000000000000000000000000000000000000000000000000000
000000000000000000000000000000000000----------XXXX--0000000000000000000000000000000000000000000000000000000000000000000000000000
000000000000000000000000000000000000-------XXXXXX---0000000000000000000000000000000000000000000000000000000000000000000000000000
000000000000000000000000000000000000-------XXXXX----0000000000000000000000000000000000000000000000000000000000000000000000000000
000000000000000000000000000000000000XX----------XXXX0000000000000000000000000000000000000000000000000000000000000000000000000000
000000000000000000000000000000000000XX--------------0000000000000000000000000000000000000000000000000000000000000000000000000000
000000000000000000000000000000000000XX--------------0000000000000000000000000000000000000000000000000000000000000000000000000000
000000000000000000000000000000000000XXD---------TTTT0000000000000000000000000000000000000000000000000000000000000000000000000000
000000000000000000000000000000000000XX--------------0000000000000000000000000000000000000000000000000000000000000000000000000000
000000000000000000000000000000000000XX--------------0000000000000000000000000000000000000000000000000000000000000000000000000000
000000000000000000000000000000000000XX--------TTT---0000000000000000000000000000000000000000000000000000000000000000000000000000
000000000000000000000000000000000000XD--------------0000000000000000000000000000000000000000000000000000000000000000000000000000
000000000000000000000000000000000000XD-------------X0000000000000000000000000000000000000000000000000000000000000000000000000000
000000000000000000000000000000000000XXXXX-------XXXX0000000000000000000000000000000000000000000000000000000000000000000000000000
000000000000000000000000000000000000XXXXXXXXXXXXXXXX0000000000000000000000000000000000000000000000000000000000000000000000000000
000000000000000000000000000000000000----------------0000000000000000000000000000000000000000000000000000000000000000000000000000
000000000000000000000000000000000000----------------0000000000000000000000000000000000000000000000000000000000000000000000000000
000000000000000000000000000000000000---------TTT----0000000000000000000000000000000000000000000000000000000000000000000000000000
000000000000000000000000000000000000----------------0000000000000000000000000000000000000000000000000000000000000000000000000000
000000000000000000000000000000000000X-----------TTTT0000000000000000000000000000000000000000000000000000000000000000000000000000
000000000000000000000000000000000000X--------------X0000000000000000000000000000000000000000000000000000000000000000000000000000
000000000000000000000000000000000000X--------------X0000000000000000000000000000000000000000000000000000000000000000000000000000
0000000000000000--------------------X-----TTTT-----X0000000000000000000000000000000000000000000000000000000000000000000000000000
0000000000000000--------------------X----------T-XXX0000000000000000000000000000000000000000000000000000000000000000000000000000
0000000000000000--------------------X---------------0000000000000000000000000000000000000000000000000000000000000000000000000000
0000000000000000--------------------X---------------0000000000000000000000000000000000000000000000000000000000000000000000000000
---------XX-----S-------------------X---------------0000000000000000000000000000000000000000000000000000000000000000000000000000
------XXXXX-----S-------------------XXXXX-----------0000000000000000000000000000000000000000000000000000000000000000000000000000
------XX--------S-------------------XX--------------0000000000000000000000000000000000000000000000000000000000000000000000000000
---XXXXX--------S----------SS-------XX--------------0000000000000000000000000000000000000000000000000000000000000000000000000000
---XX-----------S-------------------XX--------TTT---0000000000000000000000000000000000000000000000000000000000000000000000000000
XXXX---------XXXS-------------------XD--------------0000000000000000000000000000000000000000000000000000000000000000000000000000
--------------DXS-------------------XD-------------X0000000000000000000000000000000000000000000000000000000000000000000000000000
----------TT---XS----------SS-------XXXXX-------XXXX0000000000000000000000000000000000000000000000000000000000000000000000000000
--------------DXS----------E-------<XXXXXXXXXXXXXXXX0000000000000000000000000000000000000000000000000000000000000000000000000000
X-------------DXS------------------[00000000000000000000000000000000000000000000000000000000000000000000000000000000000000000000
X----------XXXXXS------------------[00000000000000000000000000000000000000000000000000000000000000000000000000000000000000000000
X---------XXXXXXXXXXXXXXXXXXXXXXXXXX00000000000000000000000000000000000000000000000000000000000000000000000000000000000000000000
XXXX-----TTTTTTT0000000000000000000000000000000000000000000000000000000000000000000000000000000000000000000000000000000000000000
XXXX--------XXXX0000000000000000000000000000000000000000000000000000000000000000000000000000000000000000000000000000000000000000
XX------------XX0000000000000000000000000000000000000000000000000000000000000000000000000000000000000000000000000000000000000000
XX--------XXXXXX0000000000000000000000000000000000000000000000000000000000000000000000000000000000000000000000000000000000000000
XD------------XX0000000000000000000000000000000000000000000000000000000000000000000000000000000000000000000000000000000000000000
XD------------DX0000000000000000000000000000000000000000000000000000000000000000000000000000000000000000000000000000000000000000
XXXXX-------XXXX0000000000000000000000000000000000000000000000000000000000000000000000000000000000000000000000000000000000000000
XXXXXXXXXXXXXXXX0000000000000000000000000000000000000000000000000000000000000000000000000000000000000000000000000000000000000000