0000000000000000000000000000000000000000000000000000--------------------000000000000000
0000000000000000000000000000000000000000000000000000--------------------000000000000000
0000000000000000000000000000000000000000000000000000--------------------000000000000000
0000000000000000000000000000000000000000000000000000--------------------000000000000000
000000000000000000000000000000000000-XXXX------XXXX-S-------------------000000000000000
000000000000000000000000000000000000-XXXX------XXXX-S-------------------000000000000000
000000000000000000000000000000000000-XXXX----EXXXXX-S-------------------000000000000000
000000000000000000000000000000000000XX----------XXXXS-------------------000000000000000
000000000000000000000000000000000000XX--------------S--XXXXXX--ooooo----000000000000000
000000000000000000000000000000000000XX----------XXXXS---------X---------000000000000000
000000000000000000000000000000000000XX----------XXXXS-------------------000000000000000
000000000000000000000000000000000000XXXXXXXXE---XXXXS-X-----------------000000000000000
000000000000000000000000000000000000XXXX------XXXXXXS-X-----------------000000000000000
000000000000000000000000000000000000XXXX------XXXX--S-------------------000000000000000
000000000000000000000000000000000000XXXXE-EXXXXXXX--S-------------------000000000000000
000000000000000000000000000000000000XX---------XXXX-XX-----XXXXXXXXXXXXX000000000000000
000000000000000000000000000000000000XX----------XXXX00000000000000000000000000000000000
000000000000000000000000000000000000XX------------XX00000000000000000000000000000000000
000000000000000000000000000000000000XX--------------00000000000000000000000000000000000
000000000000000000000000000000000000XX--------TTTTTT00000000000000000000000000000000000
000000000000000000000000000000000000XD--------------00000000000000000000000000000000000
000000000000000000000000000000000000XD-------------X00000000000000000000000000000000000
000000000000000000000000000000000000XXXXX-------XXXX00000000000000000000000000000000000
000000000000000000000000000000000000XXXXXXXXXXXXXXXX00000000000000000000000000000000000
000000000000000000000000000000000000XXTTTT------XXXX00000000000000000000000000000000000
000000000000000000000000000000000000XXXX--------XXXX00000000000000000000000000000000000
000000000000000000000000000000000000XXXX--------XXXX00000000000000000000000000000000000
000000000000000000000000000000000000XXXXX-------XXXX00000000000000000000000000000000000
000000000000000000000000000000000000X---------XXXXXX00000000000000000000000000000000000
000000000000000000000000000000000000X---------XXXXXX00000000000000000000000000000000000
000000000000000000000000000000000000X-----------XXXX00000000000000000000000000000000000
000000000000000000000000000000000000X-------------XX00000000000000000000000000000000000
000000000000000000000000000000000000X-------------XX00000000000000000000000000000000000
000000000000000000000000000000000000X-------------XX00000000000000000000000000000000000
000000000000000000000000000000000000XXXX----------XX00000000000000000000000000000000000
000000000000000000000000000000000000XXXXXXXX------XX00000000000000000000000000000000000
000000000000000000000000000000000000XXXXXXXXXX----XX00000000000000000000000000000000000
000000000000000000000000000000000000XX------------XX00000000000000000000000000000000000
000000000000000000000000000000000000XX------------XX00000000000000000000000000000000000
000000000000000000000000000000000000XX----XXXXXXXXXX00000000000000000000000000000000000
000000000000000000000000000000000000XD------------XX00000000000000000000000000000000000
000000000000000000000000000000000000XD------------XX00000000000000000000000000000000000
000000000000000000000000000000000000XXXXX-------XXXX00000000000000000000000000000000000
000000000000000000000000000000000000XXXXXXXXXXXXXXXX00000000000000000000000000000000000
000000000000000000000000000000000000----------------00000000000000000000000000000000000
000000000000000000000000000000000000--E--------E----00000000000000000000000000000000000
000000000000000000000000000000000000MMMMMMMMMMMMMMMM00000000000000000000000000000000000
000000000000000000000000000000000000----------------00000000000000000000000000000000000
000000000000000000000000000000000000----------------00000000000000000000000000000000000
000000000000000000000000000000000000-------TT-------00000000000000000000000000000000000
000000000000000000000000000000000000----------------00000000000000000000000000000000000
000000000000000000000000000000000000----------------00000000000000000000000000000000000
000000000000000000000000000000000000-----------TTTT-00000000000000000000000000000000000
000000000000000000000000000000000000----------------00000000000000000000000000000000000
000000000000000000000000000000000000----------------00000000000000000000000000000000000
000000000000000000000000000000000000-TTTTTTTT-------00000000000000000000000000000000000
000000000000000000000000000000000000----------------00000000000000000000000000000000000
000000000000000000000000000000000000----------------00000000000000000000000000000000000
000000000000000000000000000000000000XX-----------XXX00000000000000000000000000000000000
000000000000000000000000000000000000XX----XXXXXXXXXX00000000000000000000000000000000000
000000000000000000000000000000000000XD------------XX00000000000000000000000000000000000
000000000000000000000000000000000000XD------------XX00000000000000000000000000000000000
000000000000000000000000000000000000XXXXX-------XXXX00000000000000000000000000000000000
000000000000000000000000000000000000XXXXXXXXXXXXXXXX00000000000000000000000000000000000
000000000000000000000000000000000000--------TTTT----00000000000000000000000000000000000
000000000000000000000000000000000000----------------00000000000000000000000000000000000
000000000000000000000000000000000000--TTTTTTTT------00000000000000000000000000000000000
000000000000000000000000000000000000----------------00000000000000000000000000000000000
000000000000000000000000000000000000----------------00000000000000000000000000000000000
000000000000000000000000000000000000----------------00000000000000000000000000000000000
000000000000000000000000000000000000XXXXXXXX-------X00000000000000000000000000000000000
000000000000000000000000000000000000----------------00000000000000000000000000000000000
0000000000000000------------------------------TTTT--00000000000000000000000000000000000
0000000000000000------------------------------------00000000000000000000000000000000000
0000000000000000------------------------------------00000000000000000000000000000000000
0000000000000000------------------------XXXXXXXX----00000000000000000000000000000000000
XX----------XXXXS-----------------------------------00000000000000000000000000000000000
XX----------XXXXS-----------------------------------00000000000000000000000000000000000
XX----------XXXXS-----------------E-XXXX---------XXX00000000000000000000000000000000000
XX--TT------XXXXS-------------------XXXXXXXX-----XXX00000000000000000000000000000000000
XX----------XXXXS-------------------XD-----------TXX00000000000000000000000000000000000
XX----------XXXXS-------------------XD------------XX00000000000000000000000000000000000
XXXXXXXXE--XXXX-S-------------------XXXXX-------XXXX00000000000000000000000000000000000
XXXX------XXXX--S-------X-----XXXXXXXXXXXXXXXXXXXXXX00000000000000000000000000000000000
XXXX------XXXX--S-------X-----------000000000000000000000000000000000000000000000000000
XXXX------XXXX--S---E---X-----------000000000000000000000000000000000000000000000000000
XXXX------XXXX--S----EE-X-----------000000000000000000000000000000000000000000000000000
XXXX------XXXX--XXXXXXXXXXXXXX------000000000000000000000000000000000000000000000000000
XXXX-----XXXXXXX00000000000000000000000000000000000000000000000000000000000000000000000
XXXX--------XXXX00000000000000000000000000000000000000000000000000000000000000000000000
XX------------XX00000000000000000000000000000000000000000000000000000000000000000000000
XX----XXXXX---XX00000000000000000000000000000000000000000000000000000000000000000000000
XD------------XX00000000000000000000000000000000000000000000000000000000000000000000000
XD------------XX00000000000000000000000000000000000000000000000000000000000000000000000
XXXXX-------XXXX00000000000000000000000000000000000000000000000000000000000000000000000
XXXXXXXXXXXXXXXX00000000000000000000000000000000000000000000000000000000000000000000000
----------------00000000000000000000000000000000000000000000000000000000000000000000000
----E--------E--00000000000000000000000000000000000000000000000000000000000000000000000
MMMMMMMMMMMMMMMM00000000000000000000000000000000000000000000000000000000000000000000000
----------------00000000000000000000000000000000000000000000000000000000000000000000000
----------------00000000000000000000000000000000000000000000000000000000000000000000000
MMMMMMMMMMMMMMMM00000000000000000000000000000000000000000000000000000000000000000000000
----------------00000000000000000000000000000000000000000000000000000000000000000000000
----------------00000000000000000000000000000000000000000000000000000000000000000000000
---------TTT----00000000000000000000000000000000000000000000000000000000000000000000000
----------------00000000000000000000000000000000000000000000000000000000000000000000000
X-----------TTTT00000000000000000000000000000000000000000000000000000000000000000000000
X--------------X00000000000000000000000000000000000000000000000000000000000000000000000
X--------------X00000000000000000000000000000000000000000000000000000000000000000000000
XXXXXXXXXXXX---X00000000000000000000000000000000000000000000000000000000000000000000000
XX-------------X00000000000000000000000000000000000000000000000000000000000000000000000
XX--------TTTTTT00000000000000000000000000000000000000000000000000000000000000000000000
XD-------------X00000000000000000000000000000000000000000000000000000000000000000000000
XD-------------X00000000000000000000000000000000000000000000000000000000000000000000000
XXXXX-------XXXX00000000000000000000000000000000000000000000000000000000000000000000000
XXXXXXXXXXXXXXXX00000000000000000000000000000000000000000000000000000000000000000000000
----------------00000000000000000000000000000000000000000000000000000000000000000000000
----------------00000000000000000000000000000000000000000000000000000000000000000000000
-------TT-------00000000000000000000000000000000000000000000000000000000000000000000000
----------------00000000000000000000000000000000000000000000000000000000000000000000000
----------------00000000000000000000000000000000000000000000000000000000000000000000000
X----------TTTT-00000000000000000000000000000000000000000000000000000000000000000000000
X---------------00000000000000000000000000000000000000000000000000000000000000000000000
X---------------00000000000000000000000000000000000000000000000000000000000000000000000
---X------------00000000000000000000000000000000000000000000000000000000000000000000000
---X-X----------00000000000000000000000000000000000000000000000000000000000000000000000
---X------------00000000000000000000000000000000000000000000000000000000000000000000000
XXXX----------XX00000000000000000000000000000000000000000000000000000000000000000000000
XXXXXXXXXX----XX00000000000000000000000000000000000000000000000000000000000000000000000
XXXX----------XX00000000000000000000000000000000000000000000000000000000000000000000000
XX------------XX00000000000000000000000000000000000000000000000000000000000000000000000
XX----XXXXXXXXXX00000000000000000000000000000000000000000000000000000000000000000000000
XD-----------TXX00000000000000000000000000000000000000000000000000000000000000000000000
XD------------XX00000000000000000000000000000000000000000000000000000000000000000000000
XXXXX-------XXXX00000000000000000000000000000000000000000000000000000000000000000000000
XXXXXXXXXXXXXXXX00000000000000000000000000000000000000000000000000000000000000000000000
XXXX--------XXXX00000000000000000000000000000000000000000000000000000000000000000000000
XXXX--------XXXX00000000000000000000000000000000000000000000000000000000000000000000000
XXXXXXX-----XXXX00000000000000000000000000000000000000000000000000000000000000000000000
XXXX--------XXXX00000000000000000000000000000000000000000000000000000000000000000000000
XX------------XX00000000000000000000000000000000000000000000000000000000000000000000000
XX-----XXXX---DX00000000000000000000000000000000000000000000000000000000000000000000000
XX------------DX00000000000000000000000000000000000000000000000000000000000000000000000
XXXX--------XXXX00000000000000000000000000000000000000000000000000000000000000000000000
XXXXXX------XXXX00000000000000000000000000000000000000000000000000000000000000000000000
XXXX--------XXXX00000000000000000000000000000000000000000000000000000000000000000000000
XXXX--------XXXX00000000000000000000000000000000000000000000000000000000000000000000000
XX----TTTTTTTTXX00000000000000000000000000000000000000000000000000000000000000000000000
XX------------XX00000000000000000000000000000000000000000000000000000000000000000000000
XX------------XX00000000000000000000000000000000000000000000000000000000000000000000000
XXXXXXXX------XX00000000000000000000000000000000000000000000000000000000000000000000000
XX----XXXXX---XX00000000000000000000000000000000000000000000000000000000000000000000000
XD------------XX00000000000000000000000000000000000000000000000000000000000000000000000
XD------------XX00000000000000000000000000000000000000000000000000000000000000000000000
XXXXX-------XXXX00000000000000000000000000000000000000000000000000000000000000000000000
XXXXXXXXXXXXXXXX00000000000000000000000000000000000000000000000000000000000000000000000