--------------------------------------------------------------------------------------------------------------------------------------------------------------------------------------------------------000000000000000
--------------------------------------------------------------------------------------------------------------------------------------------------------------------------------------------------------000000000000000
--------------------------------------------------------------------------------------------------------------------------------------------------------------------------------------------------------000000000000000
--------------------------------------------------------------------------------------------------------------------------------------------------------------------------------------------------------000000000000000
--------------------------------------------------------------------------------------------------------------------------------------------------------------------------------------------------------000000000000000
--------------------------------------------------------------------------------------------------------------------------------------------------------------------------------------------------------000000000000000
--------------------------------------------------------------------------------------------------------------------------------------------------------------------------------------------------------000000000000000
--------------------------------------------------------------------------------------------------------------------------------------------------------------------------------------------------------000000000000000
--------------------------------------------------------------------------------------------------------------------------------------------------------------------------------------------------------000000000000000
--------------------------------------------------------------------------------------------------------------------------------------------------------------------------------------------------------000000000000000
---------------------------------------------------------------------------------------------------------oooo------------------------------------------------------------------------SSSSSSSSSSSS-------000000000000000
----------------------o------------------------------------------------------------------------E---E---oo-----------------------------S--------X----------E-------------------------ES--XS--------------000000000000000
----------------------------------------------------------------------------------------------<>--<>-------------------------------------------X---------<>---------------------------------------------000000000000000
----------------------------------------------------------------------------------------------[]--[]-------------------------------------------X---------[]---------------------------------------------000000000000000
------------------------E------------------E-----------------E---E--------------------------E-[]--[]--------------EEE--E-----------------------X---------[]----E-----E-------------------------E--------000000000000000
XXXXXXXXXXXXXXXXXXXXXXXXXXXXXXXXXXXXXXXXXXXXXXXXXXXXXXXXXXXXXXXXXXXXXXXXXXXXXXXXXXXXXXXXXXXXXXXXXXXXXXXXXXXXXXXXXXXXXXXXXXXXXXXXXXXXXXXXXXXXXXXXXXXXXXXXXXXXXXXXXXXXXXXXXXXXXXXXXXXXXXXXXXXXXXXXXXXXXXXX000000000000000
00000000000000000000000000000000000000000000000000000000000000000000000000000000000000000000000000000000000000000000000000000000000000000000000000000000000000000000000000000000000000000000000000000000000000000000000