000000000000000000000000000000000000000000000000000000000000000000000000000000000000000000000000000000000000XXXX----------DX
000000000000000000000000000000000000000000000000000000000000000000000000000000000000000000000000000000000000XXXX----------DX
000000000000000000000000000000000000000000000000000000000000000000000000000000000000000000000000000000000000XXXX----XXXXXXXX
000000000000000000000000000000000000000000000000000000000000000000000000000000000000000000000000000000000000---X-X----------
000000000000000000000000000000000000000000000000000000000000000000000000000000000000000000000000000000000000---X------------
000000000000000000000000000000000000000000000000000000000000000000000000000000000000000000000000000000000000XXXX----------XX
000000000000000000000000000000000000000000000000000000000000000000000000000000000000000000000000000000000000XXXX----------XX
000000000000000000000000000000000000000000000000000000000000000000000000000000000000000000000000000000000000XXXX----------XX
000000000000000000000000000000000000000000000000000000000000000000000000000000000000000000000000000000000000XXXXXXXX------XX
000000000000000000000000000000000000000000000000000000000000000000000000000000000000000000000000000000000000XXXXXXXXXX----XX
000000000000000000000000000000000000000000000000000000000000000000000000000000000000000000000000000000000000XXXX----------XX
000000000000000000000000000000000000000000000000000000000000000000000000000000000000000000000000000000000000XX------------XX
000000000000000000000000000000000000000000000000000000000000000000000000000000000000000000000000000000000000XXXXXXXX------XX
000000000000000000000000000000000000000000000000000000000000000000000000000000000000000000000000000000000000XX------------DX
000000000000000000000000000000000000000000000000000000000000000000000000000000000000000000000000000000000000XX------------XX
000000000000000000000000000000000000000000000000000000000000000000000000000000000000000000000000000000000000XX----XXXXXXXXXX
000000000000000000000000000000000000000000000000000000000000000000000000000000000000000000000000000000000000XD-------------X
000000000000000000000000000000000000000000000000000000000000000000000000000000000000000000000000000000000000XD------------DX
000000000000000000000000000000000000000000000000000000000000000000000000000000000000000000000000000000000000XXXXX-------XXXX
000000000000000000000000000000000000000000000000000000000000000000000000000000000000000000000000000000000000XXXXXXXXXXXXXXXX
000000000000000000000000000000000000000000000000000000000000000000000000000000000000000000000000000000000000---------------X
000000000000000000000000000000000000000000000000000000000000000000000000000000000000000000000000000000000000X-----------XXXX
000000000000000000000000000000000000000000000000000000000000000000000000000000000000000000000000000000000000X---XXXXXXXXXXXX
000000000000000000000000000000000000000000000000000000000000000000000000000000000000000000000000000000000000X-------------XX
000000000000000000000000000000000000000000000000000000000000000000000000000000000000000000000000000000000000X-------------XX
000000000000000000000000000000000000000000000000000000000000000000000000000000000000000000000000000000000000X-------------XX
000000000000000000000000000000000000000000000000000000000000000000000000000000000000000000000000000000000000X-------------XX
000000000000000000000000000000000000000000000000000000000000000000000000000000000000000000000000000000000000X---E---------XX
000000000000000000000000000000000000000000000000000000000000000000000000000000000000000000000000000000000000---XXXXX-------X
000000000000000000000000000000000000000000000000000000000000000000000000000000000000000000000000000000000000---X---XXXXXXXXX
000000000000000000000000000000000000000000000000000000000000000000000000000000000000000000000000000000000000---X------------
000000000000000000000000000000000000000000000000000000000000000000000000000000000000000000000000000000000000XXXXXXXX------XX
000000000000000000000000000000000000000000000000000000000000000000000000000000000000000000000000000000000000XXXXXXXXXX----XX
000000000000000000000000000000000000000000000000000000000000000000000000000000000000000000000000000000000000XX------------XX
000000000000000000000000000000000000000000000000000000000000000000000000000000000000000000000000000000000000XX------------XX
000000000000000000000000000000000000000000000000000000000000000000000000000000000000000000000000000000000000XX----XXXXXXXXXX
000000000000000000000000000000000000000000000000000000000000000000000000000000000000000000000000000000000000XD------------XX
000000000000000000000000000000000000000000000000000000000000000000000000000000000000000000000000000000000000XD------------XX
000000000000000000000000000000000000000000000000000000000000000000000000000000000000000000000000000000000000XXXXX-------XXXX
000000000000000000000000000000000000000000000000000000000000000000000000000000000000000000000000000000000000XXXXXXXXXXXXXXXX
000000000000000000000000000000000000000000000000000000000000000000000000000000000000000000000000000000000000XXXXXXX-----XXXX
000000000000000000000000000000000000000000000000000000000000000000000000000000000000000000000000000000000000XXXX--------XXXX
000000000000000000000000000000000000000000000000000000000000000000000000000000000000000000000000000000000000XX------------XX
000000000000000000000000000000000000000000000000000000000000000000000000000000000000000000000000000000000000XX-----XXXX---DX
000000000000000000000000000000000000000000000000000000000000000000000000000000000000000000000000000000000000XX------------DX
000000000000000000000000000000000000000000000000000000000000000000000000000000000000000000000000000000000000XXXX--------XXXX
000000000000000000000000000000000000000000000000000000000000000000000000000000000000000000000000000000000000XXXXXX------XXXX
000000000000000000000000000000000000000000000000000000000000000000000000000000000000000000000000000000000000XXXX--------XXXX
0000000000000000000000000000000000000000000000000000000000000000000000000000000000000000--------------------XXXX--------XXXX
0000000000000000000000000000000000000000000000000000000000000000000000000000000000000000--------------------XX----TTTTTTTTXX
000000000000000000000000000000000000000000000000000000000000000000000000-----------TTTT---------------------XX------------XX
000000000000000000000000000000000000000000000000000000000000000000000000------------------------------------XX------------XX
000000000000000000000000000000000000000000000000000000000000000000000000----------------S-------------------XXXXXXXX------XX
000000000000000000000000000000000000000000000000000000000000000000000000--------TTTT----S-------------------XX------------XX
000000000000000000000000000000000000000000000000000000000000000000000000----------------S-------------------XX------------XX
000000000000000000000000000000000000000000000000000000000000000000000000----------------S-------------------XX----XXXXXXXXXX
000000000000000000000000000000000000000000000000000000000000000000000000X-----TTTT-TTTTTS-------------------XD------------XX
000000000000000000000000000000000000000000000000000000000000000000000000X---------------S-------------------XD------------XX
000000000000000000000000000000000000000000000000000000000000000000000000X---------------S-------------------XXXXX-------XXXX
0000000000000000000000000000000000000000000000000000--------------------XXXX------------S---------SSS--SX--QXXXXXXXXXXXXXXXX
0000000000000000000000000000000000000000000000000000--------------------XXXX------------S-------------------0000000000000000
0000000000000000000000000000000000000000000000000000--------------------XXXX----------X-S-------------------0000000000000000
0000000000000000000000000000000000000000000000000000--------------------XXXX----------X-S-------------------0000000000000000
000000000000000000000000000000000000---------o----X-S-------------------XXXX------------XXXXXXXXXXXXXXXXXXXX0000000000000000
000000000000000000000000000000000000--------------X-S-------------------XXXX------------000000000000000000000000000000000000
000000000000000000000000000000000000------------E-X-S-------------------XXXX------TTT---000000000000000000000000000000000000
000000000000000000000000000000000000--------------X-S-------------------XD--------------000000000000000000000000000000000000
000000000000000000000000000000000000----------------S-------------------XD-------------X000000000000000000000000000000000000
000000000000000000000000000000000000----------------S-------------------XXXXX-------XXXX000000000000000000000000000000000000
000000000000000000000000000000000000----XXXXXXXX----S----------------SSSXXXXXXXXXXXXXXXX000000000000000000000000000000000000
000000000000000000000000000000000000----------------S------X------------0000000000000000000000000000000000000000000000000000
0000000000000000------------------------------------S-----XX------------0000000000000000000000000000000000000000000000000000
0000000000000000--------------------XX-----------XXXS----XXX------------0000000000000000000000000000000000000000000000000000
0000000000000000--------------------XX----XXXXXXXXXXS--XXXXX------------0000000000000000000000000000000000000000000000000000
0000000000000000--------------------XX------------XXXXEXXXXXXXXXXXXXXXXX0000000000000000000000000000000000000000000000000000
----------------S-------------------XX------------XX000000000000000000000000000000000000000000000000000000000000000000000000
-TTTT-----------S-------------------XXXXXXXX------XX000000000000000000000000000000000000000000000000000000000000000000000000
----------------S-------------------XX----XXXXX---XX000000000000000000000000000000000000000000000000000000000000000000000000
----------------S-------------------XD------------XX000000000000000000000000000000000000000000000000000000000000000000000000
-------TT-------S-------------------XD------------XX000000000000000000000000000000000000000000000000000000000000000000000000
----------------S-------------------XXXXX-------XXXX000000000000000000000000000000000000000000000000000000000000000000000000
----------------S-----------------XXXXXXXXXXXXXXXXXX000000000000000000000000000000000000000000000000000000000000000000000000
-----------TTTT-S-----------<E---X--0000000000000000000000000000000000000000000000000000000000000000000000000000000000000000
X---------------S-----------[>------0000000000000000000000000000000000000000000000000000000000000000000000000000000000000000
X--------------XS-----------[]------0000000000000000000000000000000000000000000000000000000000000000000000000000000000000000
XXXX--------XXXXS----------E[]----o-0000000000000000000000000000000000000000000000000000000000000000000000000000000000000000
XX----------X---XXXXXXXXXXXXXXXXXXX-0000000000000000000000000000000000000000000000000000000000000000000000000000000000000000
XX--------------000000000000000000000000000000000000000000000000000000000000000000000000000000000000000000000000000000000000
XX----------XXXX000000000000000000000000000000000000000000000000000000000000000000000000000000000000000000000000000000000000
XX----------XXXX000000000000000000000000000000000000000000000000000000000000000000000000000000000000000000000000000000000000
XX----XXXXXXXXXX000000000000000000000000000000000000000000000000000000000000000000000000000000000000000000000000000000000000
XD-------------X000000000000000000000000000000000000000000000000000000000000000000000000000000000000000000000000000000000000
XD------------DX000000000000000000000000000000000000000000000000000000000000000000000000000000000000000000000000000000000000
XXXXX-------XXXX000000000000000000000000000000000000000000000000000000000000000000000000000000000000000000000000000000000000
XXXXXXXXXXXXXXXX000000000000000000000000000000000000000000000000000000000000000000000000000000000000000000000000000000000000
----------------000000000000000000000000000000000000000000000000000000000000000000000000000000000000000000000000000000000000
----------------000000000000000000000000000000000000000000000000000000000000000000000000000000000000000000000000000000000000
-----TTTT-------000000000000000000000000000000000000000000000000000000000000000000000000000000000000000000000000000000000000
----------------000000000000000000000000000000000000000000000000000000000000000000000000000000000000000000000000000000000000
XXXX--------XXXX000000000000000000000000000000000000000000000000000000000000000000000000000000000000000000000000000000000000
XXXX--------XXXX000000000000000000000000000000000000000000000000000000000000000000000000000000000000000000000000000000000000
XXXXXXX-----XXXX000000000000000000000000000000000000000000000000000000000000000000000000000000000000000000000000000000000000
XXXX--------XXXX000000000000000000000000000000000000000000000000000000000000000000000000000000000000000000000000000000000000
XX------------XX000000000000000000000000000000000000000000000000000000000000000000000000000000000000000000000000000000000000
XX-----XXXXX--DX000000000000000000000000000000000000000000000000000000000000000000000000000000000000000000000000000000000000
XX----------XXXX000000000000000000000000000000000000000000000000000000000000000000000000000000000000000000000000000000000000
XX----------XXXX000000000000000000000000000000000000000000000000000000000000000000000000000000000000000000000000000000000000
XX--TT------XXXX000000000000000000000000000000000000000000000000000000000000000000000000000000000000000000000000000000000000
XX----------XXXX000000000000000000000000000000000000000000000000000000000000000000000000000000000000000000000000000000000000
XX-----------XXX000000000000000000000000000000000000000000000000000000000000000000000000000000000000000000000000000000000000
XX----XXXXXXXXXX000000000000000000000000000000000000000000000000000000000000000000000000000000000000000000000000000000000000
XD-----------TXX000000000000000000000000000000000000000000000000000000000000000000000000000000000000000000000000000000000000
XD------------XX000000000000000000000000000000000000000000000000000000000000000000000000000000000000000000000000000000000000
XXXXX-------XXXX000000000000000000000000000000000000000000000000000000000000000000000000000000000000000000000000000000000000
XXXXXXXXXXXXXXXX000000000000000000000000000000000000000000000000000000000000000000000000000000000000000000000000000000000000