--------------------------------------------------------------------------------------------------------------------------------------------------------------------------------------------------------000000000000000
--------------------------------------------------------------------------------------------------------------------------------------------------------------------------------------------------------000000000000000
--------------------------------------------------------------------------------------------------------------------------------------------------------------------------------------------------------000000000000000
--------------------------------------------------------------------------------------------------------------------------------------------------------------------------------------------------------000000000000000
--------------SSSSSSSSSSSSSSSSSSSSSSSSSSSSSSSSSSSSSSSSSSSSSSSSSSSSSSSSSSSSSSSSSSSSSSSSSSSSSSSSSSSS-SSSSSSSSSSSSSSSSSSSSSSSSSSSSSSSSSSSSSSSSSSSSSSSSSSSSSSSSSSSSSSSSSSSSSSSSSSSSSSSSSSSSSSSSSSSSSSSSS----000000000000000
---------------------------------------------------------------------------------------------------------------------------------------------------------------------SSSSSSSSSSSSSSS--------------------000000000000000
---------------------------------------------------------------------------------------------------------------------------------------------------------------------SSSSSSSSSSSSSSS--------------------000000000000000
---------------------S-------------------------------------------------------oooooooooooooooooooooo------------------------S---------------------------------------SSS-SSSSSSSSSSSSS-S----------------XX000000000000000
--------------------------------------------------------X-------------E-----X----------------------------------------------S---------------------------------------SSS--------------------------------XX000000000000000
----------------------------------------------------------X---------X<>------SSSSSSSSSSSSSSSSSSSSS-------------------------S---------------------------------------SSS------------------------------XXXX000000000000000
---------------------------------------------------------oS----E-----[]-------SSSSSSSSSSSSSSSSSSSS----------------S--------S------S-----------S--------------------SSS-----------E----------E-------XXXX000000000000000
----E-------XXXX-----S--E--------------------------XXX---XX---->--SX-[]----S--SS------SS----------------------E------QQ----S-----------------S---------------------SSSSSSSSSSSSSSSSS-------->-------XXXX000000000000000
---<>------------------<>-------------------------XXXX--E-----<]-----[]--------------------------------------<>-E------------------------------XX--------------E------SSSSSSSSSSSSSS-------<]------XXXXX000000000000000
---[]------------------[]------------------------XXXXX--------[]-----[]--------------------------------------[]<>-------------E----------------XX---------------------SSSSSSSSSSSSSS-------[]-----XXXXXX000000000000000
---[]------------------[]--------------E------E--XXXXX------E-[]-E---[]---E--E-------E-----------------------[][]----E----------------------EEXXX-------------------E----------------------[]----XXXXXXX000000000000000
XXXXXXXXXXX------XXXXXXXXXXXXXXXXXXXXXXXXXXXXXXXXXXXXXXXXXXXXXXXXXXXXXXXXXXXXXXXXXXXXXXXXXXXXXXXX----XXXXXXXXXXXXXXXXXXXXXXXXXXXXXXXXXXXXXXXXXXXX--XXXXXXXXXXXXXXXXXXXXXXXXXXXXXXXXX--XXXXXXXXXXXXXXXXXX000000000000000
00000000000000000000000000000000000000000000000000000000000000000000000000000000000000000000000000000000000000000000000000000000000000000000000000000000000000000000000000000000000000000000000000000000000000000000000