00000000000000000000000000000000000000000000000000000000000000000000000000000000000000000000000000000000000000000000----------------
00000000000000000000000000000000000000000000000000000000000000000000000000000000000000000000000000000000000000000000-----TTTTTTT----
00000000000000000000000000000000000000000000000000000000000000000000000000000000000000000000000000000000000000000000----------------
00000000000000000000000000000000000000000000000000000000000000000000000000000000000000000000000000000000000000000000----------------
00000000000000000000000000000000000000000000000000000000000000000000000000000000000000000000000000000000000000000000---TTTT--TTTT---
00000000000000000000000000000000000000000000000000000000000000000000000000000000000000000000000000000000000000000000----------------
00000000000000000000000000000000000000000000000000000000000000000000000000000000000000000000000000000000000000000000----------------
00000000000000000000000000000000000000000000000000000000000000000000000000000000000000000000000000000000000000000000---------TTT----
00000000000000000000000000000000000000000000000000000000000000000000000000000000000000000000000000000000000000000000----------------
00000000000000000000000000000000000000000000000000000000000000000000000000000000000000000000000000000000000000000000X-----------TTTT
00000000000000000000000000000000000000000000000000000000000000000000000000000000000000000000000000000000000000000000X--------------X
00000000000000000000000000000000000000000000000000000000000000000000000000000000000000000000000000000000000000000000X--------------X
00000000000000000000000000000000000000000000000000000000000000000000000000000000000000000000000000000000000000000000XXXXXXXXX------X
00000000000000000000000000000000000000000000000000000000000000000000000000000000000000000000000000000000000000000000XX-------------X
00000000000000000000000000000000000000000000000000000000000000000000000000000000000000000000000000000000000000000000XX--------TTTTTT
00000000000000000000000000000000000000000000000000000000000000000000000000000000000000000000000000000000000000000000XD-------------X
00000000000000000000000000000000000000000000000000000000000000000000000000000000000000000000000000000000000000000000XD-------------X
00000000000000000000000000000000000000000000000000000000000000000000000000000000000000000000000000000000000000000000TTTTXXXXXXXX--DX
00000000000000000000000000000000000000000000000000000000000000000000000000000000000000000000000000000000000000000000--TTTTTTTT-----X
00000000000000000000000000000000000000000000000000000000000000000000000000000000000000000000000000000000000000000000---------TTTTTTT
00000000000000000000000000000000000000000000000000000000000000000000000000000000000000000000000000000000000000000000----------------
00000000000000000000000000000000000000000000000000000000000000000000000000000000000000000000000000000000000000000000----E--------E--
00000000000000000000000000000000000000000000000000000000000000000000000000000000000000000000000000000000000000000000MMMMMMMMMMMMMMMM
00000000000000000000000000000000000000000000000000000000000000000000000000000000000000000000000000000000000000000000----------------
00000000000000000000000000000000000000000000000000000000000000000000000000000000000000000000000000000000000000000000----------------
00000000000000000000000000000000000000000000000000000000000000000000000000000000000000000000000000000000000000000000-TTTT-----------
00000000000000000000000000000000000000000000000000000000000000000000000000000000000000000000000000000000000000000000----------------
00000000000000000000000000000000000000000000000000000000000000000000000000000000000000000000000000000000000000000000----------------
00000000000000000000000000000000000000000000000000000000000000000000000000000000000000000000000000000000000000000000------------XX--
00000000000000000000000000000000000000000000000000000000000000000000000000000000000000000000000000000000000000000000----XXXX---XXXX-
00000000000000000000000000000000000000000000000000000000000000000000000000000000000000000000000000000000000000000000XXXX------XXXX--
00000000000000000000000000000000000000000000000000000000000000000000000000000000000000000000000000000000000000000000XXXX-----TTTTTTT
00000000000000000000000000000000000000000000000000000000000000000000000000000000000000000000000000000000000000000000XXXX--------XXXX
00000000000000000000000000000000000000000000000000000000000000000000000000000000000000000000000000000000000000000000XXXX--------XXXX
00000000000000000000000000000000000000000000000000000000000000000000000000000000000000000000000000000000000000000000X---TTTT---XXXXX
00000000000000000000000000000000000000000000000000000000000000000000000000000000000000000000000000000000000000000000XD-------------X
00000000000000000000000000000000000000000000000000000000000000000000000000000000000000000000000000000000000000000000XD-------------X
00000000000000000000000000000000000000000000000000000000000000000000000000000000000000000000000000000000000000000000TTTTXXXXXXXX--XX
00000000000000000000000000000000000000000000000000000000000000000000000000000000000000000000000000000000000000000000--TTTTTTTT-----X
00000000000000000000000000000000000000000000000000000000000000000000000000000000000000000000000000000000000000000000---------TTTTTTT
00000000000000000000000000000000000000000000000000000000000000000000000000000000000000000000000000000000000000000000----------------
00000000000000000000000000000000000000000000000000000000000000000000000000000000000000000000000000000000000000000000---------XXXX---
00000000000000000000000000000000000000000000000000000000000000000000000000000000000000000000000000000000000000000000----------------
00000000000000000000000000000000000000000000000000000000000000000000000000000000000000000000000000000000000000000000----------------
00000000000000000000000000000000000000000000000000000000000000000000000000000000000000000000000000000000000000000000MMMMMMMMMMMMMMMM
00000000000000000000000000000000000000000000000000000000000000000000000000000000000000000000000000000000000000000000----------------
00000000000000000000000000000000000000000000000000000000000000000000000000000000000000000000000000000000000000000000----------------
00000000000000000000000000000000000000000000000000000000000000000000000000000000000000000000000000000000000000000000---------TTT----
00000000000000000000000000000000000000000000000000000000000000000000000000000000000000000000000000000000000000000000----------------
00000000000000000000000000000000000000000000000000000000000000000000000000000000000000000000000000000000000000000000X-----------TTTT
00000000000000000000000000000000000000000000000000000000000000000000000000000000000000000000000000000000000000000000X--------------X
00000000000000000000000000000000000000000000000000000000000000000000000000000000000000000000000000000000000000000000X--------------X
00000000000000000000000000000000000000000000000000000000000000000000000000000000000000000000000000000000000000000000XXXXXXXXX------X
00000000000000000000000000000000000000000000000000000000000000000000000000000000000000000000000000000000000000000000XX-------------X
00000000000000000000000000000000000000000000000000000000000000000000000000000000000000000000000000000000000000000000XX--------TTTTTT
00000000000000000000000000000000000000000000000000000000000000000000000000000000000000000000000000000000000000000000XD-------------X
00000000000000000000000000000000000000000000000000000000000000000000000000000000000000000000000000000000000000000000XD-------------X
00000000000000000000000000000000000000000000000000000000000000000000000000000000000000000000000000000000000000000000TTTTXXXXXXXX--DX
00000000000000000000000000000000000000000000000000000000000000000000000000000000000000000000000000000000000000000000--TTTTTTTT-----X
00000000000000000000000000000000000000000000000000000000000000000000000000000000000000000000000000000000000000000000---------TTTTTTT
00000000000000000000000000000000000000000000000000000000000000000000000000000000000000000000000000000000000000000000X----------DXXXX
00000000000000000000000000000000000000000000000000000000000000000000000000000000000000000000000000000000000000000000X---XXXXXXXXXXXX
00000000000000000000000000000000000000000000000000000000000000000000000000000000000000000000000000000000000000000000X-------------XX
00000000000000000000000000000000000000000000000000000000000000000000000000000000000000000000000000000000000000000000X-------------XX
00000000000000000000000000000000000000000000000000000000000000000000000000000000000000000000000000000000000000000000X-------------XX
00000000000000000000000000000000000000000000000000000000000000000000000000000000000000000000000000000000000000000000X---XXXX------XX
00000000000000000000000000000000000000000000000000000000000000000000000000000000000000000000000000000000000000000000X-------------XX
00000000000000000000000000000000000000000000000000000000000000000000000000000000000000000000000000000000000000000000X-------------XX
00000000000000000000000000000000000000000000000000000000000000000000000000000000000000000000000000000000000000000000X-------------XX
00000000000000000000000000000000000000000000000000000000000000000000000000000000000000000000000000000000000000000000X-------------XX
00000000000000000000000000000000000000000000000000000000000000000000000000000000000000000000000000000000000000000000X-------------XX
00000000000000000000000000000000000000000000000000000000000000000000000000000000000000000000000000000000000000000000X-------------XX
00000000000000000000000000000000000000000000000000000000000000000000000000000000000000000000000000000000000000000000XX------------XX
00000000000000000000000000000000000000000000000000000000000000000000000000000000000000000000000000000000000000000000XXXXXXXX------XX
00000000000000000000000000000000000000000000000000000000000000000000000000000000000000000000000000000000000000000000XD-------TTTT--X
00000000000000000000000000000000000000000000000000000000000000000000000000000000000000000000000000000000000000000000XD-------------X
00000000000000000000000000000000000000000000000000000000000000000000000000000000000000000000000000000000000000000000XD-------------X
00000000000000000000000000000000000000000000000000000000000000000000000000000000000000000000000000000000000000000000TTTTXXXXXXXX--XX
00000000000000000000000000000000000000000000000000000000000000000000000000000000000000000000000000000000000000000000--TTTTTTTT-----X
0000000000000000-------------------------------------------------------------------------------------------------------------TTTTTTT
0000000000000000----------------------------------------------------------------------------------------------------0000000000000000
0000000000000000----------------------------------------------------------------------------------------------------0000000000000000
0000000000000000----------------------------------------------------------------------------------------------------0000000000000000
0000000000000000----------------------------------------------------------------------------------------------------0000000000000000
0000000000000000----------------------------------------------------------------------------------------------------0000000000000000
0000000000000000----------------------------------------------------------------------------------------------------0000000000000000
0000000000000000----------------------------------------------SSSSSSSSS---------------oo----------------------------0000000000000000
0000000000000000----------------------------------------------------------------------------------------------------0000000000000000
0000000000000000----------------------------------------------------------------------------------------------------0000000000000000
0000000000000000----------X-----oooo-----------------------------------E--------------------------------------------0000000000000000
0000000000000000---------XX---------------------------------E---------<>-----------XXX--XXXXXXXX--------------------0000000000000000
0000000000000000--------XXX-------------------------------------------[]--------------------------------------------0000000000000000
0000000000000000-------XXXXX------------------------------------------[]--------------------------------------------0000000000000000
----------------------XXXXXX--------------EEEE------------------------[]-------X------------------------E--EE-------0000000000000000
----------------XXXXXXXXXXXXXXXXXXX-XXXXXXXXXXXXXXXXXXXXXXXXXXXXXXXXXXXXXXXXXXXXXXX-------------XXXXXXXXXXXXXXXXXXX-0000000000000000
-------TT-------00000000000000000000000000000000000000000000000000000000000000000000000000000000000000000000000000000000000000000000
----------------00000000000000000000000000000000000000000000000000000000000000000000000000000000000000000000000000000000000000000000
----------------00000000000000000000000000000000000000000000000000000000000000000000000000000000000000000000000000000000000000000000
-----------TTTT-00000000000000000000000000000000000000000000000000000000000000000000000000000000000000000000000000000000000000000000
XXXX------------00000000000000000000000000000000000000000000000000000000000000000000000000000000000000000000000000000000000000000000
X---------------00000000000000000000000000000000000000000000000000000000000000000000000000000000000000000000000000000000000000000000
X-----------TTTT00000000000000000000000000000000000000000000000000000000000000000000000000000000000000000000000000000000000000000000
X------T-------X00000000000000000000000000000000000000000000000000000000000000000000000000000000000000000000000000000000000000000000
X--------------X00000000000000000000000000000000000000000000000000000000000000000000000000000000000000000000000000000000000000000000
X--------------X00000000000000000000000000000000000000000000000000000000000000000000000000000000000000000000000000000000000000000000
XXXXXXXXX------X00000000000000000000000000000000000000000000000000000000000000000000000000000000000000000000000000000000000000000000
XX-------------X00000000000000000000000000000000000000000000000000000000000000000000000000000000000000000000000000000000000000000000
XX--------TTTTTT00000000000000000000000000000000000000000000000000000000000000000000000000000000000000000000000000000000000000000000
XD-------------X00000000000000000000000000000000000000000000000000000000000000000000000000000000000000000000000000000000000000000000
XD-------------X00000000000000000000000000000000000000000000000000000000000000000000000000000000000000000000000000000000000000000000
TTTTXXXXXXXX--DX00000000000000000000000000000000000000000000000000000000000000000000000000000000000000000000000000000000000000000000
--TTTTTTTT-----X00000000000000000000000000000000000000000000000000000000000000000000000000000000000000000000000000000000000000000000
---------TTTTTTT00000000000000000000000000000000000000000000000000000000000000000000000000000000000000000000000000000000000000000000