000000000000000000000000000000000000000000000000000000000000000----------------
000000000000000000000000000000000000000000000000000000000------XXXX--------XXXX
000000000000000000000000000000000000000000000000000000000------0000000000000000
000000000000000000000000000000000000000000000000000000000------0000000000000000
000000000000000000000000000000000000000000000000000000000------0000000000000000
000000000000000000000000000000000000000000000000000000000------0000000000000000
000000000000000000000000000000000000000000000000000000000------0000000000000000
000000000000000000000000000000000000000000000000000000000------0000000000000000
00000000000000000000000000000000000000000----------------------0000000000000000
00000000000000000000000000000000000000000----------------X-----0000000000000000
00000000000000000000000000000000000000000------------X---------0000000000000000
00000000000000000000000000000000000000000------------X---------0000000000000000
00000000000000000000000000000000000000000----------------------0000000000000000
00000000000000000000000000000000000000000----------------------0000000000000000
00000000000000000000000000000000000000000------TTTT------------0000000000000000
00000000000000000000000000000000000000000-------------------X--0000000000000000
00000000000000000000000000000000000000000---------XXXX------X--0000000000000000
00000000000000000000000000000000000000000----------------0000000000000000000000
00000000000000000000000000000000000000000------XXXX------0000000000000000000000
00000000000000000000000000000000000000000----------------0000000000000000000000
00000000000000000000000000000000000000000---------XXXX---0000000000000000000000
00000000000000000000000000000000000000000----------------0000000000000000000000
00000000000000000000000000000000000000000---E---E--------0000000000000000000000
00000000000000000000000000000000000000000MMMMMMMMMMMMMMMM0000000000000000000000
00000000000000000000000000000000000000000----------------0000000000000000000000
00000000000000000000000000000000000000000----------------0000000000000000000000
00000000000000000000000000000000000000000---------TTT----0000000000000000000000
00000000000000000000000000000000000000000----------------0000000000000000000000
00000000000000000000000000000000000000000X-----------TTTT0000000000000000000000
00000000000000000000000000000000000000000X--------------X0000000000000000000000
00000000000000000000000000000000000000000X-----------XXXX0000000000000000000000
00000000000000000000000000000000000000000X-----------XXXX0000000000000000000000
00000000000000000000000000000000000000000X-----XXXXXXXXXX0000000000000000000000
00000000000000000000000000000000000000000X-----XXXX---XXX0000000000000000000000
00000000000000000000000000000000000000000X------------XXX0000000000000000000000
00000000000000000000000000000000000000000X------------XXX0000000000000000000000
00000000000000000000000000000000000000000XXXX----------XX0000000000000000000000
00000000000000000000000000000000000000000XXXX-----------X0000000000000000000000
00000000000000000000000000000000000000000XXXX--------XXXX0000000000000000000000
00000000000000000000000000000000000000000XXXX--XXXXXXXXXX0000000000000000000000
00000000000000000000000000000000000000000XXXX--------XXXX0000000000000000000000
00000000000000000000000000000000000000000XXXX--------XXXX0000000000000000000000
00000000000000000000000000000000000000000XXXX--XXXXXXXXXX0000000000000000000000
00000000000000000000000000000000000000000XXXX--------XXXX0000000000000000000000
00000000000000000000000000000000000000000XXXX--------XXXX0000000000000000000000
00000000000000000000000000000000000000000XTTTTTTTT---XXXX0000000000000000000000
00000000000000000000000000000000000000000XXXX--------XXXX0000000000000000000000
00000000000000000000000000000000000000000XXXX--------XXXX0000000000000000000000
00000000000000000000000000000000000000000XXXX-----TTTTXXX0000000000000000000000
00000000000000000000000000000000000000000XXXX--------XXXX0000000000000000000000
00000000000000000000000000000000000000000XXXX--------XXXX0000000000000000000000
00000000000000000000000000000000000000000XTTTTTTTT---XXXX0000000000000000000000
00000000000000000000000000000000000000000XXXX--------XXXX0000000000000000000000
00000000000000000000000000000000000000000XXXX--------XXXX0000000000000000000000
00000000000000000000000000000000000000000XXXX-----TTTTXXX0000000000000000000000
00000000000000000000000000000000000000000XXXX------T-XXXX0000000000000000000000
00000000000000000000000000000000000000000XX----------XXXX0000000000000000000000
00000000000000000000000000000000000000000XX----------XXXX0000000000000000000000
00000000000000000000000000000000000000000XX----TTXXXXXXXX0000000000000000000000
00000000000000000000000000000000000000000XX--------------0000000000000000000000
00000000000000000000000000000000000000000XX--------------0000000000000000000000
00000000000000000000000000000000000000000XTTTT-----------0000000000000000000000
00000000000000000000000000000000000000000----------------0000000000000000000000
00000000000000000000000000000000000000000----------------0000000000000000000000
00000000000000000000000000000000000000000---------TTT----0000000000000000000000
000000000000000000000000000000000000000---------E--------0000000000000000000000
000000000000000000000000000000000000000--00000000000000000000000000000000000000
000000000000000000000000000000000000000--00000000000000000000000000000000000000
000000000000000000000000000000000000000--00000000000000000000000000000000000000
000000000000000000000000000000000000000--00000000000000000000000000000000000000
000000000000000000000000000000000000000--00000000000000000000000000000000000000
000000000000000000000000000000000000000--00000000000000000000000000000000000000
000000000000000000000000000000000000000--00000000000000000000000000000000000000
000000000000000000000000000000000000000--00000000000000000000000000000000000000
00000000000000000000000----------------X-00000000000000000000000000000000000000
00000000000000000000000------XXXX------X-00000000000000000000000000000000000000
00000000000000000000000----------------X-00000000000000000000000000000000000000
00000000000000000000000---------XXXX---X-00000000000000000000000000000000000000
00000000000000000000000----------------X-00000000000000000000000000000000000000
00000000000000000000000XXXX--------XXXXX-00000000000000000000000000000000000000
00000000000000000000000XX-------------XX-00000000000000000000000000000000000000
00000000000000000000000XX-------------X0000000000000000000000000000000000000000
00000000000000000000000XXXXXXXX-------X0000000000000000000000000000000000000000
00000000000000000000000XX-------------X0000000000000000000000000000000000000000
00000000000000000000000----------------0000000000000000000000000000000000000000
00000000000000000000000--------TTTT----0000000000000000000000000000000000000000
00000000000000000000000----------------0000000000000000000000000000000000000000
00000000000000000000000----------------0000000000000000000000000000000000000000
00000000000000000000000----------------0000000000000000000000000000000000000000
00000000000000000000000X-----TTTT-TTTTT0000000000000000000000000000000000000000
00000000000000000000000X---------------0000000000000000000000000000000000000000
00000000000000000000000X---------------0000000000000000000000000000000000000000
00000000000000000000000X----------D----0000000000000000000000000000000000000000
00000000000000000000000X---XXXXXXXX----0000000000000000000000000000000000000000
00000000000000000000000X-------XXXXXXXX0000000000000000000000000000000000000000
00000000000000000000000X-----------XXXX0000000000000000000000000000000000000000
00000000000000000000000X-------------XX0000000000000000000000000000000000000000
00000000000000000000000X-------------XX0000000000000000000000000000000000000000
00000000000000000000000X-------------DX0000000000000000000000000000000000000000
00000000000000000000000X------D-----DXX0000000000000000000000000000000000000000
00000000000000000000000X---XXXXXXXXXXXX0000000000000000000000000000000000000000
00000000000000000000000X-----XXXX-XXXXX0000000000000000000000000000000000000000
00000000000000000000000X------------XXX0000000000000000000000000000000000000000
00000000000000000000000X-------------XX0000000000000000000000000000000000000000
00000000000000000000000X-------------XX0000000000000000000000000000000000000000
00000000000000000000000X-----XXXX----XX0000000000000000000000000000000000000000
00000000000000000000000X-------------XX0000000000000000000000000000000000000000
00000000000000000000000X-------------XX0000000000000000000000000000000000000000
00000000000000000000000X-------------XX0000000000000000000000000000000000000000
00000000000000000000000X-------------XX0000000000000000000000000000000000000000
00000000000000000000000X-----XXXX----XX0000000000000000000000000000000000000000
00000000000000000000000X-------------XX0000000000000000000000000000000000000000
00000000000000000000000X-------------XX0000000000000000000000000000000000000000
00000000000000000000000X-------------XX0000000000000000000000000000000000000000
00000000000000000000000X-------------DX0000000000000000000000000000000000000000
00000000000000000000000X-------------DX0000000000000000000000000000000000000000
00000000000000000000000X-----------XXXX0000000000000000000000000000000000000000
00000000000000000000000X-----XXXXXXXXXX0000000000000000000000000000000000000000
00000000000000000000000--------TTTTTTTT0000000000000000000000000000000000000000
00000000000000000000000----TTTTTTTT----0000000000000000000000000000000000000000
00000000000000000000000TTTT------------0000000000000000000000000000000000000000
00000000000000000000000----------------0000000000000000000000000000000000000000
00000000000000000000000----------------0000000000000000000000000000000000000000
0000000000000000------------T----------0000000000000000000000000000000000000000
0000000000000000-------00000000000000000000000000000000000000000000000000000000
0000000000000000-------00000000000000000000000000000000000000000000000000000000
0000000000000000-------00000000000000000000000000000000000000000000000000000000
0000000000000000-------00000000000000000000000000000000000000000000000000000000
0000000000000000-------00000000000000000000000000000000000000000000000000000000
0000000000000000-------00000000000000000000000000000000000000000000000000000000
0000000000000000-------00000000000000000000000000000000000000000000000000000000
--------------------X--00000000000000000000000000000000000000000000000000000000
----------------oo-----00000000000000000000000000000000000000000000000000000000
TTTTTTTT---------------00000000000000000000000000000000000000000000000000000000
---------TTTT----------00000000000000000000000000000000000000000000000000000000
-----------------------00000000000000000000000000000000000000000000000000000000
XXXX--------XXXX-------00000000000000000000000000000000000000000000000000000000
-----------------------00000000000000000000000000000000000000000000000000000000
----TTTT---------------00000000000000000000000000000000000000000000000000000000
----------------000000000000000000000000000000000000000000000000000000000000000
----------------000000000000000000000000000000000000000000000000000000000000000
--------TT------000000000000000000000000000000000000000000000000000000000000000
----------------000000000000000000000000000000000000000000000000000000000000000
----------------000000000000000000000000000000000000000000000000000000000000000
---XXXX---------000000000000000000000000000000000000000000000000000000000000000
XXXX---------XXX000000000000000000000000000000000000000000000000000000000000000
XXXX--XXXXXXXXXX000000000000000000000000000000000000000000000000000000000000000
XXXX---------DXX000000000000000000000000000000000000000000000000000000000000000
XXXX---------DXX000000000000000000000000000000000000000000000000000000000000000
XXXX----XXXXXXXX000000000000000000000000000000000000000000000000000000000000000
XXXX------------000000000000000000000000000000000000000000000000000000000000000
XXXX----------X-000000000000000000000000000000000000000000000000000000000000000
XXXX----------X-000000000000000000000000000000000000000000000000000000000000000
XXXX------------000000000000000000000000000000000000000000000000000000000000000
XXXX------------000000000000000000000000000000000000000000000000000000000000000
XXXX----------X-000000000000000000000000000000000000000000000000000000000000000
XXXX----------X-000000000000000000000000000000000000000000000000000000000000000
XXXX------------000000000000000000000000000000000000000000000000000000000000000
XXXX------------000000000000000000000000000000000000000000000000000000000000000
XTTTT-----------000000000000000000000000000000000000000000000000000000000000000
----------------000000000000000000000000000000000000000000000000000000000000000
----TTTT--------000000000000000000000000000000000000000000000000000000000000000
----------------000000000000000000000000000000000000000000000000000000000000000
----------------000000000000000000000000000000000000000000000000000000000000000
---TTTT---------000000000000000000000000000000000000000000000000000000000000000
----------------000000000000000000000000000000000000000000000000000000000000000
----------------000000000000000000000000000000000000000000000000000000000000000
-----TTTT-------000000000000000000000000000000000000000000000000000000000000000
----------------000000000000000000000000000000000000000000000000000000000000000
----------------000000000000000000000000000000000000000000000000000000000000000
---TTTT--TTTT---000000000000000000000000000000000000000000000000000000000000000
----------------000000000000000000000000000000000000000000000000000000000000000
----------------000000000000000000000000000000000000000000000000000000000000000
--------TT------000000000000000000000000000000000000000000000000000000000000000
----------------000000000000000000000000000000000000000000000000000000000000000
----------------000000000000000000000000000000000000000000000000000000000000000
---------XXXX---000000000000000000000000000000000000000000000000000000000000000
----------------000000000000000000000000000000000000000000000000000000000000000
XXXX--------XXXX000000000000000000000000000000000000000000000000000000000000000
----------------000000000000000000000000000000000000000000000000000000000000000
--------T-------000000000000000000000000000000000000000000000000000000000000000
----------------000000000000000000000000000000000000000000000000000000000000000
----------------000000000000000000000000000000000000000000000000000000000000000
X-----------TTTT000000000000000000000000000000000000000000000000000000000000000
X--------------X000000000000000000000000000000000000000000000000000000000000000
X-----------XXXX000000000000000000000000000000000000000000000000000000000000000
X----X---------X000000000000000000000000000000000000000000000000000000000000000
X--------------X000000000000000000000000000000000000000000000000000000000000000
----------------000000000000000000000000000000000000000000000000000000000000000
----------------000000000000000000000000000000000000000000000000000000000000000
----TTTT--------000000000000000000000000000000000000000000000000000000000000000
----------TTT---000000000000000000000000000000000000000000000000000000000000000
----------------000000000000000000000000000000000000000000000000000000000000000
----------------000000000000000000000000000000000000000000000000000000000000000
-----------XXXX-000000000000000000000000000000000000000000000000000000000000000
---------XXXX---000000000000000000000000000000000000000000000000000000000000000
X-----------TTTT000000000000000000000000000000000000000000000000000000000000000
X--------------X000000000000000000000000000000000000000000000000000000000000000
X--------------X000000000000000000000000000000000000000000000000000000000000000
XXXXXXXXX------X000000000000000000000000000000000000000000000000000000000000000
XX-------------X000000000000000000000000000000000000000000000000000000000000000
XX--------TTTTTT000000000000000000000000000000000000000000000000000000000000000
XD-------------X000000000000000000000000000000000000000000000000000000000000000
XD-------------X000000000000000000000000000000000000000000000000000000000000000
XXXXX---XXXXXXXX000000000000000000000000000000000000000000000000000000000000000
XXXXXXXXXXXXXXXX000000000000000000000000000000000000000000000000000000000000000