--------------------------------------------------------------------------------------------------------------------------------------------------------------------------------------------------------000000000000000
--------------------------------------------------------------------------------------------------------------------------------------------------------------------------------------------------------000000000000000
--------------------------------------------------------------------------------------------------------------------------------------------------------------------------------------------------------000000000000000
--------------------------------------------------------------------------------------------------------------------------------------------------------------------------------------------------------000000000000000
--------------------------------------------------------------------------------------------------------------------------------------------------------------------------------------------------------000000000000000
--------------------------------------------------------------------------------------------------------------------------------------------------------------------------------------------------------000000000000000
----------------------------------------------------------------------------------------E---------------------------------------------------------------------------------------------------------------000000000000000
--------------------------------------------------------------------------------------------------------------------------------------------------------------------------------------------------------000000000000000
--------------------------------------------------------------------------------------------------------------------------------------------------------------------------------------------------------000000000000000
----------------------------------------X----------------------------------------------------------------------------------------------------------------------------------X----------------------------000000000000000
---------------------------------------XX----------------E---------------------E-----------------------------------------------------E-------E-----------------S----------XX----------------------------000000000000000
-------------------------------------XXXX---------------<>--------------------<>-----XX--------X----E-------------------------------<>------<>-S-------S-----S?SS--------XXX---------S------------------000000000000000
------------------------------------XXXXX---E-----------[]--------------------[]--------------XX---<>-------------------------------[]------[]-------------------------XXXXX----------------------------000000000000000
-----------------------------------XXXXXX---------------[]----------------<>--[]-------------XXX---[]-------------------------------[]------[]------------------------XXXXXX----------------------------000000000000000
--------E---E------------E---E----XXXXXXX---------EE--E-[]---------E-------]--[]--------E--XXXXX---[]-------------------------------[]------[]-------------------E---XXXXXXX---EEE----------------------000000000000000
XXXXXXXXXXXXXXXXXXXXXXXXXXXXXXXXXXXXXXXXXXXXXXXXXXXXXXXXXXXXXXXXXXXXXXXXXXXXXXXXXXXXXXXXXXXXXXXXXXXXXXXXXXXXXXX-XXX-X-XXXXXXXXXXXXXXXXXXXXXXXX----XXXXXXXXXXXXXXXXXXXXXXXXXXXXXXXXXXXXXXXXXXXXXXXXXXXXXX000000000000000
00000000000000000000000000000000000000000000000000000000000000000000000000000000000000000000000000000000000000000000000000000000000000000000000000000000000000000000000000000000000000000000000000000000000000000000000