XXXX------XXXX--
XXXX------XXXX--
XXXX------XXXX--
XXXX------XXXX--
XXXX------XXXX--
XXXX------XXXX--
XXXX------XXXX--
XXXX------XXXX--
XXXX------XXXX--
XXXX------XXXX--
XXXX------XXXX--
XXXX------XXXX--
XXXX------XXXX--
XXXX------XXXX--
XXXX------XXXX--
XXXX------XXXX--
XXXX------XXXX--
XXXX------XXXX--
XXXX------XXXX--
XXXX------XXXX--
XXXX------XXXX--
XXXX------XXXX--
XXXX------XXXX--
XXXX------XXXX--
XXXX------XXXX--
XXXX------XXXX--
XXXX------XXXX--
XXXX------XXXX--
XXXX------XXXX--
XXXX------XXXX--
XXXX------XXXX--
XXXX------XXXX--
XXXX------XXXX--
XXXX------XXXX--
XXXX------XXXX--
XXXX------XXXX--
XXXX------XXXX--
XXXX------XXXX--
XXXX------XXXX--
XXXX------XXXX--
XXXX------XXXX--
XXXX------XXXX--
XXXX------XXXX--
XXXX------XXXX--
XXXX------XXXX--
XXXX------XXXX--
XXXX------XXXX--
XXXX------XXXX--
XXXX------XXXX--
XXXX------XXXX--
XXXX------XXXX--
XXXX------XXXX--
XXXX------XXXX--
XXXX------XXXX--
XXXX------XXXX--
XXXX------XXXX--
XXXX------XXXX--
XXXX------XXXX--
XXXX------XXXX--
XXXX------XXXX--
XXXX------XXXX--
XXXX------XXXX--
XXXX------XXXX--
XXXX------XXXX--
XXXX------XXXX--
XXXX------XXXX--
XXXX------XXXX--
XXXX------XXXX--
XXXX------XXXX--
XXXX------XXXX--
XXXX------XXXX--
XXXX------XXXX--
XXXX------XXXX--
XXXX------XXXX--
XXXX------XXXX--
XXXX------XXXX--
XXXX------XXXX--
XXXX------XXXX--
XXXX------XXXX--
XXXX------XXXX--
XXXX------XXXX--
XXXX------XXXX--
XXXX------XXXX--
XXXX------XXXX--
XXXX------XXXX--
XXXX------XXXX--
XXXX------XXXX--
XXXX------XXXX--
XXXX------XXXX--
XXXX------XXXX--
XXXX------XXXX--
XXXX------XXXX--
XXXX------XXXX--
XXXX------XXXX--
XXXX------XXXX--
XXXX------XXXX--
XXXX------XXXX--
XXXX------XXXX--
XXXX------XXXX--
XXXX------XXXX--
XXXX------XXXX--
XXXX------XXXX--
XXXX------XXXX--
XXXX------XXXX--
XXXX------XXXX--
XXXX------XXXX--
XXXX------XXXX--
XXXX------XXXX--
XXXX------XXXX--
XXXX------XXXX--
XXXX------XXXX--
XXXX------XXXX--
XXXX------XXXX--
XXXX------XXXX--
XXXX------XXXX--
XXXX------XXXX--
XXXX------XXXX--
XXXX------XXXX--
XXXX------XXXX--
XXXX------XXXX--
XXXX------XXXX--
XXXX------XXXX--
XXXX------XXXX--
XXXX------XXXX--
XXXX------XXXX--
XXXX------XXXX--
XXXX------XXXX--
XXXX------XXXX--
XXXX------XXXX--
XXXX------XXXX--
XXXX------XXXX--
XXXX------XXXX--
XXXX------XXXX--
XXXX------XXXX--
XXXX------XXXX--
XXXX------XXXX--
XXXX------XXXX--
XXXX------XXXX--
XXXX------XXXX--
XXXX------XXXX--
XXXX------XXXX--
XXXX------XXXX--
XXXX------XXXX--
XXXX------XXXX--
XXXX------XXXX--
XXXX------XXXX--
XXXX------XXXX--
XXXX------XXXX--
XXXX------XXXX--
XXXX------XXXX--
XXXX------XXXX--
XXXX------XXXX--
XXXX------XXXX--
XXXX------XXXX--
XXXX------XXXX--
XXXX------XXXX--
XXXX------XXXX--
XXXX------XXXX--
XXXX------XXXX--
XXXX------XXXX--
XXXX------XXXX--
XXXX------XXXX--
XXXX------XXXX--
XXXX------XXXX--
XXXX------XXXX--
XXXX------XXXX--
XXXX------XXXX--
XXXX------XXXX--
XXXX------XXXX--
XXXX------XXXX--
XXXX------XXXX--
XXXX------XXXX--
XXXX------XXXX--
XXXX------XXXX--
XXXX------XXXX--
XXXX------XXXX--
XXXX------XXXX--
XXXX------XXXX--
XXXX------XXXX--
XXXX-----XXXX---
XXXX--------XXXX
XXXX--------XXXX
XXXX--------XXXX
XXXX--------XXXX
XXXX--------XXXX
XXXX--------XXXX
XXXX--------XXXX
XXXX--------XXXX
XXXXXX------XXXX
XXXX--------XXXX
XXXX--------XXXX
XX----TTTTTTTTXX
XX------------XX
XX------------XX
XX-----------XXX
XXXX--------XXXX
XD----------XXXX
XD---------XXXXX
XXXXX---XXXXXXXX
XXXXXXXXXXXXXXXX