--------------------------------------------------------------------------------------------------------------------------------------------------------------------------------------------------------000000000000000
--------------------------------------------------------------------------------------------------------------------------------------------------------------------------------------------------------000000000000000
--------------------------------------------------------------------------------------------------------------------------------------------------------------------------------------------------------000000000000000
--------------------------------------------------------------------------------------------------------------------------------------------------------------------------------------------------------000000000000000
------------------------------------------------------------------------------------------------------------------------------------------E-------------------------------------------------------------000000000000000
--------------------------------------------------------------------------------------------------------------------------------------------------------------------------------------------------------000000000000000
--------------------------------------------------------------------------------------------------------------------------------------------------------------------------------------------------------000000000000000
------------------------------------------------------------------------------------------------------------------S---------------------------------------------------------XX--------------------------000000000000000
---------------------------------------------------------------------------------------------------------------------------------------------------------------------------XXX--------------------------000000000000000
--------------------------------------------------------------------------------------------------------------------------------------------------------------------------XXXX--------------------------000000000000000
--------------------------------------------------------------------------------------E-----------------------SSSS-------------------------------------------------X-----XXXXX--------------------------000000000000000
--------------------------S-----------------------------X---E-----XXX----------------<>----------------------------SS---E------------------------E----------------XXX----XXXXX-----X--------------------000000000000000
---------E---------------------------------------------------------------------------[]--------------------------------------------------------------------------XXXXX--XXXXXX-----X--------------------000000000000000
--------<>---------------------------------------------------------------------------[]-------------------------------------------------------------------------XXXXXXXXXXXXXX-----X-E------------------000000000000000
--------[]-------E---EE-------------------E-EE-----------------------------E---------[]------------------------------------------------------------------------XXXXXXXXXXXXXXX-----X------E-------------000000000000000
XXXXXX-XXXXXXXXXXXXXXXXXXXXXXXXXXXXXXXXXXXXXXXXXXXXXXXXXXXXXXXXXXXX----XXXXXXXXXXXXXXXXXXXXXXXXXXXXXXXXXXXXXXXXXXXXXXXXXXXXXXXX-XXXXXXXXXXXXXXXXXXXXXXXXXXXXXXXXXXXXXXXXXXXXXXXXXXXXXXXXXXXXXXXXXXXXXXXX000000000000000
00000000000000000000000000000000000000000000000000000000000000000000000000000000000000000000000000000000000000000000000000000000000000000000000000000000000000000000000000000000000000000000000000000000000000000000000