000000000000000000000000000000000000000000000000000000000000000000000000000000000000000000000000000000000000--------------------000000000000000
000000000000000000000000000000000000000000000000000000000000000000000000000000000000000000000000000000000000--------------------000000000000000
000000000000000000000000000000000000000000000000000000000000000000000000000000000000000000000000000000000000--------------------000000000000000
000000000000000000000000000000000000000000000000000000000000000000000000000000000000000000000000000000000000--------------------000000000000000
000000000000000000000000000000000000000000000000000000000000000000000000000000000000000000000000000000000000--------------------000000000000000
000000000000000000000000000000000000000000000000000000000000000000000000000000000000000000000000000000000000--------------------000000000000000
000000000000000000000000000000000000000000000000000000000000000000000000000000000000000000000000000000000000--------------------000000000000000
000000000000000000000000000000000000000000000000000000000000000000000000000000000000000000000000000000000000--------------------000000000000000
000000000000000000000000000000000000000000000000000000000000000000000000000000000000000000000000000000000000--------------------000000000000000
000000000000000000000000000000000000000000000000000000000000000000000000000000000000000000000000000000000000--------------------000000000000000
000000000000000000000000000000000000000000000000000000000000000000000000000000000000000000000000000000000000--------------------000000000000000
000000000000000000000000000000000000000000000000000000000000000000000000000000000000000000000000000000000000-------<>-----------000000000000000
000000000000000000000000000000000000000000000000000000000000000000000000000000000000000000000000000000000000-------[]-----------000000000000000
000000000000000000000000000000000000000000000000000000000000000000000000000000000000000000000000000000000000-------[]-----------000000000000000
000000000000000000000000000000000000000000000000000000000000000000000000000000000000000000000000000000000000-------[]-E---------000000000000000
00000000000000000000000000000000000000000000000000000000000000000000000000000000000000000000-TTTT------TTTTTXXXXXXXXXXXXXXXXXXX-000000000000000
00000000000000000000000000000000000000000000000000000000000000000000000000000000000000000000X---------------00000000000000000000000000000000000
00000000000000000000000000000000000000000000000000000000000000000000000000000000000000000000X---------------00000000000000000000000000000000000
00000000000000000000000000000000000000000000000000000000000000000000000000000000000000000000X------TTTT-----00000000000000000000000000000000000
00000000000000000000000000000000000000000000000000000000000000000000000000000000000000000000X---------------00000000000000000000000000000000000
00000000000000000000000000000000000000000000000000000000000000000000000000000000000000000000XX--------------00000000000000000000000000000000000
00000000000000000000000000000000000000000000000000000000000000000000000000000000000000000000XD--TTTT--------00000000000000000000000000000000000
00000000000000000000000000000000000000000000000000000000000000000000000000000000000000000000XD--------------00000000000000000000000000000000000
00000000000000000000000000000000000000000000000000000000000000000000000000000000000000000000XTTTT---E-------00000000000000000000000000000000000
00000000000000000000000000000000000000000000000000000000000000000000000000000000000000000000----------------00000000000000000000000000000000000
00000000000000000000000000000000000000000000000000000000000000000000000000000000000000000000----------------00000000000000000000000000000000000
00000000000000000000000000000000000000000000000000000000000000000000000000000000000000000000XXXX--------XXXX00000000000000000000000000000000000
00000000000000000000000000000000000000000000000000000000000000000000000000000000000000000000------------XXXX00000000000000000000000000000000000
00000000000000000000000000000000000000000000000000000000000000000000000000000000000000000000------------XXXX00000000000000000000000000000000000
00000000000000000000000000000000000000000000000000000000000000000000000000000000000000000000------------XXXX00000000000000000000000000000000000
00000000000000000000000000000000000000000000000000000000000000000000000000000000000000000000-XXXXX------XXXX00000000000000000000000000000000000
00000000000000000000000000000000000000000000000000000000000000000000000000000000000000000000XX----------XXXX00000000000000000000000000000000000
00000000000000000000000000000000000000000000000000000000000000000000000000000000000000000000XD-------------X00000000000000000000000000000000000
00000000000000000000000000000000000000000000000000000000000000000000000000000000000000000000XD-------------X00000000000000000000000000000000000
00000000000000000000000000000000000000000000000000000000000000000000000000000000000000000000XXXXXXXXXXX-----00000000000000000000000000000000000
00000000000000000000000000000000000000000000000000000000000000000000000000000000000000000000-------XX-------00000000000000000000000000000000000
00000000000000000000000000000000000000000000000000000000000000000000000000000000000000000000----------------00000000000000000000000000000000000
00000000000000000000000000000000000000000000000000000000000000000000000000000000000000000000---------XXXX---00000000000000000000000000000000000
00000000000000000000000000000000000000000000000000000000000000000000000000000000000000000000----------------00000000000000000000000000000000000
00000000000000000000000000000000000000000000000000000000000000000000000000000000000000000000XXXX--------XXXX00000000000000000000000000000000000
00000000000000000000000000000000000000000000000000000000000000000000000000000000000000000000-----E----------00000000000000000000000000000000000
00000000000000000000000000000000000000000000000000000000000000000000000000000000000000000000----TTT---------00000000000000000000000000000000000
00000000000000000000000000000000000000000000000000000000000000000000000000000000000000000000----------------00000000000000000000000000000000000
00000000000000000000000000000000000000000000000000000000000000000000000000000000000000000000------XXXX------00000000000000000000000000000000000
00000000000000000000000000000000000000000000000000000000000000000000000000000000000000000000----------------00000000000000000000000000000000000
00000000000000000000000000000000000000000000000000000000000000000000000000000000000000000000---TTTT---------00000000000000000000000000000000000
00000000000000000000000000000000000000000000000000000000000000000000000000000000000000000000XX--------------00000000000000000000000000000000000
00000000000000000000000000000000000000000000000000000000000000000000000000000000000000000000XX--------------00000000000000000000000000000000000
00000000000000000000000000000000000000000000000000000000000000000000000000000000000000000000XXXX--TTTT------00000000000000000000000000000000000
00000000000000000000000000000000000000000000000000000000000000000000000000000000000000000000XXXX------------00000000000000000000000000000000000
00000000000000000000000000000000000000000000000000000000000000000000000000000000000000000000XX-------------X00000000000000000000000000000000000
00000000000000000000000000000000000000000000000000000000000000000000000000000000000000000000XX----------TTTT00000000000000000000000000000000000
00000000000000000000000000000000000000000000000000000000000000000000000000000000000000000000XD-------------X00000000000000000000000000000000000
00000000000000000000000000000000000000000000000000000000000000000000000000000000000000000000XD-------------X00000000000000000000000000000000000
000000000000000000000000000000000000000000000000000000000000000000000000--------------------XXXXXXXXXXX-----00000000000000000000000000000000000
000000000000000000000000000000000000000000000000000000000000000000000000--------------------000000000000000000000000000000000000000000000000000
000000000000000000000000000000000000000000000000000000000000000000000000--------------------000000000000000000000000000000000000000000000000000
000000000000000000000000000000000000000000000000000000000000000000000000--------------------000000000000000000000000000000000000000000000000000
000000000000000000000000000000000000000000000000000000000000000000000000--------------------000000000000000000000000000000000000000000000000000
000000000000000000000000000000000000000000000000000000000000000000000000--------------------000000000000000000000000000000000000000000000000000
000000000000000000000000000000000000000000000000000000000000000000000000--------------------000000000000000000000000000000000000000000000000000
000000000000000000000000000000000000000000000000000000000000000000000000--------------------000000000000000000000000000000000000000000000000000
000000000000000000000000000000000000000000000000000000000000000000000000--------------------000000000000000000000000000000000000000000000000000
000000000000000000000000000000000000000000000000000000000000000000000000--------------------000000000000000000000000000000000000000000000000000
000000000000000000000000000000000000000000000000000000000000000000000000--------------------000000000000000000000000000000000000000000000000000
000000000000000000000000000000000000000000000000000000000000000000000000--------------------000000000000000000000000000000000000000000000000000
000000000000000000000000000000000000000000000000000000000000000000000000--------------------000000000000000000000000000000000000000000000000000
000000000000000000000000000000000000000000000000000000000000000000000000--------------------000000000000000000000000000000000000000000000000000
000000000000000000000000000000000000000000000000000000000000000000000000--------------------000000000000000000000000000000000000000000000000000
00000000000000000000000000000000000000000000000000000000--------------XXXXXXXXXXXXXX-XXXXXX-000000000000000000000000000000000000000000000000000
00000000000000000000000000000000000000000000000000000000-----------T-XXX00000000000000000000000000000000000000000000000000000000000000000000000
00000000000000000000000000000000000000000000000000000000-------XEEEEEEXX00000000000000000000000000000000000000000000000000000000000000000000000
00000000000000000000000000000000000000000000000000000000-----T-XXXXXX-X-00000000000000000000000000000000000000000000000000000000000000000000000
00000000000000000000000000000000000000000000000000000000----------------00000000000000000000000000000000000000000000000000000000000000000000000
00000000000000000000000000000000000000000000000000000000----------------00000000000000000000000000000000000000000000000000000000000000000000000
00000000000000000000000000000000000000000000000000000000----TTTT--------00000000000000000000000000000000000000000000000000000000000000000000000
00000000000000000000000000000000000000000000000000000000----------TTT---00000000000000000000000000000000000000000000000000000000000000000000000
00000000000000000000000000000000000000000000000000000000----------------00000000000000000000000000000000000000000000000000000000000000000000000
00000000000000000000000000000000000000000000000000000000----------------00000000000000000000000000000000000000000000000000000000000000000000000
00000000000000000000000000000000000000000000000000000000----XXXX--------00000000000000000000000000000000000000000000000000000000000000000000000
00000000000000000000000000000000000000000000000000000000XX--------------00000000000000000000000000000000000000000000000000000000000000000000000
00000000000000000000000000000000000000000000000000000000XX--------------00000000000000000000000000000000000000000000000000000000000000000000000
00000000000000000000000000000000000000000000000000000000XXXX--TTTT------00000000000000000000000000000000000000000000000000000000000000000000000
00000000000000000000000000000000000000000000000000000000XXXX------------00000000000000000000000000000000000000000000000000000000000000000000000
00000000000000000000000000000000000000000000000000000000XX-------------X00000000000000000000000000000000000000000000000000000000000000000000000
00000000000000000000000000000000000000000000000000000000XX----------TTTT00000000000000000000000000000000000000000000000000000000000000000000000
00000000000000000000000000000000000000000000000000000000XD-------------X00000000000000000000000000000000000000000000000000000000000000000000000
00000000000000000000000000000000000000000000000000000000XD-------------X00000000000000000000000000000000000000000000000000000000000000000000000
00000000000000000000000000000000000000000000000000000000XXXXXXXXXXX-----00000000000000000000000000000000000000000000000000000000000000000000000
00000000000000000000000000000000000000000000000000000000-------XXXX-----00000000000000000000000000000000000000000000000000000000000000000000000
00000000000000000000000000000000000000000000000000000000----------------00000000000000000000000000000000000000000000000000000000000000000000000
00000000000000000000000000000000000000000000000000000000---XXXXX--------00000000000000000000000000000000000000000000000000000000000000000000000
00000000000000000000000000000000000000000000000000000000-TTTT-----------00000000000000000000000000000000000000000000000000000000000000000000000
00000000000000000000000000000000000000000000000000000000----------------00000000000000000000000000000000000000000000000000000000000000000000000
00000000000000000000000000000000000000000000000000000000----------------00000000000000000000000000000000000000000000000000000000000000000000000
00000000000000000000000000000000000000000000000000000000---------XXXXXXX00000000000000000000000000000000000000000000000000000000000000000000000
00000000000000000000000000000000000000000000000000000000----------------00000000000000000000000000000000000000000000000000000000000000000000000
00000000000000000000000000000000000000000000000000000000------XXXX------00000000000000000000000000000000000000000000000000000000000000000000000
00000000000000000000000000000000000000000000000000000000----------------00000000000000000000000000000000000000000000000000000000000000000000000
00000000000000000000000000000000000000000000000000000000---TTTT---------00000000000000000000000000000000000000000000000000000000000000000000000
00000000000000000000000000000000000000000000000000000000XX--------------00000000000000000000000000000000000000000000000000000000000000000000000
00000000000000000000000000000000000000000000000000000000XX--------------00000000000000000000000000000000000000000000000000000000000000000000000
00000000000000000000000000000000000000000000000000000000XXXX--TTTT------00000000000000000000000000000000000000000000000000000000000000000000000
00000000000000000000000000000000000000000000000000000000XXXX------------00000000000000000000000000000000000000000000000000000000000000000000000
00000000000000000000000000000000000000000000000000000000XX-------------X00000000000000000000000000000000000000000000000000000000000000000000000
00000000000000000000000000000000000000000000000000000000XX----------TTTT00000000000000000000000000000000000000000000000000000000000000000000000
00000000000000000000000000000000000000000000000000000000XD-------------X00000000000000000000000000000000000000000000000000000000000000000000000
00000000000000000000000000000000000000000000000000000000XD-------------X00000000000000000000000000000000000000000000000000000000000000000000000
00000000000000000000000000000000000000000000000000000000XXXXXXXXXXX-----00000000000000000000000000000000000000000000000000000000000000000000000
00000000000000000000000000000000000000000000000000000000-XXXXXXXXXX----X00000000000000000000000000000000000000000000000000000000000000000000000
00000000000000000000000000000000000000000000000000000000XX------------XX00000000000000000000000000000000000000000000000000000000000000000000000
00000000000000000000000000000000000000000000000000000000XX------------XX00000000000000000000000000000000000000000000000000000000000000000000000
00000000000000000000000000000000000000000000000000000000XX----XXXXXXXXXX00000000000000000000000000000000000000000000000000000000000000000000000
00000000000000000000000000000000000000000000000000000000XX------------XX00000000000000000000000000000000000000000000000000000000000000000000000
00000000000000000000000000000000000000000000000000000000XX------------XX00000000000000000000000000000000000000000000000000000000000000000000000
00000000000000000000000000000000000000000000000000000000XX----------XXXX00000000000000000000000000000000000000000000000000000000000000000000000
00000000000000000000000000000000000000000000000000000000XXXX--------XXXX00000000000000000000000000000000000000000000000000000000000000000000000
000000000000000000000000000000000000--------------------XX----------XXXX00000000000000000000000000000000000000000000000000000000000000000000000
000000000000000000000000000000000000--------------------XX----------XXXX00000000000000000000000000000000000000000000000000000000000000000000000
000000000000000000000000000000000000--------------------XX----TTXXXXXXXX00000000000000000000000000000000000000000000000000000000000000000000000
000000000000000000000000000000000000--------------------XX--------------00000000000000000000000000000000000000000000000000000000000000000000000
000000000000000000000000000000000000--------------------XX--------------00000000000000000000000000000000000000000000000000000000000000000000000
000000000000000000000000000000000000--------------------XXXX--TTTT------00000000000000000000000000000000000000000000000000000000000000000000000
000000000000000000000000000000000000--------------------XXXX------------00000000000000000000000000000000000000000000000000000000000000000000000
000000000000000000000000000000000000-------------Q------XX-------------X00000000000000000000000000000000000000000000000000000000000000000000000
000000000000000000000000000000000000--------------------XX----------TTTT00000000000000000000000000000000000000000000000000000000000000000000000
000000000000000000000000000000000000--------------------XD-------------X00000000000000000000000000000000000000000000000000000000000000000000000
000000000000000000000000000000000000--------------------XD-------------X00000000000000000000000000000000000000000000000000000000000000000000000
000000000000000000000000000000000000------------------<EXXXXXXXXXXX-----00000000000000000000000000000000000000000000000000000000000000000000000
000000000000000000000000000000000000------------------[>000000000000000000000000000000000000000000000000000000000000000000000000000000000000000
000000000000000000000000000000000000------------------[]000000000000000000000000000000000000000000000000000000000000000000000000000000000000000
000000000000000000000000000000000000---------EE-------[]000000000000000000000000000000000000000000000000000000000000000000000000000000000000000
00000000000000000000--XXXX------XXXXXXXXXXXXXXXXX-XXXXX]000000000000000000000000000000000000000000000000000000000000000000000000000000000000000
00000000000000000000-XXXX------XXXX-00000000000000000000000000000000000000000000000000000000000000000000000000000000000000000000000000000000000
00000000000000000000-XXXX------XXXX-00000000000000000000000000000000000000000000000000000000000000000000000000000000000000000000000000000000000
00000000000000000000-XXXX------XXXX-00000000000000000000000000000000000000000000000000000000000000000000000000000000000000000000000000000000000
00000000000000000000-XXXX------XXXX-00000000000000000000000000000000000000000000000000000000000000000000000000000000000000000000000000000000000
00000000000000000000-XXXX------XXXX-00000000000000000000000000000000000000000000000000000000000000000000000000000000000000000000000000000000000
00000000000000000000-XXXX------XXXX-00000000000000000000000000000000000000000000000000000000000000000000000000000000000000000000000000000000000
00000000000000000000-XXXX------XXXX-00000000000000000000000000000000000000000000000000000000000000000000000000000000000000000000000000000000000
00000000000000000000-XXXX------XXXX-00000000000000000000000000000000000000000000000000000000000000000000000000000000000000000000000000000000000
00000000000000000000XX----------XXXX00000000000000000000000000000000000000000000000000000000000000000000000000000000000000000000000000000000000
00000000000000000000XX----TTXXXXXXXX00000000000000000000000000000000000000000000000000000000000000000000000000000000000000000000000000000000000
00000000000000000000XX--------------00000000000000000000000000000000000000000000000000000000000000000000000000000000000000000000000000000000000
00000000000000000000XX--------------00000000000000000000000000000000000000000000000000000000000000000000000000000000000000000000000000000000000
00000000000000000000XXXX--TTTT------00000000000000000000000000000000000000000000000000000000000000000000000000000000000000000000000000000000000
00000000000000000000XXXX------------00000000000000000000000000000000000000000000000000000000000000000000000000000000000000000000000000000000000
00000000000000000000XX-------------X00000000000000000000000000000000000000000000000000000000000000000000000000000000000000000000000000000000000
00000000000000000000XX----------TTTT00000000000000000000000000000000000000000000000000000000000000000000000000000000000000000000000000000000000
00000000000000000000XD-------------X00000000000000000000000000000000000000000000000000000000000000000000000000000000000000000000000000000000000
00000000000000000000XD-------------X00000000000000000000000000000000000000000000000000000000000000000000000000000000000000000000000000000000000
--------------------XXXXXXXXXXX-----00000000000000000000000000000000000000000000000000000000000000000000000000000000000000000000000000000000000
--------------------000000000000000000000000000000000000000000000000000000000000000000000000000000000000000000000000000000000000000000000000000
--------------------000000000000000000000000000000000000000000000000000000000000000000000000000000000000000000000000000000000000000000000000000
--------------------000000000000000000000000000000000000000000000000000000000000000000000000000000000000000000000000000000000000000000000000000
--------------------000000000000000000000000000000000000000000000000000000000000000000000000000000000000000000000000000000000000000000000000000
--------------------000000000000000000000000000000000000000000000000000000000000000000000000000000000000000000000000000000000000000000000000000
--------------------000000000000000000000000000000000000000000000000000000000000000000000000000000000000000000000000000000000000000000000000000
--------------------000000000000000000000000000000000000000000000000000000000000000000000000000000000000000000000000000000000000000000000000000
--------------------000000000000000000000000000000000000000000000000000000000000000000000000000000000000000000000000000000000000000000000000000
--------------------000000000000000000000000000000000000000000000000000000000000000000000000000000000000000000000000000000000000000000000000000
--------------E-----000000000000000000000000000000000000000000000000000000000000000000000000000000000000000000000000000000000000000000000000000
---------------XX---000000000000000000000000000000000000000000000000000000000000000000000000000000000000000000000000000000000000000000000000000
--------------------000000000000000000000000000000000000000000000000000000000000000000000000000000000000000000000000000000000000000000000000000
-----------X--------000000000000000000000000000000000000000000000000000000000000000000000000000000000000000000000000000000000000000000000000000
--------------------000000000000000000000000000000000000000000000000000000000000000000000000000000000000000000000000000000000000000000000000000
XXXXXXXX------------000000000000000000000000000000000000000000000000000000000000000000000000000000000000000000000000000000000000000000000000000
00000000000000000000000000000000000000000000000000000000000000000000000000000000000000000000000000000000000000000000000000000000000000000000000