000000000000000000000000000000000000000000000000000000000000000000000000000000000000000000000000000000000000000000000000000000000000000000000000000000000000----------------------------------------000000000000000
000000000000000000000000000000000000000000000000000000000000000000000000000000000000000000000000000000000000000000000000000000000000000000000000000000000000----------------------------------------000000000000000
000000000000000000000000000000000000000000000000000000000000000000000000000000000000000000000000000000000000000000000000000000000000000000000000000000000000----------------------------------------000000000000000
000000000000000000000000000000000000000000000000000000000000000000000000000000000000000000000000000000000000000000000000000000000000000000000000000000000000----------------------------------------000000000000000
000000000000000000000000000000000000000000000000000000000000000000000000000000000000000000000000000000000000000000000000000000000000000000000000000000000000----------------------------------------000000000000000
000000000000000000000000000000000000000000000000000000000000000000000000000000000000000000000000000000000000000000000000000000000000000000000000000000000000----------------------------------------000000000000000
000000000000000000000000000000000000000000000000000000000000000000000000000000000000000000000000000000000000000000000000000000000000000000000000000000000000----------------------------------------000000000000000
000000000000000000000000000000000000000000000000000000000000000000000000000000000000000000000000000000000000000000000000000000000000000000000000000000000000----------------------------------------000000000000000
000000000000000000000000000000000000000000000000000000000000000000000000000000000000000000000000000000000000000000000000000000000000000000000000000000000000----------------------------------------000000000000000
000000000000000000000000000000000000000000000000000000000000000000000000000000000000000000000000000000000000000000000000000000000000000000000000000000000000----------------------------------------000000000000000
000000000000000000000000000000000000000000000000000000000000000000000000000000000000000000000000000000000000000000000000000000000000000000000000000000000000-----------E----------------------------000000000000000
000000000000000000000000000000000000000000000000000000000000000000000000000000000000000000000000000000000000000000000000000000000000000000000000000000000000----------<>-------------XX--X----------000000000000000
000000000000000000000000000000000000000000000000000000000000000000000000000000000000000000000000000000000000000000000000000000000000000000000000000000000000-------X--[]------------XXX-XX--E-------000000000000000
000000000000000000000000000000000000000000000000000000000000000000000000000000000000000000000000000000000000000000000000000000000000000000000000000000000000-------X--[]-----------XXXXXXX----------000000000000000
00000000000000000000000000000000000000000000000000000000000000000000000000000000000000000000000000000000000000000000000000000000000000000000--------TTTT---------X-X--[]----------XXXX-XXX----------000000000000000
00000000000000000000000000000000000000000000000000000000000000000000000000000000000000000000000000000000000000000000000000000000000000000000----------------XXXXXXXXXXXXXXXXXXXXXXXXXX-XXXXXXXXXXXXX000000000000000
00000000000000000000000000000000000000000000000000000000000000000000000000000000000000000000000000000000000000000000000000000000000000000000--TTTT---TTTT---0000000000000000000000000000000000000000000000000000000
00000000000000000000000000000000000000000000000000000000000000000000000000000000000000000000000000000000000000000000000000000000000000000000----------------0000000000000000000000000000000000000000000000000000000
------------------------------------------------------------------------------------------------------------------------------------------------------------0000000000000000000000000000000000000000000000000000000
--------------------------------------------------------------------------------------------------------------------------------------------XX----------XXXX0000000000000000000000000000000000000000000000000000000
--------------------------------------------------------------------------------------------------------------------------------------------XX-----------XXX0000000000000000000000000000000000000000000000000000000
--------------------------------------------------------------------------------------------------------------------------------------------XX-----------XXX0000000000000000000000000000000000000000000000000000000
--------------------------------------------------------------------------------------------------------------------------------------------XX-----------XXX0000000000000000000000000000000000000000000000000000000
--------------------------------------------------------------------------------------------------------------------------------------------XX-----------XXX0000000000000000000000000000000000000000000000000000000
----------------------------------------------------------X---------------------------------------------------------------------------------XX-----------XXX0000000000000000000000000000000000000000000000000000000
------------------------------------------------SSS-------XX----------------------------------------------SSSS------------------------------XX-----------XXX0000000000000000000000000000000000000000000000000000000
----------------------------------------------------------XX--------------------------------------------------------------------------------XX-----------XXX0000000000000000000000000000000000000000000000000000000
----------------------------------------------------------XX-------------------X------------------------------------------------------------XX-----------XXX0000000000000000000000000000000000000000000000000000000
------------X--E------------------------------------------XX-----------------XXX------------------------------------------------------------XX-----------XXX0000000000000000000000000000000000000000000000000000000
-----------XX-->--S----------------------------X----------XX----------------XXXX------------------------------------------------------------XX-----------XXX0000000000000000000000000000000000000000000000000000000
----------XXX-<]-------------------------------X-----------X---------------XXXXX--------------E---------------------------------------------XD-----------XXX0000000000000000000000000000000000000000000000000000000
---------XXXX-[]-------------S-----------------X--------------------------XXXXXX-------------<>-----------------------<>--------------------XD-----------XXX0000000000000000000000000000000000000000000000000000000
---E----XXXXX-[]-E-------X----------E-E--------X--E-E-------------------XXXXXXXX-------------[]----------------E-E-E--[]----------E----X----XXXXXXXXXXXXXXXX0000000000000000000000000000000000000000000000000000000
XXXXXXXXXXXXXXXXXXXXXXXXXXXXXXXXXXXXXXXXXXXXXXXXXXXXXXXXXXXXXXXXXXXXXXXXXXXXXXX-XXXXXXXXXXXXXXXXXXXXXXXXXXXXXXXXXXXXXXXXXXXXXXXXXXXXXXXXXXXXXXXXXXXXXXXXXXXX0000000000000000000000000000000000000000000000000000000
0000000000000000000000000000000000000000000000000000000000000000000000000000000000000000000000000000000000000000000000000000000000000000000000000000000000000000000000000000000000000000000000000000000000000000000