000000000000000000000000000000000000000000000000000000000000000000000000000000000000000000000000000000000000----------------
000000000000000000000000000000000000000000000000000000000000000000000000000000000000000000000000000000000000---------XXXXXXX
000000000000000000000000000000000000000000000000000000000000000000000000000000000000000000000000000000000000----------------
000000000000000000000000000000000000000000000000000000000000000000000000000000000000000000000000000000000000------XXXX------
000000000000000000000000000000000000000000000000000000000000000000000000000000000000000000000000000000000000----------------
000000000000000000000000000000000000000000000000000000000000000000000000000000000000000000000000000000000000---TTTT---------
000000000000000000000000000000000000000000000000000000000000000000000000000000000000000000000000000000000000----------------
000000000000000000000000000000000000000000000000000000000000000000000000000000000000000000000000000000000000------TTTT------
000000000000000000000000000000000000000000000000000000000000000000000000000000000000000000000000000000000000----------------
000000000000000000000000000000000000000000000000000000000000000000000000000000000000000000000000000000000000---------TTTT---
000000000000000000000000000000000000000000000000000000000000000000000000000000000000000000000000000000000000----------------
000000000000000000000000000000000000000000000000000000000000000000000000000000000000000000000000000000000000XXXX--------TTTT
000000000000000000000000000000000000000000000000000000000000000000000000000000000000000000000000000000000000----------------
000000000000000000000000000000000000000000000000000000000000000000000000000000000000000000000000000000000000----TTTT--------
000000000000000000000000000000000000000000000000000000000000000000000000000000000000000000000000000000000000----------------
000000000000000000000000000000000000000000000000000000000000000000000000000000000000000000000000000000000000XX-----------XXX
000000000000000000000000000000000000000000000000000000000000000000000000000000000000000000000000000000000000XX----------TTTT
000000000000000000000000000000000000000000000000000000000000000000000000000000000000000000000000000000000000XD-------------X
000000000000000000000000000000000000000000000000000000000000000000000000000000000000000000000000000000000000XD-------------X
000000000000000000000000000000000000000000000000000000000000000000000000000000000000000000000000000000000000XXXXXXXXXXX-----
000000000000000000000000000000000000000000000000000000000000000000000000000000000000000000000000000000000000----------XXXX--
000000000000000000000000000000000000000000000000000000000000000000000000000000000000000000000000000000000000----------------
000000000000000000000000000000000000000000000000000000000000000000000000000000000000000000000000000000000000----------------
000000000000000000000000000000000000000000000000000000000000000000000000000000000000000000000000000000000000MMMMMMMMMMMMMMMM
000000000000000000000000000000000000000000000000000000000000000000000000000000000000000000000000000000000000----------------
000000000000000000000000000000000000000000000000000000000000000000000000000000000000000000000000000000000000----------------
000000000000000000000000000000000000000000000000000000000000000000000000000000000000000000000000000000000000-----TT---------
000000000000000000000000000000000000000000000000000000000000000000000000000000000000000000000000000000000000----------------
000000000000000000000000000000000000000000000000000000000000000000000000000000000000000000000000000000000000---E-----E------
000000000000000000000000000000000000000000000000000000000000000000000000000000000000000000000000000000000000MMMMMMMMMMMMMMMX
000000000000000000000000000000000000000000000000000000000000000000000000000000000000000000000000000000000000----------------
000000000000000000000000000000000000000000000000000000000000000000000000000000000000000000000000000000000000--E--------E----
000000000000000000000000000000000000000000000000000000000000000000000000000000000000000000000000000000000000MMMMMMMMMMMMMMMM
000000000000000000000000000000000000000000000000000000000000000000000000000000000000000000000000000000000000----------------
000000000000000000000000000000000000000000000000000000000000000000000000000000000000000000000000000000000000----------------
000000000000000000000000000000000000000000000000000000000000000000000000000000000000000000000000000000000000-XXXXMMMMMMMMMMM
000000000000000000000000000000000000000000000000000000000000000000000000000000000000000000000000000000000000XX----------XXXX
000000000000000000000000000000000000000000000000000000000000000000000000000000000000000000000000000000000000XD-------------X
000000000000000000000000000000000000000000000000000000000000000000000000000000000000000000000000000000000000XD-------------X
000000000000000000000000000000000000000000000000000000000000000000000000000000000000000000000000000000000000XXXXXXXXXXX-----
000000000000000000000000000000000000000000000000000000000000000000000000000000000000000000000000000000000000----------------
000000000000000000000000000000000000000000000000000000000000000000000000000000000000000000000000000000000000----------------
000000000000000000000000000000000000000000000000000000000000000000000000000000000000000000000000000000000000-----TT--TT-----
000000000000000000000000000000000000000000000000000000000000000000000000000000000000000000000000000000000000----------------
000000000000000000000000000000000000000000000000000000000000000000000000000000000000000000000000000000000000----------------
000000000000000000000000000000000000000000000000000000000000000000000000000000000000000000000000000000000000--------TTTT----
000000000000000000000000000000000000000000000000000000000000000000000000000000000000000000000000000000000000----------------
000000000000000000000000000000000000000000000000000000000000000000000000000000000000000000000000000000000000--TTTTTTTT------
000000000000000000000000000000000000000000000000000000000000000000000000000000000000000000000000000000000000----------------
000000000000000000000000000000000000000000000000000000000000000000000000000000000000000000000000000000000000----------------
000000000000000000000000000000000000000000000000000000000000000000000000000000000000000000000000000000000000------------XXXX
000000000000000000000000000000000000000000000000000000000000000000000000000000000000000000000000000000000000----------------
000000000000000000000000000000000000000000000000000000000000000000000000000000000000000000000000000000000000--------TTT-----
000000000000000000000000000000000000000000000000000000000000000000000000000000000000000000000000000000000000----------------
000000000000000000000000000000000000000000000000000000000000000000000000000000000000000000000000000000000000----------------
000000000000000000000000000000000000000000000000000000000000000000000000000000000000000000000000000000000000XX------TTTTTTTT
000000000000000000000000000000000000000000000000000000000000000000000000000000000000000000000000000000000000XX-------------X
000000000000000000000000000000000000000000000000000000000000000000000000000000000000000000000000000000000000XD-------------X
000000000000000000000000000000000000000000000000000000000000000000000000000000000000000000000000000000000000XD-------------X
0000000000000000000000000000000000000000000000000000000000000000000000000000000000000000--------------------XXXXXXXXXXX-----
0000000000000000000000000000000000000000000000000000000000000000000000000000000000000000--------------------0000000000000000
0000000000000000000000000000000000000000000000000000000000000000000000000000000000000000--------------------0000000000000000
0000000000000000000000000000000000000000000000000000000000000000000000000000000000000000--------------------0000000000000000
0000000000000000000000000000000000000000000000000000000000000000000000000000000000000000--------------------0000000000000000
0000000000000000000000000000000000000000000000000000000000000000000000000000000000000000--------------------0000000000000000
0000000000000000000000000000000000000000000000000000000000000000000000000000000000000000--------------------0000000000000000
0000000000000000000000000000000000000000000000000000000000000000000000000000000000000000---------S----------0000000000000000
0000000000000000000000000000000000000000000000000000000000000000000000000000000000000000--------------------0000000000000000
0000000000000000000000000000000000000000000000000000000000000000000000000000000000000000--------------------0000000000000000
0000000000000000000000000000000000000000000000000000000000000000000000000000000000000000--------------------0000000000000000
0000000000000000000000000000000000000000000000000000000000000000000000000000000000000000--------------------0000000000000000
0000000000000000000000000000000000000000000000000000000000000000000000000000000000000000-------E------------0000000000000000
0000000000000000000000000000000000000000000000000000000000000000000000000000000000000000--------------------0000000000000000
000000000000000000000000000000000000000000000000000000000000000000000000------------------------------EE-E--0000000000000000
000000000000000000000000000000000000000000000000000000000000000000000000----------------XXXXXXXXXXXXXXXXXXX-0000000000000000
000000000000000000000000000000000000000000000000000000000000000000000000MMMMMMMMMXMMMMMM000000000000000000000000000000000000
000000000000000000000000000000000000000000000000000000000000000000000000----------------000000000000000000000000000000000000
000000000000000000000000000000000000000000000000000000000000000000000000----------------000000000000000000000000000000000000
000000000000000000000000000000000000000000000000000000000000000000000000---------X------000000000000000000000000000000000000
000000000000000000000000000000000000000000000000000000000000000000000000-----E---X---E--000000000000000000000000000000000000
000000000000000000000000000000000000000000000000000000000000000000000000MMMMMMMMMXMMMMMM000000000000000000000000000000000000
000000000000000000000000000000000000000000000000000000000000000000000000----------------000000000000000000000000000000000000
000000000000000000000000000000000000000000000000000000000000000000000000----------------000000000000000000000000000000000000
000000000000000000000000000000000000000000000000000000000000000000000000----XXXX--------000000000000000000000000000000000000
000000000000000000000000000000000000000000000000000000000000000000000000XX--------------000000000000000000000000000000000000
000000000000000000000000000000000000000000000000000000000000000000000000XX--------------000000000000000000000000000000000000
000000000000000000000000000000000000000000000000000000000000000000000000XXXX--TTTT------000000000000000000000000000000000000
000000000000000000000000000000000000000000000000000000000000000000000000XXXX------------000000000000000000000000000000000000
000000000000000000000000000000000000000000000000000000000000000000000000XX-------------X000000000000000000000000000000000000
000000000000000000000000000000000000000000000000000000000000000000000000XX----------TTTT000000000000000000000000000000000000
000000000000000000000000000000000000000000000000000000000000000000000000XD-------------X000000000000000000000000000000000000
000000000000000000000000000000000000000000000000000000000000000000000000XD-------------X000000000000000000000000000000000000
0000000000000000000000000000000000000000000000000000--------------------XXXXXXXXXXX-----000000000000000000000000000000000000
0000000000000000000000000000000000000000000000000000--------------------0000000000000000000000000000000000000000000000000000
0000000000000000000000000000000000000000000000000000--------------------0000000000000000000000000000000000000000000000000000
0000000000000000000000000000000000000000000000000000--------------------0000000000000000000000000000000000000000000000000000
0000000000000000000000000000000000000000000000000000--------------------0000000000000000000000000000000000000000000000000000
0000000000000000000000000000000000000000000000000000--------------------0000000000000000000000000000000000000000000000000000
0000000000000000000000000000000000000000000000000000--------------------0000000000000000000000000000000000000000000000000000
0000000000000000000000000000000000000000000000000000--------------------0000000000000000000000000000000000000000000000000000
0000000000000000000000000000000000000000000000000000--------------------0000000000000000000000000000000000000000000000000000
0000000000000000000000000000000000000000000000000000--------------------0000000000000000000000000000000000000000000000000000
0000000000000000000000000000000000000000000000000000--------E-----------0000000000000000000000000000000000000000000000000000
0000000000000000000000000000000000000000000000000000-------<>-----------0000000000000000000000000000000000000000000000000000
0000000000000000000000000000000000000000000000000000-------[]-----------0000000000000000000000000000000000000000000000000000
0000000000000000000000000000000000000000000000000000-------[]-----------0000000000000000000000000000000000000000000000000000
0000000000000000000000000000000000000000000000000000-------[]-----------0000000000000000000000000000000000000000000000000000
000000000000000000000000000000000000-XXXX--------XXXXXXXXXXXXXXXXXXXXXX-0000000000000000000000000000000000000000000000000000
000000000000000000000000000000000000-----E----------000000000000000000000000000000000000000000000000000000000000000000000000
000000000000000000000000000000000000----TTT---------000000000000000000000000000000000000000000000000000000000000000000000000
000000000000000000000000000000000000----------------000000000000000000000000000000000000000000000000000000000000000000000000
000000000000000000000000000000000000------XXXX------000000000000000000000000000000000000000000000000000000000000000000000000
000000000000000000000000000000000000----------------000000000000000000000000000000000000000000000000000000000000000000000000
000000000000000000000000000000000000---TTTT---------000000000000000000000000000000000000000000000000000000000000000000000000
000000000000000000000000000000000000--------------E-000000000000000000000000000000000000000000000000000000000000000000000000
000000000000000000000000000000000000XX----------XXXX000000000000000000000000000000000000000000000000000000000000000000000000
000000000000000000000000000000000000XX--------------000000000000000000000000000000000000000000000000000000000000000000000000
000000000000000000000000000000000000XX-----TTTT-----000000000000000000000000000000000000000000000000000000000000000000000000
000000000000000000000000000000000000XX--------------000000000000000000000000000000000000000000000000000000000000000000000000
000000000000000000000000000000000000XX--------------000000000000000000000000000000000000000000000000000000000000000000000000
000000000000000000000000000000000000XXXX--TTTT------000000000000000000000000000000000000000000000000000000000000000000000000
000000000000000000000000000000000000XXXX------------000000000000000000000000000000000000000000000000000000000000000000000000
000000000000000000000000000000000000XX-------------X000000000000000000000000000000000000000000000000000000000000000000000000
000000000000000000000000000000000000XX----------TTTT000000000000000000000000000000000000000000000000000000000000000000000000
000000000000000000000000000000000000XD-------------X000000000000000000000000000000000000000000000000000000000000000000000000
000000000000000000000000000000000000XD-------------X000000000000000000000000000000000000000000000000000000000000000000000000
000000000000000000000000000000000000XXXXXXXXXXX-----000000000000000000000000000000000000000000000000000000000000000000000000
000000000000000000000000000000000000----------------000000000000000000000000000000000000000000000000000000000000000000000000
000000000000000000000000000000000000----------------000000000000000000000000000000000000000000000000000000000000000000000000
000000000000000000000000000000000000---------XXXX---000000000000000000000000000000000000000000000000000000000000000000000000
000000000000000000000000000000000000----------------000000000000000000000000000000000000000000000000000000000000000000000000
000000000000000000000000000000000000----------------000000000000000000000000000000000000000000000000000000000000000000000000
0000000000000000-----------------------------XXXXXXX000000000000000000000000000000000000000000000000000000000000000000000000
0000000000000000------------------------------------000000000000000000000000000000000000000000000000000000000000000000000000
0000000000000000---------------------X--------------000000000000000000000000000000000000000000000000000000000000000000000000
0000000000000000--------------------XX----------XXXX000000000000000000000000000000000000000000000000000000000000000000000000
0000000000000000--------------------XX--------------000000000000000000000000000000000000000000000000000000000000000000000000
0000000000000000--------------------XX--------------000000000000000000000000000000000000000000000000000000000000000000000000
0000000000000000--------------------XXXXMMMMMMMMMMMM000000000000000000000000000000000000000000000000000000000000000000000000
0000000000000000--------------SSQ---XXXX------------000000000000000000000000000000000000000000000000000000000000000000000000
0000000000000000-------------S------XXXX------------000000000000000000000000000000000000000000000000000000000000000000000000
0000000000000000--------------------XXXXXXXXX-------000000000000000000000000000000000000000000000000000000000000000000000000
0000000000000000-----------SSSS-----XX--------------000000000000000000000000000000000000000000000000000000000000000000000000
0000000000000000----------------Q---XX----------TTTT000000000000000000000000000000000000000000000000000000000000000000000000
0000000000000000--------------------XD-------------X000000000000000000000000000000000000000000000000000000000000000000000000
0000000000000000--------------------XD-------------X000000000000000000000000000000000000000000000000000000000000000000000000
0000000000000000-------------E-E---<XXXXXXXXXXX-----000000000000000000000000000000000000000000000000000000000000000000000000
----------------XXXXXXXXXXXXXXXXXXX[0000000000000000000000000000000000000000000000000000000000000000000000000000000000000000
XMMMMMMMMMMMMMMM000000000000000000000000000000000000000000000000000000000000000000000000000000000000000000000000000000000000
----------------000000000000000000000000000000000000000000000000000000000000000000000000000000000000000000000000000000000000
----E--------E--000000000000000000000000000000000000000000000000000000000000000000000000000000000000000000000000000000000000
MMMMMMMMMMMMMMMM000000000000000000000000000000000000000000000000000000000000000000000000000000000000000000000000000000000000
----------------000000000000000000000000000000000000000000000000000000000000000000000000000000000000000000000000000000000000
-X--------------000000000000000000000000000000000000000000000000000000000000000000000000000000000000000000000000000000000000
XX----------XXXX000000000000000000000000000000000000000000000000000000000000000000000000000000000000000000000000000000000000
XX--------------000000000000000000000000000000000000000000000000000000000000000000000000000000000000000000000000000000000000
XX--------------000000000000000000000000000000000000000000000000000000000000000000000000000000000000000000000000000000000000
XXXXMMMMMMMMMMMM000000000000000000000000000000000000000000000000000000000000000000000000000000000000000000000000000000000000
XXXX------------000000000000000000000000000000000000000000000000000000000000000000000000000000000000000000000000000000000000
XXXX------------000000000000000000000000000000000000000000000000000000000000000000000000000000000000000000000000000000000000
XXXX------------000000000000000000000000000000000000000000000000000000000000000000000000000000000000000000000000000000000000
XXXX------------000000000000000000000000000000000000000000000000000000000000000000000000000000000000000000000000000000000000
XX-------------X000000000000000000000000000000000000000000000000000000000000000000000000000000000000000000000000000000000000
XX----------TTTT000000000000000000000000000000000000000000000000000000000000000000000000000000000000000000000000000000000000
XD-------------X000000000000000000000000000000000000000000000000000000000000000000000000000000000000000000000000000000000000
XD-------------X000000000000000000000000000000000000000000000000000000000000000000000000000000000000000000000000000000000000
XXXXXXXXXXX-----000000000000000000000000000000000000000000000000000000000000000000000000000000000000000000000000000000000000