------------------------------------000000000000000000000000000000000000000000000000000000000000000000000000000000000000000000000000000000000000000000000000000000000000000000000000000000000000000000000000000000000000000000000000000000000
------------------------------------000000000000000000000000000000000000000000000000000000000000000000000000000000000000000000000000000000000000000000000000000000000000000000000000000000000000000000000000000000000000000000000000000000000
------------------------------------000000000000000000000000000000000000000000000000000000000000000000000000000000000000000000000000000000000000000000000000000000000000000000000000000000000000000000000000000000000000000000000000000000000
------------------------------------000000000000000000000000000000000000000000000000000000000000000000000000000000000000000000000000000000000000000000000000000000000000000000000000000000000000000000000000000000000000000000000000000000000
--------------------------------E---000000000000000000000000000000000000000000000000000000000000000000000000000000000000000000000---------------------------------------------------------------------------------------------000000000000000
------------------------------------0000000000000000-------------------------------------------------------------0000000000000000---------------------------------------------------------------------------------------------000000000000000
------------------------------------0000000000000000-------------------------------------------------------------0000000000000000---------------------------------------------------------------------------------------------000000000000000
------------------------------------0000000000000000-------------------------------------------------------------0000000000000000---------------------------------------------------------------------------------------------000000000000000
------------------------------------0000000000000000-----------------------------------------------------------------------------SSSSSSSSSSSSSSSSSSSSSSSSSSSSSSSSSSSSSSSSSSSSSSSSSSSSSSSSSSSSSSSSSSSSSSSSSSSSSSSSSSSSSSSSSSSSS000000000000000
------------------------------------0000000000000000--------------------------------------------------------------------------X-----------------------------------------------------------------------------------------------000000000000000
------------------------------------0000000000000000--------------------------------------------------------------------------X-----------------------------------------------------------------------------------------------000000000000000
------------------------------------0000000000000000--------------------------------------------------------------------------X----------------S----S-------------------------------------------------------------------------000000000000000
-----E------------------------------0000000000000000--------------------------------------------------------------------------X---------------------S------------------S------------------------------------------------------000000000000000
------------------------------------0000000000000000-o------------------------------------------------------------------------X--------------------SS-------------------------------------------------------------------------000000000000000
---------------------------E----XX--0000000000000000------------------------------------------------------------------------------------------------S----------------X----------E-----------------------------------------E--E000000000000000
XXXXXXXXXXXXXXXXXXXXXXXXXXXXXXXXXXXX-----------D---Xo-------------------------------------------E----------------------------------------------SS---S-----------------X--------<>------------------------------------X---->-<>000000000000000
0000000000000000000000000000000000000000000000000000-------------------------------------------<>--------------XX---------XXXXXX--------------------------------------------E--[]---------------------XXX------------X---<]-[]000000000000000
0000000000000000000000000000000000000000000000000000---------------------E---------------------[]--------E-----XX0000000000000000-----------E-E----------------------------<>--[]--------------------XXXX------------X---[]-[]000000000000000
0000000000000000000000000000000000000000000000000000--------------------<>---------------------[]--------------XX0000000000000000--------------------------E-E-E---------E-[]--[]--------------------XXXX----------EEX---[]-[]000000000000000
0000000000000000000000000000000000000000000000000000--------------------[]----X-E-EE-E---------[]--------------XX0000000000000000-X--XXXXXXXXXXXXXXXXXXXXXXXXXXXXXXXXXXXXXXXXXXXXXXXXXXXX--X--XXX--XXXXXXXXXXXXXXXXXXXXXXXXXXX000000000000000
0000000000000000000000000000000000000000000000000000XXXXXXXXXXXXXXXXXXXXXXXXXXXXXXXXXXXXXXXXXXXXXXXXXXXXXXXXXXXXX0000000000000000000000000000000000000000000000000000000000000000000000000000000000000000000000000000000000000000000000000000
000000000000000000000000000000000000000000000000000000000000000000000000000000000000000000000000000000000000000000000000000000000000000000000000000000000000000000000000000000000000000000000000000000000000000000000000000000000000000000000