00000000000000000000000000000000000000000000000000000000--XXXX--------XX
00000000000000000000000000000000000000000000000000000000XXXX--------XXXX
00000000000000000000000000000000000000000000000000000000XXXX--------XXXX
00000000000000000000000000000000000000000000000000000000XXXX--------XXXX
00000000000000000000000000000000000000000000000000000000XXXX--------XXXX
00000000000000000000000000000000000000000000000000000000XXXX--------XXXX
00000000000000000000000000000000000000000000000000000000XXXX--------XXXX
00000000000000000000000000000000000000000000000000000000XXXX--------XXXX
00000000000000000000000000000000000000000000000000000000XXXX--------XXXX
00000000000000000000000000000000000000000000000000000000XXXX--------XXXX
00000000000000000000000000000000000000000000000000000000XXXX--------XXXX
00000000000000000000000000000000000000000000000000000000XX----TTTTTTTTXX
00000000000000000000000000000000000000000000000000000000XX------------XX
00000000000000000000000000000000000000000000000000000000XX------------XX
00000000000000000000000000000000000000000000000000000000XX--------XXXXXX
00000000000000000000000000000000000000000000000000000000XD-------------X
00000000000000000000000000000000000000000000000000000000XD-------------X
00000000000000000000000000000000000000000000000000000000TTTTXXXXXXXX--DX
00000000000000000000000000000000000000000000000000000000--TTTTTTTT----DX
00000000000000000000000000000000000000000000000000000000---------TTTTTTT
00000000000000000000000000000000000000000000000000000000----------------
00000000000000000000000000000000000000000000000000000000----------------
00000000000000000000000000000000000000000000000000000000----XXXXX-------
00000000000000000000000000000000000000000000000000000000----------------
00000000000000000000000000000000000000000000000000000000XXXX----------XX
00000000000000000000000000000000000000000000000000000000-------------XXX
00000000000000000000000000000000000000000000000000000000-------------XXX
00000000000000000000000000000000000000000000000000000000X-----XXXXXXXXXX
00000000000000000000000000000000000000000000000000000000---------TTTTTTT
00000000000000000000000000000000000000000000000000000000X-----------TTTT
00000000000000000000000000000000000000000000000000000000X--------------X
00000000000000000000000000000000000000000000000000000000X--------------X
00000000000000000000000000000000000000000000000000000000XXXXXXXXX------X
00000000000000000000000000000000000000000000000000000000XX-------------X
00000000000000000000000000000000000000000000000000000000XX---------TTTTT
00000000000000000000000000000000000000000000000000000000XD-------------X
00000000000000000000000000000000000000000000000000000000XD-------------X
00000000000000000000000000000000000000000000000000000000TTTTXXXXXXXX--DX
00000000000000000000000000000000000000000000000000000000--TTTTTTTT----DX
00000000000000000000000000000000000000000000000000000000---------TTTTTTT
00000000000000000000000000000000000000000000000000000000--XXXX--------XX
00000000000000000000000000000000000000000000000000000000----------------
00000000000000000000000000000000000000000000000000000000---------TTT----
00000000000000000000000000000000000000000000000000000000----------------
00000000000000000000000000000000000000000000000000000000X-----------TTTT
00000000000000000000000000000000000000000000000000000000X--------------X
00000000000000000000000000000000000000000000000000000000X--------------X
00000000000000000000000000000000000000000000000000000000XXXXXXXXXX-----X
00000000000000000000000000000000000000000000000000000000XX------------XX
00000000000000000000000000000000000000000000000000000000XX------------XX
00000000000000000000000000000000000000000000000000000000XX----XXXXXXXXXX
0000000000000000----------------------------------------XX------------XX
0000000000000000----------------------------------------XX------------XX
0000000000000000----------------------------------------XX----XXXXX---XX
0000000000000000----------------------------------------XX------------XX
0000000000000000----------------------------------------XD------------XX
0000000000000000----------------------------------------XD-------------X
0000000000000000----------------------------------------TTTTXXXXXXXX--DX
0000000000000000-------------------------------SSSSSSS----TTTTTTTT----DX
0000000000000000---------------------------------------S---------TTTTTTT
0000000000000000----------------------------------------0000000000000000
0000000000000000----------------------------------------0000000000000000
0000000000000000-------------------------<E-------------0000000000000000
0000000000000000-----------------E-------[>-------------0000000000000000
0000000000000000----------------<>-------[]-------------0000000000000000
0000000000000000----------E-----[]-------[]-------------0000000000000000
----------------XXXXXXXXXXXXXXXXXXX-XXXXXXXXXXXXXXXXXXX-0000000000000000
-----T----------00000000000000000000000000000000000000000000000000000000
----------------00000000000000000000000000000000000000000000000000000000
----------------00000000000000000000000000000000000000000000000000000000
----------------00000000000000000000000000000000000000000000000000000000
-------------X--00000000000000000000000000000000000000000000000000000000
----------------00000000000000000000000000000000000000000000000000000000
----------------00000000000000000000000000000000000000000000000000000000
----XXXX--------00000000000000000000000000000000000000000000000000000000
XX--------------00000000000000000000000000000000000000000000000000000000
XX--------------00000000000000000000000000000000000000000000000000000000
XXXX--TTTT------00000000000000000000000000000000000000000000000000000000
XXXX------------00000000000000000000000000000000000000000000000000000000
XX-------------X00000000000000000000000000000000000000000000000000000000
XX----------TTTT00000000000000000000000000000000000000000000000000000000
XD-------------X00000000000000000000000000000000000000000000000000000000
XD-------------X00000000000000000000000000000000000000000000000000000000
TTTTXXXXXXXX--DX00000000000000000000000000000000000000000000000000000000
--TTTTTTTT----DX00000000000000000000000000000000000000000000000000000000
---------TTTTTTT00000000000000000000000000000000000000000000000000000000
-----------XXXX-00000000000000000000000000000000000000000000000000000000
----------------00000000000000000000000000000000000000000000000000000000
----------------00000000000000000000000000000000000000000000000000000000
MMMMMMMMMMMMMMMM00000000000000000000000000000000000000000000000000000000
----------------00000000000000000000000000000000000000000000000000000000
-X--------------00000000000000000000000000000000000000000000000000000000
XX----------XXXX00000000000000000000000000000000000000000000000000000000
XX--------------00000000000000000000000000000000000000000000000000000000
XX--------------00000000000000000000000000000000000000000000000000000000
XXXXMMMMMMMMMMMM00000000000000000000000000000000000000000000000000000000
XXXX------------00000000000000000000000000000000000000000000000000000000
XXXX------------00000000000000000000000000000000000000000000000000000000
XXXX------------00000000000000000000000000000000000000000000000000000000
XX--------------00000000000000000000000000000000000000000000000000000000
XX----------TTTT00000000000000000000000000000000000000000000000000000000
XD-------------X00000000000000000000000000000000000000000000000000000000
XD-------------X00000000000000000000000000000000000000000000000000000000
TTTTXXXXXXXX--DX00000000000000000000000000000000000000000000000000000000
--TTTTTTTT----DX00000000000000000000000000000000000000000000000000000000
---------TTTTTTT00000000000000000000000000000000000000000000000000000000
--XXXXXXXX------00000000000000000000000000000000000000000000000000000000
--------------XX00000000000000000000000000000000000000000000000000000000
--------------XX00000000000000000000000000000000000000000000000000000000
-X------------XX00000000000000000000000000000000000000000000000000000000
XX----------XXXX00000000000000000000000000000000000000000000000000000000
XX--------------00000000000000000000000000000000000000000000000000000000
XX--------------00000000000000000000000000000000000000000000000000000000
XXXXMMMMMMMMMMMM00000000000000000000000000000000000000000000000000000000
XXXX------------00000000000000000000000000000000000000000000000000000000
XXXX------------00000000000000000000000000000000000000000000000000000000
----------------00000000000000000000000000000000000000000000000000000000
---TTTT---------00000000000000000000000000000000000000000000000000000000
----------------00000000000000000000000000000000000000000000000000000000
----------------00000000000000000000000000000000000000000000000000000000
XX-----TTTT---XX00000000000000000000000000000000000000000000000000000000
XX------------XX00000000000000000000000000000000000000000000000000000000
XD-------------X00000000000000000000000000000000000000000000000000000000
TTTTXXXXXXXX--DX00000000000000000000000000000000000000000000000000000000
--TTTTTTTT----DX00000000000000000000000000000000000000000000000000000000
---------TTTTTTT00000000000000000000000000000000000000000000000000000000
----------------00000000000000000000000000000000000000000000000000000000
-----TT---------00000000000000000000000000000000000000000000000000000000
----------------00000000000000000000000000000000000000000000000000000000
----------------00000000000000000000000000000000000000000000000000000000
XX------TTTT--XX00000000000000000000000000000000000000000000000000000000
XX------------XX00000000000000000000000000000000000000000000000000000000
XX------------XX00000000000000000000000000000000000000000000000000000000
XTTTT---E-----XX00000000000000000000000000000000000000000000000000000000
XXXX--------XXXX00000000000000000000000000000000000000000000000000000000
XXXX--------XXXX00000000000000000000000000000000000000000000000000000000
XXXXXXX-----XXXX00000000000000000000000000000000000000000000000000000000
XXXX--------XXXX00000000000000000000000000000000000000000000000000000000
XX------------XX00000000000000000000000000000000000000000000000000000000
XX----XXXXXXXXXX00000000000000000000000000000000000000000000000000000000
XX--------XXXXXX00000000000000000000000000000000000000000000000000000000
XD-------------X00000000000000000000000000000000000000000000000000000000
XD-------------X00000000000000000000000000000000000000000000000000000000
TTTTXXXXXXXX--DX00000000000000000000000000000000000000000000000000000000
--TTTTTTTT----DX00000000000000000000000000000000000000000000000000000000
---------TTTTTTT00000000000000000000000000000000000000000000000000000000
----------------00000000000000000000000000000000000000000000000000000000
------XXXX------00000000000000000000000000000000000000000000000000000000
----------------00000000000000000000000000000000000000000000000000000000
---------XXXX---00000000000000000000000000000000000000000000000000000000
----------------00000000000000000000000000000000000000000000000000000000
XXXXXXXX----XXXX00000000000000000000000000000000000000000000000000000000
X-----------DXXX00000000000000000000000000000000000000000000000000000000
X-----------DXXX00000000000000000000000000000000000000000000000000000000
X---T--XXXXXXXXX00000000000000000000000000000000000000000000000000000000
X--------------X00000000000000000000000000000000000000000000000000000000
X--------------X00000000000000000000000000000000000000000000000000000000
XXXXXXXXX------X00000000000000000000000000000000000000000000000000000000
XX-------------X00000000000000000000000000000000000000000000000000000000
XX--------TTTTTT00000000000000000000000000000000000000000000000000000000
XD-------------X00000000000000000000000000000000000000000000000000000000
XD-------------X00000000000000000000000000000000000000000000000000000000
XD-------------X00000000000000000000000000000000000000000000000000000000
TTTTXXXXXXXX--DX00000000000000000000000000000000000000000000000000000000
--TTTTTTTT----DX00000000000000000000000000000000000000000000000000000000
---------TTTTTTT00000000000000000000000000000000000000000000000000000000