000000000000000000000000000000000000000000000000000000000000000000000000000000000000000000000000000000000000000000000000000000000000000000000000000000000000----------------------------------------000000000000000
000000000000000000000000000000000000000000000000000000000000000000000000000000000000000000000000000000000000000000000000000000000000000000000000000000000000----------------------------------------000000000000000
000000000000000000000000000000000000000000000000000000000000000000000000000000000000000000000000000000000000000000000000000000000000000000000000000000000000----------------------------------------000000000000000
000000000000000000000000000000000000000000000000000000000000000000000000000000000000000000000000000000000000000000000000000000000000000000000000000000000000----------------------------------------000000000000000
000000000000000000000000000000000000000000000000000000000000000000000000000000000000000000000000000000000000000000000000000000000000000000000000000000000000----------------------------------------000000000000000
000000000000000000000000000000000000000000000000000000000000000000000000000000000000000000000000000000000000000000000000000000000000000000000000000000000000----------------------------------------000000000000000
000000000000000000000000000000000000000000000000000000000000000000000000000000000000000000000000000000000000000000000000000000000000000000000000000000000000----------------------------------------000000000000000
000000000000000000000000000000000000000000000000000000000000000000000000000000000000000000000000000000000000000000000000000000000000000000000000000000000000----------------------------------------000000000000000
000000000000000000000000000000000000000000000000000000000000000000000000000000000000000000000000000000000000000000000000000000000000000000000000000000000000----------------------------------------000000000000000
000000000000000000000000000000000000000000000000000000000000000000000000000000000000000000000000000000000000000000000000000000000000000000000000000000000000----------------------------------------000000000000000
000000000000000000000000000000000000000000000000000000000000000000000000000000000000000000000000000000000000000000000000000000000000000000000000000000000000----------------------------------------000000000000000
000000000000000000000000000000000000000000000000000000000000000000000000000000000000000000000000000000000000000000000000000000000000000000000000000000000000----------------------------------------000000000000000
000000000000000000000000000000000000000000000000000000000000000000000000000000000000000000000000000000000000000000000000000000000000000000000000000000000000---------------------------------E------000000000000000
000000000000000000000000000000000000000000000000000000000000000000000000000000000000000000000000000000000000000000000000000000000000000000000000000000000000--------------------------------<>------000000000000000
000000000000000000000000000000000000000000000000000000000000000000000000000000000000000000000000000000000000000000000000000000000000000000000000000000000000----------------------------EE--[]------000000000000000
00000000000000000000000000000000000000000000000000000000000000000000000000000000000000000000000000000000000000000000000000000000000000000000X--------------XXXXXXXXXXXXXXXXXXXXXXXXXXXXXXXXXXXXXXXXX000000000000000
00000000000000000000000000000000000000000000000000000000000000000000000000000000000000000000000000000000000000000000000000000000000000000000X-----------D--X0000000000000000000000000000000000000000000000000000000
00000000000000000000000000000000000000000000000000000000000000000000000000000000000000000000000000000000000000000000000000000000000000000000X----------DXXXX0000000000000000000000000000000000000000000000000000000
00000000000000000000000000000000000000000000000000000000000000000000000000000000000000000000000000000000000000000000000000000000000000000000X-----XXXXXXXXXX0000000000000000000000000000000000000000000000000000000
--------------------------------------------------------------------------------------------------------------------------------------------X----XXXXXXXXXXX0000000000000000000000000000000000000000000000000000000
--------------------------------------------------------------------------------------------------------------------------------------------XXXXE----XXXX---0000000000000000000000000000000000000000000000000000000
--------------------------------------------------------------------------------------------------------------------------------------------XX-------XXXX---0000000000000000000000000000000000000000000000000000000
--------------------------------------------------------------------------------------------------------------------------------------------XX--------------0000000000000000000000000000000000000000000000000000000
--------------------------------------------------------------------------------------------------------------------------------------------XXXX--------XXXX0000000000000000000000000000000000000000000000000000000
--------------------------------------------------------------------------------------------------------------------------------------------XXXX--------XXXX0000000000000000000000000000000000000000000000000000000
--------------------------------------------------------E-----------------------------------------------------------------------------------XXTTTT------XXXX0000000000000000000000000000000000000000000000000000000
--------------------------------------XX-------------Q--------------------------------------------------------------------------------------XXXX--------XXXX0000000000000000000000000000000000000000000000000000000
-------------------------------------XXX----------------------------------------------------------------X-----------------------------------XXXX--------XXXX0000000000000000000000000000000000000000000000000000000
------------------------------------XXXX----------------------------------------------------------------X-----------------------------------XXXXXX------XXXX0000000000000000000000000000000000000000000000000000000
-------E---------------------------XXXXX-------------------E-------------------------------------------XX--------E------------------SQ------XXXXXXXX--------0000000000000000000000000000000000000000000000000000000
------<>---oo----------E----------XXXXXX-----------QQS----<>--------------E---------E--E---SS---------XXX-------<>--SS-----------------E----XX----------TTTT0000000000000000000000000000000000000000000000000000000
------[]--------------<>--------EXXXXXXX------------------[]--------------E--------<>-<>--------------XXX-------[]--------------------------XX----------T--X0000000000000000000000000000000000000000000000000000000
------[]--------------[]--------XXXXXXXX------------------[]-----------------------[]-[]--------------XXX-------[]--------------------------XD-------------X0000000000000000000000000000000000000000000000000000000
---EEE[]-------EE-E---[]--------XXXXXXXX------------------[]----------E------------[]-[]--------------XXX-------[]--------------EEE---------XD-------------X0000000000000000000000000000000000000000000000000000000
XXXXXXXXXXXXXXXXXXXXXXXXXXXXXXXXXXXXXXXXXXXXXXXXXXXXXXXXXXXXXXXXXXXXXXXXXXXXXXXXXXXXXXXXXXXXXXXXXXXXXXXXXXXXXXXXXXXXXXXXXXXXXXXXXXXXXXXXXXXXXXXXXXXXXXX-----0000000000000000000000000000000000000000000000000000000
0000000000000000000000000000000000000000000000000000000000000000000000000000000000000000000000000000000000000000000000000000000000000000000000000000000000000000000000000000000000000000000000000000000000000000000