0000000000000000-0000000000000000000000000000000000000000000000000000000000000000000000000000000000000000000000000000000000000000000000
0000000000000000-0000000000000000---------------------------------------------------------------------------------------000000000000000
0000000000000000-0000000000000000---------------------------------------------------------------------------------------000000000000000
0000000000000000-0000000000000000---------------------------------------------------------------------------------------000000000000000
0000000000000000-0000000000000000---------------------------------------------------------------------------------------000000000000000
0000000000000000-0000000000000000---------------------------------------------------------------------------------------000000000000000
0000000000000000-0000000000000000---------------------------------------------------------------------------------------000000000000000
0000000000000000-0000000000000000---------------------------------------------------------------------------------------000000000000000
0000000000000000-0000000000000000------------------------------------------------------------------------SS----------XX-000000000000000
0000000000000000-0000000000000000------------------------------------------------------------------------------------XX-000000000000000
---------------------------------X--------------------------------------------------------------------------------X-XXX-000000000000000
----------------X-----X--------------------------------E-----------E--------------------------------------------X-XXXXXX000000000000000
XXXXXXX----------0000000000000000---------------------<>--E-------<>-------------------------------------------XX-XXXXXX000000000000000
-----------------0000000000000000---------------------[]----------[]---------------------X---------------------XX-XXXXXX000000000000000
------TTTT-------0000000000000000---------------------[]----------[]---------------------X---------------------XX--XXXXX000000000000000
-----------------0000000000000000---------------------[]---E---E--[]--------------E-EE-E-X--------XXX----------XX--XXXXX000000000000000
---------XXXX---00000000000000000XXXXXXXXXXXXXXX--XXXXXXXXXXXXXXXXXXXXXXXXXXXXXXXXXXXXXXXXXXXXXXXXXXXXXXXXXXXXXXXXXXXXXX000000000000000
----------------00000000000000000000000000000000000000000000000000000000000000000000000000000000000000000000000000000000000000000000000
XXXX--------XXXX00000000000000000000000000000000000000000000000000000000000000000000000000000000000000000000000000000000000000000000000
----------------00000000000000000000000000000000000000000000000000000000000000000000000000000000000000000000000000000000000000000000000
----------------00000000000000000000000000000000000000000000000000000000000000000000000000000000000000000000000000000000000000000000000
----TTTT--------00000000000000000000000000000000000000000000000000000000000000000000000000000000000000000000000000000000000000000000000
----------------00000000000000000000000000000000000000000000000000000000000000000000000000000000000000000000000000000000000000000000000
----------------00000000000000000000000000000000000000000000000000000000000000000000000000000000000000000000000000000000000000000000000
------TTTT------00000000000000000000000000000000000000000000000000000000000000000000000000000000000000000000000000000000000000000000000
----------------00000000000000000000000000000000000000000000000000000000000000000000000000000000000000000000000000000000000000000000000
---------XXXX---00000000000000000000000000000000000000000000000000000000000000000000000000000000000000000000000000000000000000000000000
----------------00000000000000000000000000000000000000000000000000000000000000000000000000000000000000000000000000000000000000000000000
---E---E--------00000000000000000000000000000000000000000000000000000000000000000000000000000000000000000000000000000000000000000000000
MMMMMMMMMMMMMMMM00000000000000000000000000000000000000000000000000000000000000000000000000000000000000000000000000000000000000000000000
----------------00000000000000000000000000000000000000000000000000000000000000000000000000000000000000000000000000000000000000000000000
----------------00000000000000000000000000000000000000000000000000000000000000000000000000000000000000000000000000000000000000000000000
---------TTT----00000000000000000000000000000000000000000000000000000000000000000000000000000000000000000000000000000000000000000000000
----------------00000000000000000000000000000000000000000000000000000000000000000000000000000000000000000000000000000000000000000000000
---------XXXX---00000000000000000000000000000000000000000000000000000000000000000000000000000000000000000000000000000000000000000000000
----XEEE--XX----00000000000000000000000000000000000000000000000000000000000000000000000000000000000000000000000000000000000000000000000
XXXXX------XXXXX00000000000000000000000000000000000000000000000000000000000000000000000000000000000000000000000000000000000000000000000
----------XX----00000000000000000000000000000000000000000000000000000000000000000000000000000000000000000000000000000000000000000000000
----------XX----00000000000000000000000000000000000000000000000000000000000000000000000000000000000000000000000000000000000000000000000
--TTTT----------00000000000000000000000000000000000000000000000000000000000000000000000000000000000000000000000000000000000000000000000
----------------00000000000000000000000000000000000000000000000000000000000000000000000000000000000000000000000000000000000000000000000
----------------00000000000000000000000000000000000000000000000000000000000000000000000000000000000000000000000000000000000000000000000
X----------TTTT-00000000000000000000000000000000000000000000000000000000000000000000000000000000000000000000000000000000000000000000000
X---------------00000000000000000000000000000000000000000000000000000000000000000000000000000000000000000000000000000000000000000000000
X---------------00000000000000000000000000000000000000000000000000000000000000000000000000000000000000000000000000000000000000000000000
X--------TTTT---00000000000000000000000000000000000000000000000000000000000000000000000000000000000000000000000000000000000000000000000
X---------------00000000000000000000000000000000000000000000000000000000000000000000000000000000000000000000000000000000000000000000000
X---------------00000000000000000000000000000000000000000000000000000000000000000000000000000000000000000000000000000000000000000000000
XXXX--------XXXX00000000000000000000000000000000000000000000000000000000000000000000000000000000000000000000000000000000000000000000000
XXXX--------XXXX00000000000000000000000000000000000000000000000000000000000000000000000000000000000000000000000000000000000000000000000
XXTTTT------XXXX00000000000000000000000000000000000000000000000000000000000000000000000000000000000000000000000000000000000000000000000
XXXX--------XXXX00000000000000000000000000000000000000000000000000000000000000000000000000000000000000000000000000000000000000000000000
XXXX--------XXXX00000000000000000000000000000000000000000000000000000000000000000000000000000000000000000000000000000000000000000000000
XXXX-T------XXXX00000000000000000000000000000000000000000000000000000000000000000000000000000000000000000000000000000000000000000000000
X-----------DXXX00000000000000000000000000000000000000000000000000000000000000000000000000000000000000000000000000000000000000000000000
X----------DXXXX00000000000000000000000000000000000000000000000000000000000000000000000000000000000000000000000000000000000000000000000
X-----XXXXXXXXXX00000000000000000000000000000000000000000000000000000000000000000000000000000000000000000000000000000000000000000000000
X-------XXXXXXXX00000000000000000000000000000000000000000000000000000000000000000000000000000000000000000000000000000000000000000000000
X-----------XXXX00000000000000000000000000000000000000000000000000000000000000000000000000000000000000000000000000000000000000000000000
X-------------XX00000000000000000000000000000000000000000000000000000000000000000000000000000000000000000000000000000000000000000000000
X-------------XX00000000000000000000000000000000000000000000000000000000000000000000000000000000000000000000000000000000000000000000000
X-------------XX00000000000000000000000000000000000000000000000000000000000000000000000000000000000000000000000000000000000000000000000
X-------------XX00000000000000000000000000000000000000000000000000000000000000000000000000000000000000000000000000000000000000000000000
X-------------XX00000000000000000000000000000000000000000000000000000000000000000000000000000000000000000000000000000000000000000000000
X-------------XX00000000000000000000000000000000000000000000000000000000000000000000000000000000000000000000000000000000000000000000000
X-------------XX00000000000000000000000000000000000000000000000000000000000000000000000000000000000000000000000000000000000000000000000
X-------------XX00000000000000000000000000000000000000000000000000000000000000000000000000000000000000000000000000000000000000000000000
X-------------XX00000000000000000000000000000000000000000000000000000000000000000000000000000000000000000000000000000000000000000000000
X-------------XX00000000000000000000000000000000000000000000000000000000000000000000000000000000000000000000000000000000000000000000000
X-----XXXX----XX00000000000000000000000000000000000000000000000000000000000000000000000000000000000000000000000000000000000000000000000
X-------------XX00000000000000000000000000000000000000000000000000000000000000000000000000000000000000000000000000000000000000000000000
X-------------XX00000000000000000000000000000000000000000000000000000000000000000000000000000000000000000000000000000000000000000000000
X-------------XX00000000000000000000000000000000000000000000000000000000000000000000000000000000000000000000000000000000000000000000000
X-------------DX00000000000000000000000000000000000000000000000000000000000000000000000000000000000000000000000000000000000000000000000
X-------------DX00000000000000000000000000000000000000000000000000000000000000000000000000000000000000000000000000000000000000000000000
X-----XXXXXXXXXX00000000000000000000000000000000000000000000000000000000000000000000000000000000000000000000000000000000000000000000000
X-----XXXXXXXXXX00000000000000000000000000000000000000000000000000000000000000000000000000000000000000000000000000000000000000000000000
XXXX--------XXXX00000000000000000000000000000000000000000000000000000000000000000000000000000000000000000000000000000000000000000000000
XXXX--------XXXX00000000000000000000000000000000000000000000000000000000000000000000000000000000000000000000000000000000000000000000000
XTTTTTTTT---XXXX00000000000000000000000000000000000000000000000000000000000000000000000000000000000000000000000000000000000000000000000
XXXX--------XXXX00000000000000000000000000000000000000000000000000000000000000000000000000000000000000000000000000000000000000000000000
XXXX--------XXXX00000000000000000000000000000000000000000000000000000000000000000000000000000000000000000000000000000000000000000000000
XXXX-----TTTT---00000000000000000000000000000000000000000000000000000000000000000000000000000000000000000000000000000000000000000000000
XXXX--------XXXX00000000000000000000000000000000000000000000000000000000000000000000000000000000000000000000000000000000000000000000000
XXXX--------XXXX00000000000000000000000000000000000000000000000000000000000000000000000000000000000000000000000000000000000000000000000
XXXX--XXXX--XXXX00000000000000000000000000000000000000000000000000000000000000000000000000000000000000000000000000000000000000000000000
XXXX--------XXXX00000000000000000000000000000000000000000000000000000000000000000000000000000000000000000000000000000000000000000000000
XXXX--------XXXX00000000000000000000000000000000000000000000000000000000000000000000000000000000000000000000000000000000000000000000000
XTTTTTTTT---XXXX00000000000000000000000000000000000000000000000000000000000000000000000000000000000000000000000000000000000000000000000
XXXX--------XXXX00000000000000000000000000000000000000000000000000000000000000000000000000000000000000000000000000000000000000000000000
XXXX--------XXXX00000000000000000000000000000000000000000000000000000000000000000000000000000000000000000000000000000000000000000000000
XXXX-----TTTTXXX00000000000000000000000000000000000000000000000000000000000000000000000000000000000000000000000000000000000000000000000
XXXX--------XXXX00000000000000000000000000000000000000000000000000000000000000000000000000000000000000000000000000000000000000000000000
XXXX--------XXXX00000000000000000000000000000000000000000000000000000000000000000000000000000000000000000000000000000000000000000000000
XXTTTT------XXXX00000000000000000000000000000000000000000000000000000000000000000000000000000000000000000000000000000000000000000000000
XXXX--------XXXX00000000000000000000000000000000000000000000000000000000000000000000000000000000000000000000000000000000000000000000000
XXXX--------XXXX00000000000000000000000000000000000000000000000000000000000000000000000000000000000000000000000000000000000000000000000
XXXX-T------XXXX00000000000000000000000000000000000000000000000000000000000000000000000000000000000000000000000000000000000000000000000
X-----------DXXX00000000000000000000000000000000000000000000000000000000000000000000000000000000000000000000000000000000000000000000000
X----------DXXXX00000000000000000000000000000000000000000000000000000000000000000000000000000000000000000000000000000000000000000000000
X-----XXXXXXXXXX00000000000000000000000000000000000000000000000000000000000000000000000000000000000000000000000000000000000000000000000
X------XX-------00000000000000000000000000000000000000000000000000000000000000000000000000000000000000000000000000000000000000000000000
X-----XXXX------00000000000000000000000000000000000000000000000000000000000000000000000000000000000000000000000000000000000000000000000
-----E----------00000000000000000000000000000000000000000000000000000000000000000000000000000000000000000000000000000000000000000000000
----TTT---------00000000000000000000000000000000000000000000000000000000000000000000000000000000000000000000000000000000000000000000000
----------------00000000000000000000000000000000000000000000000000000000000000000000000000000000000000000000000000000000000000000000000
------XXXX------00000000000000000000000000000000000000000000000000000000000000000000000000000000000000000000000000000000000000000000000
----------------00000000000000000000000000000000000000000000000000000000000000000000000000000000000000000000000000000000000000000000000
---------XXXX---00000000000000000000000000000000000000000000000000000000000000000000000000000000000000000000000000000000000000000000000
----------------00000000000000000000000000000000000000000000000000000000000000000000000000000000000000000000000000000000000000000000000
X-----------TTTT00000000000000000000000000000000000000000000000000000000000000000000000000000000000000000000000000000000000000000000000
X--------------X00000000000000000000000000000000000000000000000000000000000000000000000000000000000000000000000000000000000000000000000
X--------------X00000000000000000000000000000000000000000000000000000000000000000000000000000000000000000000000000000000000000000000000
XXXXXXXXX------X00000000000000000000000000000000000000000000000000000000000000000000000000000000000000000000000000000000000000000000000
XX-------------X00000000000000000000000000000000000000000000000000000000000000000000000000000000000000000000000000000000000000000000000
XX--------TTTTTT00000000000000000000000000000000000000000000000000000000000000000000000000000000000000000000000000000000000000000000000
XD-------------X00000000000000000000000000000000000000000000000000000000000000000000000000000000000000000000000000000000000000000000000
XD-------------X00000000000000000000000000000000000000000000000000000000000000000000000000000000000000000000000000000000000000000000000
XXXXX---XXXXXXXX00000000000000000000000000000000000000000000000000000000000000000000000000000000000000000000000000000000000000000000000
XXXXXXXXXXXXXXXX00000000000000000000000000000000000000000000000000000000000000000000000000000000000000000000000000000000000000000000000