0000000000000000000000000000000000000000000000000000000000000000000000000000000000000000000000000000000000000000--------------------------------------------------------------------------------000000000000000
0000000000000000000000000000000000000000000000000000000000000000000000000000000000000000000000000000000000000000--------------------------------------------------------------------------------000000000000000
0000000000000000000000000000000000000000000000000000000000000000000000000000000000000000000000000000000000000000--------------------------------------------------------------------------------000000000000000
0000000000000000000000000000000000000000000000000000000000000000000000000000000000000000000000000000000000000000--------------------------------------------------------------------------------000000000000000
0000000000000000000000000000000000000000000000000000000000000000000000000000000000000000000000000000000000000000--------------------------------------------------------------------------------000000000000000
0000000000000000000000000000000000000000000000000000000000000000000000000000000000000000000000000000000000000000--------------------------------------------------------------------------------000000000000000
0000000000000000000000000000000000000000000000000000000000000000000000000000000000000000000000000000000000000000--------------------------------------------------------------------------------000000000000000
0000000000000000000000000000000000000000000000000000000000000000000000000000000000000000000000000000000000000000--------------------------------------------------------------------------------000000000000000
0000000000000000000000000000000000000000000000000000000000000000000000000000000000000000000000000000000000000000-----------------------------------------------------XS-------------------------000000000000000
0000000000000000000000000000000000000000000000000000000000000000000000000000000000000000000000000000000000000000---------------------------------------------------X-XX-------------------------000000000000000
0000000000000000000000000000000000000000000000000000000000000000000000000000000000000000000000000000000000000000-------------------------E------------------E------XXXS-E-----------------------000000000000000
0000000000000000000000000000000000000000000000000000000000000000000000000000000000000000000000000000000000000000---E--------------------<>-----------------<>------XXXX-X-----------------------000000000000000
0000000000000000000000000000000000000000000000000000000000000000000000000000000000000000000000000000000000000000--<>------E-------------[]-----------------[]------XXXX-X----------------XXXXX--000000000000000
0000000000000000000000000000000000000000000000000000000000000000000000000000000000000000000000000000000000000000--[]-----<>-------------[]-----------------[]------XXXX-X-----------------------000000000000000
000000000000000000000000000000000000000000000000000000000000000000000000000000000000000000000000------------------[]--E--[]-------------[]---E-------------[]------XXXX-X-----------------------000000000000000
000000000000000000000000000000000000000000000000000000000000000000000000000000000000000000000000----------------XXXXXXXXXXXXXXXXX---XXXXXXXXXXXXXXXXXXX-XXXXXXX----XXX--XXXEXXXXXXX-------------000000000000000
000000000000000000000000000000000000000000000000000000000000000000000000000000000000000000000000---------TTT----00000000000000000000000000000000000000000000000000000000000000000000000000000000000000000000000
000000000000000000000000000000000000000000000000000000000000000000000000000000000000000000000000----------------00000000000000000000000000000000000000000000000000000000000000000000000000000000000000000000000
000000000000000000000000000000000000000000000000000000000000000000000000000000000000000000000000XX----------TTTT00000000000000000000000000000000000000000000000000000000000000000000000000000000000000000000000
000000000000000000000000000000000000000000000000000000000000000000000000000000000000000000000000XX-------------X00000000000000000000000000000000000000000000000000000000000000000000000000000000000000000000000
000000000000000000000000000000000000000000000000000000000000000000000000000000000000000000000000----------------00000000000000000000000000000000000000000000000000000000000000000000000000000000000000000000000
000000000000000000000000000000000000000000000000000000000000000000000000000000000000000000000000---TTTT---------00000000000000000000000000000000000000000000000000000000000000000000000000000000000000000000000
000000000000000000000000000000000000000000000000000000000000000000000000000000000000000000000000----------------00000000000000000000000000000000000000000000000000000000000000000000000000000000000000000000000
000000000000000000000000000000000000000000000000000000000000000000000000000000000000000000000000----------------00000000000000000000000000000000000000000000000000000000000000000000000000000000000000000000000
000000000000000000000000000000000000000000000000000000000000000000000000000000000000000000000000XX-----TTTT---XX00000000000000000000000000000000000000000000000000000000000000000000000000000000000000000000000
000000000000000000000000000000000000000000000000000000000000000000000000000000000000000000000000XX------------XX00000000000000000000000000000000000000000000000000000000000000000000000000000000000000000000000
000000000000000000000000000000000000000000000000000000000000000000000000000000000000000000000000XX------------XX00000000000000000000000000000000000000000000000000000000000000000000000000000000000000000000000
000000000000000000000000000000000000000000000000000000000000000000000000000000000000000000000000XXXXXX----XXXXXX00000000000000000000000000000000000000000000000000000000000000000000000000000000000000000000000
000000000000000000000000000000000000000000000000000000000000000000000000000000000000000000000000XX------------XX00000000000000000000000000000000000000000000000000000000000000000000000000000000000000000000000
000000000000000000000000000000000000000000000000000000000000000000000000000000000000000000000000XX-----------XXX00000000000000000000000000000000000000000000000000000000000000000000000000000000000000000000000
000000000000000000000000000000000000000000000000000000000000000000000000000000000000000000000000XD-----------XXX00000000000000000000000000000000000000000000000000000000000000000000000000000000000000000000000
000000000000000000000000000000000000000000000000000000000000000000000000000000000000000000000000XD-----------XXX00000000000000000000000000000000000000000000000000000000000000000000000000000000000000000000000
000000000000000000000000000000000000000000000000000000000000000000000000000000000000000000000000XXXXXXXXXXXXXXXX00000000000000000000000000000000000000000000000000000000000000000000000000000000000000000000000
0000000000000000--------------------------------------------------------------------------------XXXXXXXXXXXXXXXX00000000000000000000000000000000000000000000000000000000000000000000000000000000000000000000000
0000000000000000--------------------------------------------------------------------------------000000000000000000000000000000000000000000000000000000000000000000000000000000000000000000000000000000000000000
0000000000000000--------------------------------------------------------------------------------000000000000000000000000000000000000000000000000000000000000000000000000000000000000000000000000000000000000000
0000000000000000--------------------------------------------------------------------------------000000000000000000000000000000000000000000000000000000000000000000000000000000000000000000000000000000000000000
0000000000000000--------------------------------------------------------------------------------000000000000000000000000000000000000000000000000000000000000000000000000000000000000000000000000000000000000000
0000000000000000--------------------------------------------------------------------------------000000000000000000000000000000000000000000000000000000000000000000000000000000000000000000000000000000000000000
0000000000000000--------------------------------------E-----------------------------------------000000000000000000000000000000000000000000000000000000000000000000000000000000000000000000000000000000000000000
0000000000000000--------QSSSS-------------------------------------------------------------------000000000000000000000000000000000000000000000000000000000000000000000000000000000000000000000000000000000000000
0000000000000000--------------------------------------------------------------------------------000000000000000000000000000000000000000000000000000000000000000000000000000000000000000000000000000000000000000
0000000000000000--------------------------------------------------------------------------------000000000000000000000000000000000000000000000000000000000000000000000000000000000000000000000000000000000000000
0000000000000000--------------------------------------------------------------------------------000000000000000000000000000000000000000000000000000000000000000000000000000000000000000000000000000000000000000
0000000000000000--------S-------------------QQ-------E---------------------<--------------------000000000000000000000000000000000000000000000000000000000000000000000000000000000000000000000000000000000000000
0000000000000000-----E-----------------------------X-----------------------[--------------------000000000000000000000000000000000000000000000000000000000000000000000000000000000000000000000000000000000000000
0000000000000000----<>-----------------------------------------------------[--------------------000000000000000000000000000000000000000000000000000000000000000000000000000000000000000000000000000000000000000
0000000000000000----[]--------------------------------------------E----E---[-------EE-----------000000000000000000000000000000000000000000000000000000000000000000000000000000000000000000000000000000000000000
-XX----------XXXXXXXXXXXXXXXXXXXXXX-XXXXXXXXXXXXXXX----XXXXXXXXXXXXXXXXXXXX[XXXXXXXXXXXXXXXXXXX-000000000000000000000000000000000000000000000000000000000000000000000000000000000000000000000000000000000000000
XX----------XXXX00000000000000000000000000000000000000000000000000000000000000000000000000000000000000000000000000000000000000000000000000000000000000000000000000000000000000000000000000000000000000000000000
XXXXXXXXE---XXXX00000000000000000000000000000000000000000000000000000000000000000000000000000000000000000000000000000000000000000000000000000000000000000000000000000000000000000000000000000000000000000000000
XXXX------XXXXXX00000000000000000000000000000000000000000000000000000000000000000000000000000000000000000000000000000000000000000000000000000000000000000000000000000000000000000000000000000000000000000000000
XXXX------XXXX--00000000000000000000000000000000000000000000000000000000000000000000000000000000000000000000000000000000000000000000000000000000000000000000000000000000000000000000000000000000000000000000000
XXXXE-EXXXXXXX--00000000000000000000000000000000000000000000000000000000000000000000000000000000000000000000000000000000000000000000000000000000000000000000000000000000000000000000000000000000000000000000000
XXXX------XXXX--00000000000000000000000000000000000000000000000000000000000000000000000000000000000000000000000000000000000000000000000000000000000000000000000000000000000000000000000000000000000000000000000
XX-----------XXX00000000000000000000000000000000000000000000000000000000000000000000000000000000000000000000000000000000000000000000000000000000000000000000000000000000000000000000000000000000000000000000000
XX--TT-------XXX00000000000000000000000000000000000000000000000000000000000000000000000000000000000000000000000000000000000000000000000000000000000000000000000000000000000000000000000000000000000000000000000
XX-----------XXX00000000000000000000000000000000000000000000000000000000000000000000000000000000000000000000000000000000000000000000000000000000000000000000000000000000000000000000000000000000000000000000000
XX-----------XXX00000000000000000000000000000000000000000000000000000000000000000000000000000000000000000000000000000000000000000000000000000000000000000000000000000000000000000000000000000000000000000000000
-XXXXXXXE--XXXX-00000000000000000000000000000000000000000000000000000000000000000000000000000000000000000000000000000000000000000000000000000000000000000000000000000000000000000000000000000000000000000000000
-XXXX------XXXX-00000000000000000000000000000000000000000000000000000000000000000000000000000000000000000000000000000000000000000000000000000000000000000000000000000000000000000000000000000000000000000000000
-XXXX------XXXX-00000000000000000000000000000000000000000000000000000000000000000000000000000000000000000000000000000000000000000000000000000000000000000000000000000000000000000000000000000000000000000000000
-XXXX----EXXXXX-00000000000000000000000000000000000000000000000000000000000000000000000000000000000000000000000000000000000000000000000000000000000000000000000000000000000000000000000000000000000000000000000
XX----------XXXX00000000000000000000000000000000000000000000000000000000000000000000000000000000000000000000000000000000000000000000000000000000000000000000000000000000000000000000000000000000000000000000000
XX----------XXXX00000000000000000000000000000000000000000000000000000000000000000000000000000000000000000000000000000000000000000000000000000000000000000000000000000000000000000000000000000000000000000000000
XD-----------XXX00000000000000000000000000000000000000000000000000000000000000000000000000000000000000000000000000000000000000000000000000000000000000000000000000000000000000000000000000000000000000000000000
XXXXXXXXXXXXXXXX00000000000000000000000000000000000000000000000000000000000000000000000000000000000000000000000000000000000000000000000000000000000000000000000000000000000000000000000000000000000000000000000
XXXXXXXXXXXXXXXX00000000000000000000000000000000000000000000000000000000000000000000000000000000000000000000000000000000000000000000000000000000000000000000000000000000000000000000000000000000000000000000000