0000000000000000000000000000000000000000000000000000000000000000000000000000000000000000000000000000000000000000000000000000000000000000XXXX--------XXXX
0000000000000000000000000000000000000000000000000000000000000000000000000000000000000000000000000000000000000000000000000000000000000000XXXX--XXXXXXXXXX
0000000000000000000000000000000000000000000000000000000000000000000000000000000000000000000000000000000000000000000000000000000000000000XXXX--------XXXX
0000000000000000000000000000000000000000000000000000000000000000000000000000000000000000000000000000000000000000000000000000000000000000XXXX--------XXXX
0000000000000000000000000000000000000000000000000000000000000000000000000000000000000000000000000000000000000000000000000000000000000000XTTTTTTTT---XXXX
0000000000000000000000000000000000000000000000000000000000000000000000000000000000000000000000000000000000000000000000000000000000000000XXXX--------XXXX
0000000000000000000000000000000000000000000000000000000000000000000000000000000000000000000000000000000000000000000000000000000000000000XXXX--------XXXX
0000000000000000000000000000000000000000000000000000000000000000000000000000000000000000000000000000000000000000000000000000000000000000XXTTTT------XXXX
0000000000000000000000000000000000000000000000000000000000000000000000000000000000000000000000000000000000000000000000000000000000000000XXXX--------XXXX
0000000000000000000000000000000000000000000000000000000000000000000000000000000000000000000000000000000000000000000000000000000000000000XXXX--------XXXX
0000000000000000000000000000000000000000000000000000000000000000000000000000000000000000000000000000000000000000000000000000000000000000XXXXXXXX--------
0000000000000000000000000000000000000000000000000000000000000000000000000000000000000000000000000000000000000000000000000000000000000000XXXX------------
0000000000000000000000000000000000000000000000000000000000000000000000000000000000000000000000000000000000000000000000000000000000000000X--------------X
0000000000000000000000000000000000000000000000000000000000000000000000000000000000000000000000000000000000000000000000000000000000000000X------------TTT
0000000000000000000000000000000000000000000000000000000000000000000000000000000000000000000000000000000000000000000000000000000000000000X--------------X
0000000000000000000000000000000000000000000000000000000000000000000000000000000000000000000000000000000000000000000000000000000000000000XE-----------EXX
0000000000000000000000000000000000000000000000000000000000000000000000000000000000000000000000000000000000000000000000000000000000000000XMMMMMMMMMMMMMMX
0000000000000000000000000000000000000000000000000000000000000000000000000000000000000000000000000000000000000000000000000000000000000000----------------
0000000000000000000000000000000000000000000000000000000000000000000000000000000000000000000000000000000000000000000000000000000000000000--E--------E----
000000000000000000000000000000000000000000000000000000000000000000000000000000000000000000000000000000000000000000000000000000000000----MMMMMMMMMMMMMMMM
000000000000000000000000000000000000000000000000000000000000000000000000000000000000000000000000000000000000000000000000000000000000----0000000000000000
000000000000000000000000000000000000000000000000000000000000000000000000000000000000000000000000000000000000000000000000000000000000----0000000000000000
000000000000000000000000000000000000000000000000000000000000000000000000000000000000000000000000000000000000000000000000000000000000----0000000000000000
000000000000000000000000000000000000000000000000000000000000000000000000000000000000000000000000000000000000000000000000000000000000----0000000000000000
000000000000000000000000000000000000000000000000000000000000000000000000000000000000000000000000000000000000000000000000000000000000----0000000000000000
000000000000000000000000000000000000000000000000000000000000000000000000000000000000000000000000000000000000000000000000000000000000----0000000000000000
000000000000000000000000000000000000000000000000000000000000000000000000000000000000000000000000000000000000000000000000000000000000----0000000000000000
000000000000000000000000000000000000000000000000000000000000000000000000000000--------------------------------------0000000000000000----0000000000000000
000000000000000000000000000000000000000000000000000000000000000000000000000000--------------------------------------0000000000000000----0000000000000000
000000000000000000000000000000000000000000000000000000000000000000000000000000--------------------------------------0000000000000000----0000000000000000
000000000000000000000000000000000000000000000000000000000000000000000000000000--------------------------------------0000000000000000----0000000000000000
000000000000000000000000000000000000000000000000000000000000000000000000000000--------------------------------------0000000000000000----0000000000000000
000000000000000000000000000000000000000000000000000000000000000000000000000000--------------------------------------0000000000000000----0000000000000000
000000000000000000000000000000000000000000000000000000000000000000000000000000----------------------------------------------------------0000000000000000
000000000000000000000000000000000000000000000000000000000000000000000000000000------------------------------------------------------X---0000000000000000
000000000000000000000000000000000000000000000000000000000000000000000000000000-------------------------------------------TT--TT-----00000000000000000000
000000000000000000000000000000000000000000000000000000000000000000000000000000------------------------------------------------------00000000000000000000
000000000000000000000000000000000000000000000000000000000000000000000000000000----------E-------------------------------------------00000000000000000000
000000000000000000000000000000000000000000000000000000000000000000000000000000---------->----E---------E-----------X-----X----------00000000000000000000
000000000000000000000000000000000000000000000000000000000000000000000000000000---------<]--------------E------------000000000000000000000000000000000000
000000000000000000000000000000000000000000000000000000000000000000000000000000---------[]---------------------------000000000000000000000000000000000000
000000000000000000000000000000000000000000000000000000000000000000000000000000---------[]---------------------------000000000000000000000000000000000000
00000000000000000000000000000000000000000000000000000000000000-------X--------XXXXXXXXXXXXXXXXXXXXXXXXXXXXXXXXXXX---000000000000000000000000000000000000
00000000000000000000000000000000000000000000000000000000000000-------X--------00000000000000000000000000000000000000000000000000000000000000000000000000
00000000000000000000000000000000000000000000000000000000000000-------X---X----00000000000000000000000000000000000000000000000000000000000000000000000000
00000000000000000000000000000000000000000000000000000000000000----------------00000000000000000000000000000000000000000000000000000000000000000000000000
000000000000000000000000000000000000000000000---------------------X-----------00000000000000000000000000000000000000000000000000000000000000000000000000
000000000000000000000000000000000000000000000-----------------000000000000000000000000000000000000000000000000000000000000000000000000000000000000000000
000000000000000000000000000000000000000000000-----------------000000000000000000000000000000000000000000000000000000000000000000000000000000000000000000
000000000000000000000000000000000000000000000-----------------000000000000000000000000000000000000000000000000000000000000000000000000000000000000000000
000000000000000000000000000000000000000000000-----------------000000000000000000000000000000000000000000000000000000000000000000000000000000000000000000
000000000000000000000000000000000000000000000-----------------000000000000000000000000000000000000000000000000000000000000000000000000000000000000000000
000000000000000000000000000000000000000000000-----------------000000000000000000000000000000000000000000000000000000000000000000000000000000000000000000
000000000000000000000000000000000000000000000-----------------000000000000000000000000000000000000000000000000000000000000000000000000000000000000000000
000000000000000000000000000000000000000000000-----------------000000000000000000000000000000000000000000000000000000000000000000000000000000000000000000
000000000000000000000000000000000000000000000-E---------------000000000000000000000000000000000000000000000000000000000000000000000000000000000000000000
00000000000000000000000000000----------------->---------------000000000000000000000000000000000000000000000000000000000000000000000000000000000000000000
00000000000000000000000000000----------------<]---------------000000000000000000000000000000000000000000000000000000000000000000000000000000000000000000
00000000000000000000000000000----T--XXXX-----[]----E----------000000000000000000000000000000000000000000000000000000000000000000000000000000000000000000
00000000000000000000000000000----------------[]---<>----------000000000000000000000000000000000000000000000000000000000000000000000000000000000000000000
00000000000000000000000000000--------------X-[]---[]--E-E-----000000000000000000000000000000000000000000000000000000000000000000000000000000000000000000
00000000000000000000000000000---------T--TTTTXXXXXXXXXXXXXX---000000000000000000000000000000000000000000000000000000000000000000000000000000000000000000
00000000000000000000000000000--------------X-00000000000000000000000000000000000000000000000000000000000000000000000000000000000000000000000000000000000
00000000000000000000000000000----------------00000000000000000000000000000000000000000000000000000000000000000000000000000000000000000000000000000000000
00000000000000000000000000000-------X---X----00000000000000000000000000000000000000000000000000000000000000000000000000000000000000000000000000000000000
00000000000000000000000000000----------------00000000000000000000000000000000000000000000000000000000000000000000000000000000000000000000000000000000000
00000000000000000000000000000----X-----------00000000000000000000000000000000000000000000000000000000000000000000000000000000000000000000000000000000000
00000000000000000000000000000----------------00000000000000000000000000000000000000000000000000000000000000000000000000000000000000000000000000000000000
00000000000000000000000000000--X-------------00000000000000000000000000000000000000000000000000000000000000000000000000000000000000000000000000000000000
00000000000000000000000000000----------------00000000000000000000000000000000000000000000000000000000000000000000000000000000000000000000000000000000000
00000000000000000000000000000----------------00000000000000000000000000000000000000000000000000000000000000000000000000000000000000000000000000000000000
00000000000000000000000000000-----TTTT-------00000000000000000000000000000000000000000000000000000000000000000000000000000000000000000000000000000000000
00000000000000000000000000000----------------00000000000000000000000000000000000000000000000000000000000000000000000000000000000000000000000000000000000
00000000000000000000000000000XXXX--------XXXX00000000000000000000000000000000000000000000000000000000000000000000000000000000000000000000000000000000000
00000000000000000000000000000XXXXXXXX----XXXX00000000000000000000000000000000000000000000000000000000000000000000000000000000000000000000000000000000000
00000000000000000000000000000XX----------X---00000000000000000000000000000000000000000000000000000000000000000000000000000000000000000000000000000000000
00000000000000000000000000000XX----------XXXX00000000000000000000000000000000000000000000000000000000000000000000000000000000000000000000000000000000000
00000000000000000000000000000XXX------------X00000000000000000000000000000000000000000000000000000000000000000000000000000000000000000000000000000000000
00000000000000000000000000000XX-------------X00000000000000000000000000000000000000000000000000000000000000000000000000000000000000000000000000000000000
00000000000000000000000000000----------------00000000000000000000000000000000000000000000000000000000000000000000000000000000000000000000000000000000000
00000000000000000000000000000--------TTTT----00000000000000000000000000000000000000000000000000000000000000000000000000000000000000000000000000000000000
00000000000000000000000000000----------------00000000000000000000000000000000000000000000000000000000000000000000000000000000000000000000000000000000000
00000000000000000000000000000--TTTTTTTT------00000000000000000000000000000000000000000000000000000000000000000000000000000000000000000000000000000000000
00000000000000000000000000000----------------00000000000000000000000000000000000000000000000000000000000000000000000000000000000000000000000000000000000
00000000000000000000000000000----------------00000000000000000000000000000000000000000000000000000000000000000000000000000000000000000000000000000000000
00000000000000000000000000000XXXXXXX---------00000000000000000000000000000000000000000000000000000000000000000000000000000000000000000000000000000000000
00000000000000000000000000000----------------00000000000000000000000000000000000000000000000000000000000000000000000000000000000000000000000000000000000
00000000000000000000000000000------TTTT------00000000000000000000000000000000000000000000000000000000000000000000000000000000000000000000000000000000000
00000000000000000000000000000----------------00000000000000000000000000000000000000000000000000000000000000000000000000000000000000000000000000000000000
00000000000000000000000000000----------------00000000000000000000000000000000000000000000000000000000000000000000000000000000000000000000000000000000000
00000000000000000000000000000----------------00000000000000000000000000000000000000000000000000000000000000000000000000000000000000000000000000000000000
00000000000000000000000000000-------X---X----00000000000000000000000000000000000000000000000000000000000000000000000000000000000000000000000000000000000
00000000000000000000000000000----------------00000000000000000000000000000000000000000000000000000000000000000000000000000000000000000000000000000000000
00000000000000000000000000000----X--X--------00000000000000000000000000000000000000000000000000000000000000000000000000000000000000000000000000000000000
00000000000000000000000000000----X-----------00000000000000000000000000000000000000000000000000000000000000000000000000000000000000000000000000000000000
00000000000000000000000000000--X-------------00000000000000000000000000000000000000000000000000000000000000000000000000000000000000000000000000000000000
00000000000000000000000000000----------------00000000000000000000000000000000000000000000000000000000000000000000000000000000000000000000000000000000000
00000000000000000000000000000----------------00000000000000000000000000000000000000000000000000000000000000000000000000000000000000000000000000000000000
00000000000000000000000000000------TTTT------00000000000000000000000000000000000000000000000000000000000000000000000000000000000000000000000000000000000
00000000000000000000000000000----------------00000000000000000000000000000000000000000000000000000000000000000000000000000000000000000000000000000000000
00000000000000000000000000000---------TTTT---00000000000000000000000000000000000000000000000000000000000000000000000000000000000000000000000000000000000
00000000000000000000000000000----------------00000000000000000000000000000000000000000000000000000000000000000000000000000000000000000000000000000000000
00000000000000000000000000000XXXX--------XXXX00000000000000000000000000000000000000000000000000000000000000000000000000000000000000000000000000000000000
00000000000000000000000000000-----E----------00000000000000000000000000000000000000000000000000000000000000000000000000000000000000000000000000000000000
00000000000000000000000000000----TTT---------00000000000000000000000000000000000000000000000000000000000000000000000000000000000000000000000000000000000
00000000000000000000000000000----------------00000000000000000000000000000000000000000000000000000000000000000000000000000000000000000000000000000000000
00000000000000000000000000000------XXXX------00000000000000000000000000000000000000000000000000000000000000000000000000000000000000000000000000000000000
00000000000000000000000000000----------------00000000000000000000000000000000000000000000000000000000000000000000000000000000000000000000000000000000000
00000000000000000000000000000---------XXXX---00000000000000000000000000000000000000000000000000000000000000000000000000000000000000000000000000000000000
00000000000000000000000000000----------------00000000000000000000000000000000000000000000000000000000000000000000000000000000000000000000000000000000000
00000000000000000000000000000------XXXX------00000000000000000000000000000000000000000000000000000000000000000000000000000000000000000000000000000000000
00000000000000000000000000000----------------00000000000000000000000000000000000000000000000000000000000000000000000000000000000000000000000000000000000
00000000000000000000000000000---XXXX---------00000000000000000000000000000000000000000000000000000000000000000000000000000000000000000000000000000000000
00000000000000000000000000000----------------00000000000000000000000000000000000000000000000000000000000000000000000000000000000000000000000000000000000
00000000000000000000000000000----------------00000000000000000000000000000000000000000000000000000000000000000000000000000000000000000000000000000000000
00000000000000000000000000000----TTTT--------00000000000000000000000000000000000000000000000000000000000000000000000000000000000000000000000000000000000
00000000000000000000000000000----------TTT---00000000000000000000000000000000000000000000000000000000000000000000000000000000000000000000000000000000000
00000000000000000000000000000----------------00000000000000000000000000000000000000000000000000000000000000000000000000000000000000000000000000000000000
00000000000000000000000000000----------------00000000000000000000000000000000000000000000000000000000000000000000000000000000000000000000000000000000000
00000000000000000000000000000-TTTTTTTT-------00000000000000000000000000000000000000000000000000000000000000000000000000000000000000000000000000000000000
00000000000000000000000000000----------------00000000000000000000000000000000000000000000000000000000000000000000000000000000000000000000000000000000000
00000000000000000000000000000----------------00000000000000000000000000000000000000000000000000000000000000000000000000000000000000000000000000000000000
00000000000000000000000000000----XXXX---XXXX-00000000000000000000000000000000000000000000000000000000000000000000000000000000000000000000000000000000000
00000000000000000000000000000XXXX------XXXX--00000000000000000000000000000000000000000000000000000000000000000000000000000000000000000000000000000000000
00000000000000000000000000000XXXX-----TTTTTTT00000000000000000000000000000000000000000000000000000000000000000000000000000000000000000000000000000000000
00000000000000000000000000000XXXX--------XXXX00000000000000000000000000000000000000000000000000000000000000000000000000000000000000000000000000000000000
00000000000000000000000000000XXXX--------XXXX00000000000000000000000000000000000000000000000000000000000000000000000000000000000000000000000000000000000
00000000000000000000000000000XX----TT--TTTTXX00000000000000000000000000000000000000000000000000000000000000000000000000000000000000000000000000000000000
00000000000000000000000000000XX------------XX00000000000000000000000000000000000000000000000000000000000000000000000000000000000000000000000000000000000
00000000000000000000000000000XX------------XX00000000000000000000000000000000000000000000000000000000000000000000000000000000000000000000000000000000000
00000000000000000000000000000XXXXXXXX------XX00000000000000000000000000000000000000000000000000000000000000000000000000000000000000000000000000000000000
00000000000000000000000000000XXXX----------XX00000000000000000000000000000000000000000000000000000000000000000000000000000000000000000000000000000000000
00000000000000000000000000000XXXX----------XX00000000000000000000000000000000000000000000000000000000000000000000000000000000000000000000000000000000000
00000000000000000000000000000XXXX----------X-00000000000000000000000000000000000000000000000000000000000000000000000000000000000000000000000000000000000
00000000000000000000000000000XXXX------------00000000000000000000000000000000000000000000000000000000000000000000000000000000000000000000000000000000000
00000000000000000000000000000XXXX------------00000000000000000000000000000000000000000000000000000000000000000000000000000000000000000000000000000000000
------------00000000000000000XX-------------X00000000000000000000000000000000000000000000000000000000000000000000000000000000000000000000000000000000000
------------00000000000000000XX----------TTTT00000000000000000000000000000000000000000000000000000000000000000000000000000000000000000000000000000000000
------------00000000000000000XD------------TX00000000000000000000000000000000000000000000000000000000000000000000000000000000000000000000000000000000000
------------00000000000000000XD-------------X00000000000000000000000000000000000000000000000000000000000000000000000000000000000000000000000000000000000
------------0000000000000000-XXXX-----------X00000000000000000000000000000000000000000000000000000000000000000000000000000000000000000000000000000000000
------------0000000000000000-XMMMMMMMMMMMMMMM00000000000000000000000000000000000000000000000000000000000000000000000000000000000000000000000000000000000
------------0000000000000000-----------------00000000000000000000000000000000000000000000000000000000000000000000000000000000000000000000000000000000000
-------S----0000000000000000-----E--------E--00000000000000000000000000000000000000000000000000000000000000000000000000000000000000000000000000000000000
------------0000000000000000-MMMMMMMMMMMMMMMM00000000000000000000000000000000000000000000000000000000000000000000000000000000000000000000000000000000000
------------0000000000000000-----------------00000000000000000000000000000000000000000000000000000000000000000000000000000000000000000000000000000000000
------------0000000000000000-----------------00000000000000000000000000000000000000000000000000000000000000000000000000000000000000000000000000000000000
------------0000000000000000----------TT-----00000000000000000000000000000000000000000000000000000000000000000000000000000000000000000000000000000000000
------S-----0000000000000000-----------------00000000000000000000000000000000000000000000000000000000000000000000000000000000000000000000000000000000000
------------0000000000000000-----------------00000000000000000000000000000000000000000000000000000000000000000000000000000000000000000000000000000000000
------------0000000000000000-----------X-----00000000000000000000000000000000000000000000000000000000000000000000000000000000000000000000000000000000000
XXXXX----XXX------------X---X----------X-----00000000000000000000000000000000000000000000000000000000000000000000000000000000000000000000000000000000000
0000000000000000000000000000X000000000000000000000000000000000000000000000000000000000000000000000000000000000000000000000000000000000000000000000000000
0000000000000000000000000000-000000000000000000000000000000000000000000000000000000000000000000000000000000000000000000000000000000000000000000000000000
0000000000000000000000000000-000000000000000000000000000000000000000000000000000000000000000000000000000000000000000000000000000000000000000000000000000
0000000000000000000000000000-000000000000000000000000000000000000000000000000000000000000000000000000000000000000000000000000000000000000000000000000000
00000000000000000000000000000000000000000000000000000000000000000000000000000000000000000000000000000000000000000000000000000000000000000000000000000000