00000000000000000000000000000000000000000000000000000000000000000000000000000000000000000000000000000000000000000000000000000000----------------
00000000000000000000000000000000000000000000000000000000000000000000000000000000000000000000000000000000000000000000000000000000----------------
00000000000000000000000000000000000000000000000000000000000000000000000000000000000000000000000000000000000000000000000000000000---XXXX--TTT----
00000000000000000000000000000000000000000000000000000000000000000000000000000000000000000000000000000000000000000000000000000000---DXXX---XXXX--
000000000000000000000000000000000000000000000000000000000000000000000000000000000000000000000000000000000000---------------------TTTXXD---XXXX--
000000000000000000000000000000000000000000000000000000000000000000000000000000000000000000000000000000000000-----------------------XXXXX--XXXX--
000000000000000000000000000000000000000000000000000000000000000000000000000000000000000000000000000000000000------------------------XXXX--XXXX--
000000000000000000000000000000000000000000000000000000000000000000000000000000000000000000000000000000000000------------------------XXXX--XXXX--
000000000000000000000000000000000000000000000000000000000000000000000000000000000000000000000000000000000000------------------------XXXX-TTTTTTT
000000000000000000000000000000000000000000000000000000000000000000000000000000000000000000000000000000000000------------------------XXXX--XXXX--
000000000000000000000000000000000000000000000000000000000000000000000000000000000000000000000000000000000000-----------------------XXXXX--XXXX--
000000000000000000000000000000000000000000000000000000000000000000000000000000000000000000000000000000000000------------------------------XXXX--
000000000000000000000000000000000000000000000000000000000000000000000000000000000000000000000000000000000000--------------------XXXXXXXXXXXXXXXX
000000000000000000000000000000000000000000000000000000000000000000000000000000000000000000000000000000000000--------------------XXXXXXXXXXXXXXXX
000000000000000000000000000000000000000000000000000000000000000000000000000000000000000000000000000000000000--------------------XXXX----------XX
000000000000000000000000000000000000000000000000000000000000000000000000000000000000000000000000000000000000--------------------XXXX----------XX
000000000000000000000000000000000000000000000000000000000000000000000000000000000000000000000000000000000000--------------------XD-------------X
000000000000000000000000000000000000000000000000000000000000000000000000000000000000000000000000000000000000--------------------XD-------------X
000000000000000000000000000000000000000000000000000000000000000000000000000000000000000000000000000000000000--------------------XXXXX-------XXXX
00000000000000000000000000000000000000000000000000000000000000000000000000000000000000000000----oX----------XXXXXXXXXXXXXXXXXXXXXXXXXXXXXXXXXXXX
00000000000000000000000000000000000000000000000000000000000000000000000000000000000000000000----X---------X-000000000000000000000000000000000000
00000000000000000000000000000000000000000000000000000000000000000000000000000000000000000000--------------X-000000000000000000000000000000000000
00000000000000000000000000000000000000000000000000000000000000000000000000000000000000000000--------------X-000000000000000000000000000000000000
00000000000000000000000000000000000000000000000000000000000000000000000000000000000000000000----------------000000000000000000000000000000000000
00000000000000000000000000000000000000000000000000000000000000000000000000000000000000000000----------------000000000000000000000000000000000000
00000000000000000000000000000000000000000000000000000000000000000000000000000000000000000000-----TTTT-------000000000000000000000000000000000000
00000000000000000000000000000000000000000000000000000000000000000000000000000000000000000000----------------000000000000000000000000000000000000
00000000000000000000000000000000000000000000000000000000000000000000000000000000000000000000----------------000000000000000000000000000000000000
00000000000000000000000000000000000000000000000000000000000000000000000000000000000000000000---------TTTT---000000000000000000000000000000000000
00000000000000000000000000000000000000000000000000000000000000000000000000000000000000000000X-----------TTTT000000000000000000000000000000000000
00000000000000000000000000000000000000000000000000000000000000000000000000000000000000000000X--------------X000000000000000000000000000000000000
00000000000000000000000000000000000000000000000000000000000000000000000000000000000000000000X--------------X000000000000000000000000000000000000
00000000000000000000000000000000000000000000000000000000000000000000000000000000000000000000XXXXXXXXX------X000000000000000000000000000000000000
00000000000000000000000000000000000000000000000000000000000000000000000000000000000000000000XX-------------X000000000000000000000000000000000000
00000000000000000000000000000000000000000000000000000000000000000000000000000000000000000000XX--------TTTTTT000000000000000000000000000000000000
00000000000000000000000000000000000000000000000000000000000000000000000000000000000000000000XD-------------X000000000000000000000000000000000000
00000000000000000000000000000000000000000000000000000000000000000000000000000000000000000000XD-------------X000000000000000000000000000000000000
00000000000000000000000000000000000000000000000000000000000000000000000000000000000000000000XXXXX-------XXXX000000000000000000000000000000000000
00000000000000000000000000000000000000000000000000000000000000000000000000000000000000000000XXXXXXXXXXXXXXXX000000000000000000000000000000000000
00000000000000000000000000000000000000000000000000000000000000000000000000000000000000000000XXXXXXX-----XXXX000000000000000000000000000000000000
00000000000000000000000000000000000000000000000000000000000000000000000000000000000000000000XXXX--------XXXX000000000000000000000000000000000000
00000000000000000000000000000000000000000000000000000000000000000000000000000000000000000000XX------------XX000000000000000000000000000000000000
00000000000000000000000000000000000000000000000000000000000000000000000000000000000000000000XX-----XXXX---DX000000000000000000000000000000000000
00000000000000000000000000000000000000000000000000000000000000000000000000000000000000000000XX------------DX000000000000000000000000000000000000
00000000000000000000000000000000000000000000000000000000000000000000000000000000000000000000XXXX--------XXXX000000000000000000000000000000000000
00000000000000000000000000000000000000000000000000000000000000000000000000000000000000000000XXXXXX------XXXX000000000000000000000000000000000000
00000000000000000000000000000000000000000000000000000000000000000000000000000000000000000000XXXX--------XXXX000000000000000000000000000000000000
00000000000000000000000000000000000000000000000000000000000000000000000000000000000000000000XXXX--------XXXX000000000000000000000000000000000000
00000000000000000000000000000000000000000000000000000000000000000000000000000000000000000000XX----TTTTTTTTXX000000000000000000000000000000000000
00000000000000000000000000000000000000000000000000000000000000000000000000000000000000000000XX------------XX000000000000000000000000000000000000
00000000000000000000000000000000000000000000000000000000000000000000000000000000000000000000XX------------XX000000000000000000000000000000000000
00000000000000000000000000000000000000000000000000000000000000000000000000000000000000000000XXXXXXXX------XX000000000000000000000000000000000000
00000000000000000000000000000000000000000000000000000000000000000000000000000000000000000000XX------------XX000000000000000000000000000000000000
00000000000000000000000000000000000000000000000000000000000000000000000000000000000000000000XX------------XX000000000000000000000000000000000000
00000000000000000000000000000000000000000000000000000000000000000000000000000000000000000000XX----XXXXXXXXXX000000000000000000000000000000000000
00000000000000000000000000000000000000000000000000000000000000000000000000000000000000000000XD------------XX000000000000000000000000000000000000
00000000000000000000000000000000000000000000000000000000000000000000000000000000000000000000XD------------XX000000000000000000000000000000000000
00000000000000000000000000000000000000000000000000000000000000000000000000000000000000000000XXXXX-------XXXX000000000000000000000000000000000000
00000000000000000000000000000000000000000000000000000000000000000000000000000000000000000000XXXXXXXXXXXXXXXX000000000000000000000000000000000000
00000000000000000000000000000000000000000000000000000000000000000000000000000000000000000000----------------000000000000000000000000000000000000
00000000000000000000000000000000000000000000000000000000000000000000000000000000000000000000---------E------000000000000000000000000000000000000
00000000000000000000000000000000000000000000000000000000000000000000000000000000000000000000----------------000000000000000000000000000000000000
00000000000000000000000000000000000000000000000000000000000000000000000000000000000000000000----------------000000000000000000000000000000000000
0000000000000000000000000000000000000000000000000000--------------------------------------------TTTTTTTT----000000000000000000000000000000000000
0000000000000000000000000000000000000000000000000000--------------------------------------------------------000000000000000000000000000000000000
0000000000000000000000000000000000000000000000000000--------------------------------------------------------000000000000000000000000000000000000
0000000000000000000000000000000000000000000000000000---------------------------------------------TTTT-------000000000000000000000000000000000000
0000000000000000000000000000000000000000000000000000--------------------------------------------------------000000000000000000000000000000000000
0000000000000000000000000000000000000000000000000000----------------------------------------XXXX--------XXXX000000000000000000000000000000000000
0000000000000000000000000000000000000000000000000000----------------------------------------XXXX--------XXXX000000000000000000000000000000000000
0000000000000000000000000000000000000000000000000000-------------------S---SS---------------XXXXXXX-----XXXX000000000000000000000000000000000000
0000000000000000000000000000000000000000000000000000----------------------------------------XXXX------T-XXXX000000000000000000000000000000000000
0000000000000000000000000000000000000000000000000000----------------------------------------XX----------XXXX000000000000000000000000000000000000
0000000000000000000000000000000000000000000000000000-------------------S--------------------XX----------XXXX000000000000000000000000000000000000
0000000000000000000000000000000000000000000000000000----------------E------SS---------------XX----XXXXXXXXXX000000000000000000000000000000000000
0000000000000000000000000000000000000000000000000000----------------------------------------XD------------XX000000000000000000000000000000000000
0000000000000000000000000000000000000000000000000000----------------------------------------XD------------XX000000000000000000000000000000000000
0000000000000000000000000000000000000000000000000000---------------------------------EE-EE--XXXXX-------XXXX000000000000000000000000000000000000
000000000000000000000000000000000000----------------XXXXXXXXXXXXXXXXXXX-XXXXXXXXXXXXXXXXXXXXXXXXXXXXXXXXXXXX000000000000000000000000000000000000
000000000000000000000000000000000000TTTTTTTT--------00000000000000000000000000000000000000000000000000000000000000000000000000000000000000000000
000000000000000000000000000000000000----------------00000000000000000000000000000000000000000000000000000000000000000000000000000000000000000000
000000000000000000000000000000000000----------------00000000000000000000000000000000000000000000000000000000000000000000000000000000000000000000
000000000000000000000000000000000000------TTT-------00000000000000000000000000000000000000000000000000000000000000000000000000000000000000000000
000000000000000000000000000000000000----------------00000000000000000000000000000000000000000000000000000000000000000000000000000000000000000000
000000000000000000000000000000000000---------TTTT---00000000000000000000000000000000000000000000000000000000000000000000000000000000000000000000
000000000000000000000000000000000000----------------00000000000000000000000000000000000000000000000000000000000000000000000000000000000000000000
000000000000000000000000000000000000------XXXX------00000000000000000000000000000000000000000000000000000000000000000000000000000000000000000000
0000000000000000------------------------------------00000000000000000000000000000000000000000000000000000000000000000000000000000000000000000000
0000000000000000-----------------------XX-----------00000000000000000000000000000000000000000000000000000000000000000000000000000000000000000000
0000000000000000--------------------XXXXXXX------XXX00000000000000000000000000000000000000000000000000000000000000000000000000000000000000000000
0000000000000000--------------------------------XXX-00000000000000000000000000000000000000000000000000000000000000000000000000000000000000000000
0000000000000000------------------------------------00000000000000000000000000000000000000000000000000000000000000000000000000000000000000000000
0000000000000000--------------------XX-----------XXX00000000000000000000000000000000000000000000000000000000000000000000000000000000000000000000
0000000000000000--------------------XX----XXXXXXXXXX00000000000000000000000000000000000000000000000000000000000000000000000000000000000000000000
0000000000000000--------------------XD------------XX00000000000000000000000000000000000000000000000000000000000000000000000000000000000000000000
0000000000000000--------------------XD------------XX00000000000000000000000000000000000000000000000000000000000000000000000000000000000000000000
0000000000000000--------------------XXXXX-------XXXX00000000000000000000000000000000000000000000000000000000000000000000000000000000000000000000
0000000000000000-------------------EXXXXXXXXXXXXXXXX00000000000000000000000000000000000000000000000000000000000000000000000000000000000000000000
0000000000000000------------------<>000000000000000000000000000000000000000000000000000000000000000000000000000000000000000000000000000000000000
0000000000000000--------------E---[]000000000000000000000000000000000000000000000000000000000000000000000000000000000000000000000000000000000000
0000000000000000------------------[]000000000000000000000000000000000000000000000000000000000000000000000000000000000000000000000000000000000000
0000000000000000------------------[]000000000000000000000000000000000000000000000000000000000000000000000000000000000000000000000000000000000000
----------------XXXXXXXXXXXXXXXXXXXX000000000000000000000000000000000000000000000000000000000000000000000000000000000000000000000000000000000000
------------X---00000000000000000000000000000000000000000000000000000000000000000000000000000000000000000000000000000000000000000000000000000000
----------X-X---00000000000000000000000000000000000000000000000000000000000000000000000000000000000000000000000000000000000000000000000000000000
-------E----X---00000000000000000000000000000000000000000000000000000000000000000000000000000000000000000000000000000000000000000000000000000000
------------X---00000000000000000000000000000000000000000000000000000000000000000000000000000000000000000000000000000000000000000000000000000000
------------X---00000000000000000000000000000000000000000000000000000000000000000000000000000000000000000000000000000000000000000000000000000000
------------X---00000000000000000000000000000000000000000000000000000000000000000000000000000000000000000000000000000000000000000000000000000000
------------X---00000000000000000000000000000000000000000000000000000000000000000000000000000000000000000000000000000000000000000000000000000000
------------X---00000000000000000000000000000000000000000000000000000000000000000000000000000000000000000000000000000000000000000000000000000000
------------X---00000000000000000000000000000000000000000000000000000000000000000000000000000000000000000000000000000000000000000000000000000000
------------X---00000000000000000000000000000000000000000000000000000000000000000000000000000000000000000000000000000000000000000000000000000000
------------X---00000000000000000000000000000000000000000000000000000000000000000000000000000000000000000000000000000000000000000000000000000000
------------X---00000000000000000000000000000000000000000000000000000000000000000000000000000000000000000000000000000000000000000000000000000000
----------------00000000000000000000000000000000000000000000000000000000000000000000000000000000000000000000000000000000000000000000000000000000
XX-----------XXX00000000000000000000000000000000000000000000000000000000000000000000000000000000000000000000000000000000000000000000000000000000
XX----XXXXXXXXXX00000000000000000000000000000000000000000000000000000000000000000000000000000000000000000000000000000000000000000000000000000000
XD------------XX00000000000000000000000000000000000000000000000000000000000000000000000000000000000000000000000000000000000000000000000000000000
XD------------XX00000000000000000000000000000000000000000000000000000000000000000000000000000000000000000000000000000000000000000000000000000000
XXXXX-------XXXX00000000000000000000000000000000000000000000000000000000000000000000000000000000000000000000000000000000000000000000000000000000
XXXXXXXXXXXXXXXX00000000000000000000000000000000000000000000000000000000000000000000000000000000000000000000000000000000000000000000000000000000