--------------------------------------------------------------------------------------------------------------------------------------------------------------------------------------------------------000000000000000
--------------------------------------------------------------------------------------------------------------------------------------------------------------------------------------------------------000000000000000
--------------------------------------------------------------------------------------------------------------------------------------------------------------------------------------------------------000000000000000
--------------------------------------------------------------------------------------------------------------------------------------------------------------------------------------------------------000000000000000
--------------------------------------------------------------------------------------------------------------------------------------------------------------------------------------------------------000000000000000
----------------------------------------------------------------------------------------------------------------------------------------------------------------------------------X---------------------000000000000000
----------------------------------------------------------------------------------------------------------------------------------------------------------------------------------XX--------------------000000000000000
---------------------------------------------------------------------------------------------------------------------------------------------------------------------------------X----------------------000000000000000
--------------------------------------------------------------------------------------------------------------------------------------------------------------------------------------------------------000000000000000
--------------------------------------------------------------------------------------------------------------------------------------------------------------------------------------------------------000000000000000
---------------E-----------------------------oo-------------------------------------------E--------------------------------E----------------------------------------------------------------o-----------000000000000000
--------------<>---------------------------------------------------X--XX-----------------<>-------------------------------<>-----XXXXXXXXXXX----E------XXXXXXXXX--------------XX------------------------000000000000000
--------------[]-------------------------------------E--E-----E-------XX-----------------[]-------------------------------[]---------------------------------------------E--XXXX------------------------000000000000000
--------------[]------------------------------------<>-<>-------------XX-----------------[]-------------------------------[]--------------------------------------------<>-XXXXX------------------------000000000000000
--------------[]------E-E--------------E------------[]-[]-------------XX---E-E-------E---[]-----E------E-E----------EE-E--[]--------------------------------------------[]XXXXXX---------E-E-----X------000000000000000
XXXXXXXXXXXXXXXXXXXXXXXXXXXXXXXXXXXXXXXXXXXXXXXXXXXXXXXXXXXXXXXXXXXXXXXXXXXXXXXXXXXXXXXXXXXXXXXXXXXXXXXXXXXXXXXXXXXXXXXXXXXXXXXXX-----------XXXXXXXXXXX---------XXXXXXXXXXXXXXXXXXXXXXXXXXXXXXXXXXXXXXX-000000000000000
00000000000000000000000000000000000000000000000000000000000000000000000000000000000000000000000000000000000000000000000000000000000000000000000000000000000000000000000000000000000000000000000000000000000000000000000