0000000000000000000000000000000000000000000000000000000000000000000000000000000000000000000000000000000000000000000000000000000000000000000000000000000000000000000000000000--------------------000000000000000
0000000000000000000000000000000000000000000000000000000000000000000000000000000000000000000000000000000000000000000000000000000000000000000000000000000000000000000000000000--------------------000000000000000
0000000000000000000000000000000000000000000000000000000000000000000000000000000000000000000000000000000000000000000000000000000000000000000000000000000000000000000000000000--------------------000000000000000
0000000000000000000000000000000000000000000000000000000000000000000000000000000000000000000000000000000000000000000000000000000000000000000000000000000000000000000000000000--------------------000000000000000
000000000000000000000000000000000000000000000000000000000000000000000000000000000000000000000000000000000000000000000000000000000000000000000000000000000000----------------S-------------------000000000000000
000000000000000000000000000000000000000000000000000000000000000000000000000000000000000000000000000000000000000000000000000000000000000000000000000000000000------TTT-------S-------------------000000000000000
000000000000000000000000000000000000000000000000000000000000000000000000000000000000000000000000000000000000000000000000000000000000000000000000000000000000----------------S-------------------000000000000000
000000000000000000000000000000000000000000000000000000000000000000000000000000000000000000000000000000000000000000000000000000000000000000000000000000000000---------TTTT---S--------SS---------000000000000000
0000000000000000000000000000000000000000000000000000000000000000000000000000000000000000000000000000000000000000000000000000000000000000------------------------------------S----------------ooo000000000000000
0000000000000000000000000000000000000000000000000000000000000000000000000000000000000000000000000000000000000000000000000000000000000000------------------------------------S-------------------000000000000000
0000000000000000000000000000000000000000000000000000000000000000000000000000000000000000000000000000000000000000000000000000000000000000---------------------XXXX-----------S--------------E----000000000000000
0000000000000000000000000000000000000000000000000000000000000000000000000000000000000000000000000000000000000000000000000000000000000000------------------------------------S-----E--SSS--<>----000000000000000
000000000000000000000000000000000000000000000000000000000000000000000000000000000000000000000000000000000000000000000000XXXXXXXE----XXXXS-----------------------------------S----<>-------[]----000000000000000
000000000000000000000000000000000000000000000000000000000000000000000000000000000000000000000000000000000000000000000000XXXX--------XXXXS-----------------------XXXX--------S----[]-------[]----000000000000000
000000000000000000000000000000000000000000000000000000000000000000000000000000000000000000000000000000000000000000000000XX------------XXS-------------------XXXXXXXXXXXXXXXXS----[]-------[]----000000000000000
000000000000000000000000000000000000000000000000000000000000000000000000000000000000000000000000000000000000000000000000XX-----XXXX---DXS-------------------XXXX----------XXXXXXXXXXXXXXXXXXXXXX000000000000000
000000000000000000000000000000000000000000000000000000000000000000000000000000000000000000000000000000000000000000000000XX------------DXS-------------------XXXX----------XX00000000000000000000000000000000000
000000000000000000000000000000000000000000000000000000000000000000000000000000000000000000000000000000000000000000000000XXXX--------XXXXS-------------------XXXXXXXXXXXX---X00000000000000000000000000000000000
------------------------------------------------------------------------------------------------------------------------XXXXXX------XXXXS-------------------XXXXXXXXXXXXXXXX00000000000000000000000000000000000
------------------------------------------------------------------------------------------------------------------------XXXX--------XXXXS-------------------XXXX----------XX00000000000000000000000000000000000
------------------------------------------------------------------------------------------------------------------------XXXX--------XXXXS----------------E--XD-------------X00000000000000000000000000000000000
------------------------------------------------------------------------------------------------------------------------XX----TTTTTTTTXXS-------------------XD-------------X00000000000000000000000000000000000
S-------------------S-------------------S-------------------S-------------------S-------------------S-------------------XX------------XXS-------------------XXXXX-------XXXX00000000000000000000000000000000000
S-------------------S-------------------S-------------------S-------------------S-------------------S-------------------XX------------XXXXXXXXXXXXXXXXXXXXXXXXXXXXXXXXXXXXXX00000000000000000000000000000000000
S-------------------S-------------------S-------------------S-------------------S-------------------S-------------------XXXXXXXXXX----XX00000000000000000000000000000000000000000000000000000000000000000000000
S-------------------S-------------------S-------------------S-----------SSSSSSSSS-------------------S---------XXXX------XX------------XX00000000000000000000000000000000000000000000000000000000000000000000000
S-------------------S-------------------S-------------------S-------------------S-------------------S--------XXXXX------XX------------XX00000000000000000000000000000000000000000000000000000000000000000000000
S-------------------S-------------------S--E----------------S-------------------S-------------------S--------XXXXX------XX----XXXXXXXXXX00000000000000000000000000000000000000000000000000000000000000000000000
S-------------------S-------------ooo---S-->----------------S-------------------S-------------------S-E-o---XXXXXX------XD------------XX00000000000000000000000000000000000000000000000000000000000000000000000
S------------E------S-------------------S-<]----------------S-------------------S--------------E----S------XXXXXXX------XD------------XX00000000000000000000000000000000000000000000000000000000000000000000000
S----------------E--S-------------------S-[]---------------<S-------------------S----E--------<>---<S----XXXXXXXXX------XXXXX-------XXXX00000000000000000000000000000000000000000000000000000000000000000000000
S---------------<>--S----------------X--S-[]---------------[S--------E----------S-------------[]---[S---XXXXXXXXXX-----XXXXXXXXXXXXXXXXX00000000000000000000000000000000000000000000000000000000000000000000000
S---------------[]--S-----E-------EE----S-[]---------------[S------------------ES-------EE-EE-[]---[S--XXXXXXXXXXX------000000000000000000000000000000000000000000000000000000000000000000000000000000000000000
XXXXXXXXXXXXXXXXXXXXXXXXXXXXXXXXXXXXXXXXXXXXXXXXXXXXXXXXXXXXXXXXXXXXXXXXXXXXXXXXXXXXXXXXXXXXXXXXXXXXXXXXXXXXXXXXXXXXXXX-000000000000000000000000000000000000000000000000000000000000000000000000000000000000000
000000000000000000000000000000000000000000000000000000000000000000000000000000000000000000000000000000000000000000000000000000000000000000000000000000000000000000000000000000000000000000000000000000000000000