000000000000000000000000000000000000000000000000000000000000000000000000000000000000000000000000000000000000000000000000000000000000-----E--------E-
000000000000000000000000000000000000000000000000000000000000000000000000000000000000000000000000000000000000000000000000000000000000MMMMMMMMMMMMMMMM
000000000000000000000000000000000000000000000000000000000000000000000000000000000000000000000000000000000000000000000000000000000000----------------
000000000000000000000000000000000000000000000000000000000000000000000000000000000000000000000000000000000000000000000000000000000000----------------
000000000000000000000000000000000000000000000000000000000000000000000000000000000000000000000000000000000000000000000000000000000000XXXXXXXXX------X
000000000000000000000000000000000000000000000000000000000000000000000000000000000000000000000000000000000000000000000000000000000000---------------X
000000000000000000000000000000000000000000000000000000000000000000000000000000000000000000000000000000000000000000000000000000000000-----------TTTTX
000000000000000000000000000000000000000000000000000000000000000000000000000000000000000000000000000000000000000000000000000000000000---------------X
000000000000000000000000000000000000000000000000000000000000000000000000000000000000000000000000000000000000000000000000000000000000---------------X
000000000000000000000000000000000000000000000000000000000000000000000000000000000000000000000000000000000000000000000000000000000000-------------TTX
000000000000000000000000000000000000000000000000000000000000000000000000000000000000000000000000000000000000000000000000000000000000---------------X
000000000000000000000000000000000000000000000000000000000000000000000000000000000000000000000000000000000000000000000000000000000000------XXXXXXXXXX
000000000000000000000000000000000000000000000000000000000000000000000000000000000000000000000000000000000000000000000000000000000000------XX--------
000000000000000000000000000000000000000000000000000000000000000000000000000000000000000000000000000000000000000000000000000000000000------XX--------
000000000000000000000000000000000000000000000000000000000000000000000000000000000000000000000000000000000000000000000000000000000000--------XXXXX---
000000000000000000000000000000000000000000000000000000000000000000000000000000000000000000000000000000000000000000000000000000000000-----------XX---
000000000000000000000000000000000000000000000000000000000000000000000000000000000000000000000000000000000000000000000000000000000000XX----------XXXX
000000000000000000000000000000000000000000000000000000000000000000000000000000000000000000000000000000000000000000000000000000000000XD-------------X
000000000000000000000000000000000000000000000000000000000000000000000000000000000000000000000000000000000000000000000000000000000000XD-------------X
000000000000000000000000000000000000000000000000000000000000000000000000000000000000000000000000000000000000000000000000000000000000XXXXXXXXXXX-----
000000000000000000000000000000000000000000000000000000000000000000000000000000000000000000000000000000000000000000000000000000000000----XXXXX--XXXX-
000000000000000000000000000000000000000000000000000000000000000000000000000000000000000000000000000000000000000000000000000000000000----XXXX--XXXX--
000000000000000000000000000000000000000000000000000000000000000000000000000000000000000000000000000000000000000000000000000000000000----XXXX--XXXX--
000000000000000000000000000000000000000000000000000000000000000000000000000000000000000000000000000000000000000000000000000000000000----XXXX-TTTTTTT
000000000000000000000000000000000000000000000000000000000000000000000000000000000000000000000000000000000000000000000000000000000000----XXXX--XXXX--
000000000000000000000000000000000000000000000000000000000000000000000000000000000000000000000000000000000000000000000000000000000000----XXXX--XXXX--
000000000000000000000000000000000000000000000000000000000000000000000000000000000000000000000000000000000000000000000000000000000000----XTTTT-XXXX--
000000000000000000000000000000000000000000000000000000000000000000000000000000000000000000000000000000000000000000000000000000000000----------XXXX--
000000000000000000000000000000000000000000000000000000000000000000000000000000000000000000000000000000000000000000000000000000000000----------XXXX--
000000000000000000000000000000000000000000000000000000000000000000000000000000000000000000000000000000000000000000000000000000000000---------TTTXX--
000000000000000000000000000000000000000000000000000000000000000000000000000000000000000000000000000000000000000000000000000000000000-------E--------
00000000000000000000000000000000000000000000000000000000000000000000000000000000000000000000--------------------------------------------------------
00000000000000000000000000000000000000000000000000000000000000000000000000000000000000000000-------------------------------------------------XXXXXXX
00000000000000000000000000000000000000000000000000000000000000000000000000000000000000000000--------------------------------------------------------
00000000000000000000000000000000000000000000000000000000000000000000000000000000000000000000--------------------------------------------------------
00000000000000000000000000000000000000000000000000000000000000000000000000000000000000000000----------------------------------------XX-----------XXX
00000000000000000000000000000000000000000000000000000000000000000000000000000000000000000000----------------------------------------XX----------TTTT
00000000000000000000000000000000000000000000000000000000000000000000000000000000000000000000----------------------------------------XD-------------X
00000000000000000000000000000000000000000000000000000000000000000000000000000000000000000000----------------------------------SSSSS-XD-------------X
00000000000000000000000000000000000000000000000000000000000000000000000000000000000000000000---------------------------------------SXXXXXXXXXXX-----
00000000000000000000000000000000000000000000000000000000000000000000000000000000000000000000----------------------------------------0000000000000000
00000000000000000000000000000000000000000000000000000000000000000000000000000000000000000000---------------E------------------------0000000000000000
00000000000000000000000000000000000000000000000000000000000000000000000000000000000000000000------Q-------<>-------------------E----0000000000000000
00000000000000000000000000000000000000000000000000000000000000000000000000000000000000000000--------------[]------------------<>----0000000000000000
00000000000000000000000000000000000000000000000000000000000000000000000000000000000000000000--------------[]-------------X----[]----0000000000000000
0000000000000000000000000000000000000000000000000000000000000000000000000000-------XXXX-----------E-------[]------------XX----[]-E--0000000000000000
0000000000000000000000000000000000000000000000000000000000000000000000000000----------------XXXXXXXXXXXXXXXXXXX-XXXXXXXXXXXXXXXXXXX-0000000000000000
0000000000000000000000000000000000000000000000000000000000000000000000000000---------XXXX---00000000000000000000000000000000000000000000000000000000
0000000000000000000000000000000000000000000000000000000000000000000000000000----------------00000000000000000000000000000000000000000000000000000000
0000000000000000000000000000000000000000000000000000000000000000000000000000XXXX--------XXXX00000000000000000000000000000000000000000000000000000000
0000000000000000000000000000000000000000000000000000000000000000000000000000-----E----------00000000000000000000000000000000000000000000000000000000
0000000000000000000000000000000000000000000000000000000000000000000000000000----TTT---------00000000000000000000000000000000000000000000000000000000
0000000000000000000000000000000000000000000000000000000000000000000000000000----------------00000000000000000000000000000000000000000000000000000000
0000000000000000000000000000000000000000000000000000000000000000000000000000------XXXX------00000000000000000000000000000000000000000000000000000000
0000000000000000000000000000000000000000000000000000000000000000000000000000TTTTTTTT--------00000000000000000000000000000000000000000000000000000000
0000000000000000000000000000000000000000000000000000000000000000000000000000----------------00000000000000000000000000000000000000000000000000000000
0000000000000000000000000000000000000000000000000000000000000000000000000000-------------XXX00000000000000000000000000000000000000000000000000000000
0000000000000000000000000000000000000000000000000000000000000000000000000000---------------X00000000000000000000000000000000000000000000000000000000
0000000000000000000000000000000000000000000000000000000000000000000000000000---------------X00000000000000000000000000000000000000000000000000000000
0000000000000000000000000000000000000000000000000000000000000000000000000000---------------X00000000000000000000000000000000000000000000000000000000
0000000000000000000000000000000000000000000000000000000000000000000000000000-X---------X---X00000000000000000000000000000000000000000000000000000000
0000000000000000000000000000000000000000000000000000000000000000000000000000XX----------XXXX00000000000000000000000000000000000000000000000000000000
0000000000000000000000000000000000000000000000000000000000000000000000000000XD-------------X00000000000000000000000000000000000000000000000000000000
0000000000000000000000000000000000000000000000000000000000000000000000000000XD-------------X00000000000000000000000000000000000000000000000000000000
000000000000000000000000000000000000----------------------------------------XXXXXXXXXXX-----00000000000000000000000000000000000000000000000000000000
000000000000000000000000000000000000----------------------------------------000000000000000000000000000000000000000000000000000000000000000000000000
000000000000000000000000000000000000----------------------------------------000000000000000000000000000000000000000000000000000000000000000000000000
000000000000000000000000000000000000----------------------------------------000000000000000000000000000000000000000000000000000000000000000000000000
000000000000000000000000000000000000----------------------------------------000000000000000000000000000000000000000000000000000000000000000000000000
000000000000000000000000000000000000----------------------------------------000000000000000000000000000000000000000000000000000000000000000000000000
000000000000000000000000000000000000----------------------------------------000000000000000000000000000000000000000000000000000000000000000000000000
000000000000000000000000000000000000------------------E----------SSSSSSSSSS-000000000000000000000000000000000000000000000000000000000000000000000000
000000000000000000000000000000000000-----------------<>---------------------000000000000000000000000000000000000000000000000000000000000000000000000
000000000000000000000000000000000000-----------------[]---------------------000000000000000000000000000000000000000000000000000000000000000000000000
000000000000000000000000000000000000-----------------XX---------------------000000000000000000000000000000000000000000000000000000000000000000000000
000000000000000000000000000000000000--------S?S--------X--------------------000000000000000000000000000000000000000000000000000000000000000000000000
000000000000000000000000000000000000--------------------------------S-------000000000000000000000000000000000000000000000000000000000000000000000000
000000000000000000000000000000000000---------------X------------------------000000000000000000000000000000000000000000000000000000000000000000000000
000000000000000000000000000000000000---------------X------------------------000000000000000000000000000000000000000000000000000000000000000000000000
00000000000000000000----------------XXXXXXXXXXXXXXXX-XX-XXXXXXXXXXXXXXXXXX--000000000000000000000000000000000000000000000000000000000000000000000000
00000000000000000000---TTTT--TTTT---0000000000000000000000000000000000000000000000000000000000000000000000000000000000000000000000000000000000000000
00000000000000000000----------------0000000000000000000000000000000000000000000000000000000000000000000000000000000000000000000000000000000000000000
00000000000000000000----------------0000000000000000000000000000000000000000000000000000000000000000000000000000000000000000000000000000000000000000
00000000000000000000-----TTTTT------0000000000000000000000000000000000000000000000000000000000000000000000000000000000000000000000000000000000000000
00000000000000000000----------------0000000000000000000000000000000000000000000000000000000000000000000000000000000000000000000000000000000000000000
00000000000000000000----------------0000000000000000000000000000000000000000000000000000000000000000000000000000000000000000000000000000000000000000
00000000000000000000X----------TTTT-0000000000000000000000000000000000000000000000000000000000000000000000000000000000000000000000000000000000000000
00000000000000000000----------------0000000000000000000000000000000000000000000000000000000000000000000000000000000000000000000000000000000000000000
00000000000000000000----------------0000000000000000000000000000000000000000000000000000000000000000000000000000000000000000000000000000000000000000
00000000000000000000----XXXXXXXX----0000000000000000000000000000000000000000000000000000000000000000000000000000000000000000000000000000000000000000
00000000000000000000XX--------------0000000000000000000000000000000000000000000000000000000000000000000000000000000000000000000000000000000000000000
00000000000000000000XX--------------0000000000000000000000000000000000000000000000000000000000000000000000000000000000000000000000000000000000000000
00000000000000000000XXXX--TTTT------0000000000000000000000000000000000000000000000000000000000000000000000000000000000000000000000000000000000000000
00000000000000000000XXXX------------0000000000000000000000000000000000000000000000000000000000000000000000000000000000000000000000000000000000000000
00000000000000000000XX-------------X0000000000000000000000000000000000000000000000000000000000000000000000000000000000000000000000000000000000000000
00000000000000000000XX----------TTTT0000000000000000000000000000000000000000000000000000000000000000000000000000000000000000000000000000000000000000
00000000000000000000XD-------------X0000000000000000000000000000000000000000000000000000000000000000000000000000000000000000000000000000000000000000
00000000000000000000XD-------------X0000000000000000000000000000000000000000000000000000000000000000000000000000000000000000000000000000000000000000
00000000000000000000XXXXXXXXXXX-----0000000000000000000000000000000000000000000000000000000000000000000000000000000000000000000000000000000000000000
00000000000000000000-X------------XX0000000000000000000000000000000000000000000000000000000000000000000000000000000000000000000000000000000000000000
00000000000000000000X-------------XX0000000000000000000000000000000000000000000000000000000000000000000000000000000000000000000000000000000000000000
00000000000000000000X-------------XX0000000000000000000000000000000000000000000000000000000000000000000000000000000000000000000000000000000000000000
00000000000000000000XMMMMMMMMMMMMMXX0000000000000000000000000000000000000000000000000000000000000000000000000000000000000000000000000000000000000000
00000000000000000000XX--------------0000000000000000000000000000000000000000000000000000000000000000000000000000000000000000000000000000000000000000
--------------------XX--------------0000000000000000000000000000000000000000000000000000000000000000000000000000000000000000000000000000000000000000
--------------------XXXX--------XXXX0000000000000000000000000000000000000000000000000000000000000000000000000000000000000000000000000000000000000000
--------------------XXXX--------XXXX0000000000000000000000000000000000000000000000000000000000000000000000000000000000000000000000000000000000000000
--------------------XXXX--------XXXX0000000000000000000000000000000000000000000000000000000000000000000000000000000000000000000000000000000000000000
--------------------XXXX--------XXXX0000000000000000000000000000000000000000000000000000000000000000000000000000000000000000000000000000000000000000
--------------------XXXX--------XXXX0000000000000000000000000000000000000000000000000000000000000000000000000000000000000000000000000000000000000000
--------------------XXXX--------XXXX0000000000000000000000000000000000000000000000000000000000000000000000000000000000000000000000000000000000000000
--------------------XXXX--------XXXX0000000000000000000000000000000000000000000000000000000000000000000000000000000000000000000000000000000000000000
--------------------XX----TTTT--XXXX0000000000000000000000000000000000000000000000000000000000000000000000000000000000000000000000000000000000000000
--------------o-----XX-----------XXX0000000000000000000000000000000000000000000000000000000000000000000000000000000000000000000000000000000000000000
--------------------XX-----------XXX0000000000000000000000000000000000000000000000000000000000000000000000000000000000000000000000000000000000000000
--------------------XX----------TTTT0000000000000000000000000000000000000000000000000000000000000000000000000000000000000000000000000000000000000000
--------------------XD-------------X0000000000000000000000000000000000000000000000000000000000000000000000000000000000000000000000000000000000000000
-----------------XX-XD-------------X0000000000000000000000000000000000000000000000000000000000000000000000000000000000000000000000000000000000000000
--X----------------XXXXXXXXXXXX-----0000000000000000000000000000000000000000000000000000000000000000000000000000000000000000000000000000000000000000
XXXXXXXXXX----------00000000000000000000000000000000000000000000000000000000000000000000000000000000000000000000000000000000000000000000000000000000
0000000000000000000000000000000000000000000000000000000000000000000000000000000000000000000000000000000000000000000000000000000000000000000000000000