000000000000000000000000000000000000000000000000000000000000000000000000000000000000000000000000000000000000000000000000000000000000000000000000000000000000000000000000XTTTTTTTT---XXXX
000000000000000000000000000000000000000000000000000000000000000000000000000000000000000000000000000000000000000000000000000000000000000000000000000000000000000000000000XXXX--------XXXX
000000000000000000000000000000000000000000000000000000000000000000000000000000000000000000000000000000000000000000000000000000000000000000000000000000000000000000000000XXXX--------XXXX
000000000000000000000000000000000000000000000000000000000000000000000000000000000000000000000000000000000000000000000000000000000000000000000000000000000000000000000000XXXXXXX-----XXXX
00000000000000000000000000000000000000000000000000000000000000000000000000000000000000000000000000000000000000000000000000000000----------------------------------------XXXX------T-XXXX
00000000000000000000000000000000000000000000000000000000000000000000000000000000000000000000000000000000000000000000000000000000----------------------------------------XX-----------XXX
00000000000000000000000000000000000000000000000000000000000000000000000000000000000000000000000000000000000000000000000000000000----------------------------------------XX-----------XXX
00000000000000000000000000000000000000000000000000000000000000000000000000000000000000000000000000000000000000000000000000000000----------------------------------------XXXX---------XXX
0000000000000000000000000000000000000000000000000000000000000000000000000000000000000000000000000000000000000000---------------XS-------------------S-------------------XXXX---------XXX
0000000000000000000000000000000000000000000000000000000000000000000000000000000000000000000000000000000000000000X-----------XXXXS-------------------S-------------------XXXX----------X-
0000000000000000000000000000000000000000000000000000000000000000000000000000000000000000000000000000000000000000X---XXXXXXXXXXXXS-------------------S-------------------XXXX------------
0000000000000000000000000000000000000000000000000000000000000000000000000000000000000000000000000000000000000000X-------------XXS-----X-------------S-------------------XXXX------------
0000000000000000000000000000000000000000000000000000000000000000000000000000000000000000000000000000000000000000X-------------XXS-------------------S-------------E-----XXXXXXXXX-------
0000000000000000000000000000000000000000000000000000000000000000000000000000000000000000000000000000000000000000X-------------DXS-------------------S-------------------XXXX------------
00000000000000000000000000000000000000000000000000000000000000000000000000000000000000000000--------------------X-----XXXX----DXS-------------------S-------------------XX--------------
00000000000000000000000000000000000000000000000000000000000000000000000000000000000000000000--------------------X------------XXXS-X-----------------S--------E-------E--XX-----TTTT-----
00000000000000000000000000000000000000000000000000000000000000000000000000000000000000000000--------------------X-------------XXS-X-----E-----------S---------------<>--XD-------------X
00000000000000000000000000000000000000000000000000000000000000000000000000000000000000000000--------------------X-------------XXS-X-----------------S---------------[]--XD------------DX
0000000000000000000000000000000000000000000000000000000000000000000000000000XXXX------XXXX--S-------------------X---XXXX------XXS-X--E--------------S---------------[]--XXXXX-------XXXX
0000000000000000000000000000000000000000000000000000000000000000000000000000XXXX--XXXXXXXXX-S-------------------X---XXXXXXXX--XXXXXXXXXXXXXXXXXXXXXXXXXXXXXXXXXXXXXXXXXXXXXXXXXXXXXXXXXX
0000000000000000000000000000000000000000000000000000000000000000000000000000XXXX--------XXXXS-------------------XX----------XXXX00000000000000000000000000000000000000000000000000000000
0000000000000000000000000000000000000000000000000000000000000000000000000000XXXX--------XXXXS---XXXXXXXX--------XX----------XXXX00000000000000000000000000000000000000000000000000000000
0000000000000000000000000000000000000000000000000000000000000000000000000000XX------------XXS---XXXXXXXX--------XX----------XXXX00000000000000000000000000000000000000000000000000000000
0000000000000000000000000000000000000000000000000000000000000000000000000000XX-----XXXX---DXS--XXXXXXXXX--------XXXXXXXX----XXXX00000000000000000000000000000000000000000000000000000000
0000000000000000000000000000000000000000000000000000000000000000000000000000XX------------DXS--XXXXXXXXX--------XD--------------00000000000000000000000000000000000000000000000000000000
0000000000000000000000000000000000000000000000000000000000000000000000000000XXXX--------XXXXS-XXXXXXXXXX--------XD-------------X00000000000000000000000000000000000000000000000000000000
0000000000000000000000000000000000000000000000000000000000000000000000000000XXXXXX------XXXXS-XXXXXXXXXX--------XXXXX-------XXXX00000000000000000000000000000000000000000000000000000000
0000000000000000000000000000000000000000000000000000000000000000000000000000XXXX--------XXXXS-XXXXXXXXXX------<>XXXXXXXXXXXXXXXX00000000000000000000000000000000000000000000000000000000
0000000000000000000000000000000000000000000000000000000000000000000000000000XXXX--------XXXXS-XXXXXXXXXX------[]000000000000000000000000000000000000000000000000000000000000000000000000
0000000000000000000000000000000000000000000000000000000000000000000000000000XX----TTTTTTTTXXXXXXXXXXXXXXXXXXXXXX000000000000000000000000000000000000000000000000000000000000000000000000
0000000000000000000000000000000000000000000000000000000000000000000000000000XX------------XX00000000000000000000000000000000000000000000000000000000000000000000000000000000000000000000
0000000000000000000000000000000000000000000000000000000000000000000000000000XX------------XX00000000000000000000000000000000000000000000000000000000000000000000000000000000000000000000
0000000000000000000000000000000000000000000000000000000000000000000000000000XXXXXXXX------XX00000000000000000000000000000000000000000000000000000000000000000000000000000000000000000000
0000000000000000000000000000000000000000000000000000000000000000000000000000XX----XXXXX---XX00000000000000000000000000000000000000000000000000000000000000000000000000000000000000000000
0000000000000000000000000000000000000000000000000000000000000000000000000000XD------------XX00000000000000000000000000000000000000000000000000000000000000000000000000000000000000000000
0000000000000000000000000000000000000000000000000000000000000000000000000000XD------------XX00000000000000000000000000000000000000000000000000000000000000000000000000000000000000000000
0000000000000000000000000000000000000000000000000000000000000000000000000000XXXXX-------XXXX00000000000000000000000000000000000000000000000000000000000000000000000000000000000000000000
000000000000000000000000000000000000----------------------------------------XXXXXXXXXXXXXXXX00000000000000000000000000000000000000000000000000000000000000000000000000000000000000000000
000000000000000000000000000000000000----------------------------------------000000000000000000000000000000000000000000000000000000000000000000000000000000000000000000000000000000000000
000000000000000000000000000000000000----------------------------------------000000000000000000000000000000000000000000000000000000000000000000000000000000000000000000000000000000000000
000000000000000000000000000000000000----------------------------------------000000000000000000000000000000000000000000000000000000000000000000000000000000000000000000000000000000000000
00000000000000000000----------------S-------------------S-------------------000000000000000000000000000000000000000000000000000000000000000000000000000000000000000000000000000000000000
00000000000000000000----E--------E--S-------------------S-------------------000000000000000000000000000000000000000000000000000000000000000000000000000000000000000000000000000000000000
00000000000000000000MMMMMMMMMMMMMMMMS-------------------S-------------------000000000000000000000000000000000000000000000000000000000000000000000000000000000000000000000000000000000000
00000000000000000000----------------S-------------------S-------------------000000000000000000000000000000000000000000000000000000000000000000000000000000000000000000000000000000000000
00000000000000000000----------------S-------------------S-------------------000000000000000000000000000000000000000000000000000000000000000000000000000000000000000000000000000000000000
00000000000000000000---------T------S-------------------S-------------------000000000000000000000000000000000000000000000000000000000000000000000000000000000000000000000000000000000000
00000000000000000000----------------S------------oooo---S-------------------000000000000000000000000000000000000000000000000000000000000000000000000000000000000000000000000000000000000
00000000000000000000----------------S-------------------S-------------------000000000000000000000000000000000000000000000000000000000000000000000000000000000000000000000000000000000000
--------------------XX----TTTTTTTTXXS-------------------S-------------------000000000000000000000000000000000000000000000000000000000000000000000000000000000000000000000000000000000000
--------------------XX------------XXS-------------------S-------------------000000000000000000000000000000000000000000000000000000000000000000000000000000000000000000000000000000000000
--------------------XX------------XXS-------------------S-------------------000000000000000000000000000000000000000000000000000000000000000000000000000000000000000000000000000000000000
--------------------XXXXXXXX------XXXXXXXXXXXXXXXXXXXXXXXXXXXXXXXXXXXXXXXXX-000000000000000000000000000000000000000000000000000000000000000000000000000000000000000000000000000000000000
S-------------------XXXXXXXXXX----XX0000000000000000000000000000000000000000000000000000000000000000000000000000000000000000000000000000000000000000000000000000000000000000000000000000
S-------------------XX------------XX0000000000000000000000000000000000000000000000000000000000000000000000000000000000000000000000000000000000000000000000000000000000000000000000000000
S-------------------XX------------XX0000000000000000000000000000000000000000000000000000000000000000000000000000000000000000000000000000000000000000000000000000000000000000000000000000
S-------------------XX----XXXXXXXXXX0000000000000000000000000000000000000000000000000000000000000000000000000000000000000000000000000000000000000000000000000000000000000000000000000000
S-------------------XD-------------X0000000000000000000000000000000000000000000000000000000000000000000000000000000000000000000000000000000000000000000000000000000000000000000000000000
S-------------------XD------------DX0000000000000000000000000000000000000000000000000000000000000000000000000000000000000000000000000000000000000000000000000000000000000000000000000000
S-------------------XXXXX-------XXXX0000000000000000000000000000000000000000000000000000000000000000000000000000000000000000000000000000000000000000000000000000000000000000000000000000
S--------E--------XXXXXXXXXXXXXXXXXX0000000000000000000000000000000000000000000000000000000000000000000000000000000000000000000000000000000000000000000000000000000000000000000000000000
S-------<>----------00000000000000000000000000000000000000000000000000000000000000000000000000000000000000000000000000000000000000000000000000000000000000000000000000000000000000000000
S-------[]----------00000000000000000000000000000000000000000000000000000000000000000000000000000000000000000000000000000000000000000000000000000000000000000000000000000000000000000000
S-------[]----------00000000000000000000000000000000000000000000000000000000000000000000000000000000000000000000000000000000000000000000000000000000000000000000000000000000000000000000
XXXXXXXXXXXXXXXXXX--00000000000000000000000000000000000000000000000000000000000000000000000000000000000000000000000000000000000000000000000000000000000000000000000000000000000000000000
0000000000000000000000000000000000000000000000000000000000000000000000000000000000000000000000000000000000000000000000000000000000000000000000000000000000000000000000000000000000000000