000000000000000000000000000000000000000000000000000000000000000000000000000000000000000000000000000000000000--------------------000000000000000
000000000000000000000000000000000000000000000000000000000000000000000000000000000000000000000000000000000000--------------------000000000000000
000000000000000000000000000000000000000000000000000000000000000000000000000000000000000000000000000000000000--------------------000000000000000
000000000000000000000000000000000000000000000000000000000000000000000000000000000000000000000000000000000000--------------------000000000000000
000000000000000000000000000000000000000000000000000000000000000000000000000000000000000000000000000000000000--------------------000000000000000
000000000000000000000000000000000000000000000000000000000000000000000000000000000000000000000000000000000000--------------------000000000000000
000000000000000000000000000000000000000000000000000000000000000000000000000000000000000000000000000000000000--------oo----------000000000000000
000000000000000000000000000000000000000000000000000000000000000000000000000000000000000000000000000000000000--------------o-----000000000000000
000000000000000000000000000000000000000000000000000000000000000000000000000000000000000000000000000000000000---<E---------------000000000000000
000000000000000000000000000000000000000000000000000000000000000000000000000000000000000000000000000000000000---[>---------------000000000000000
000000000000000000000000000000000000000000000000000000000000000000000000000000000000000000000000000000000000---[]---------------000000000000000
000000000000000000000000000000000000000000000000000000000000000000000000000000000000000000000000000000000000---XXX---XX---------000000000000000
000000000000000000000000000000000000000000000000000000000000000000000000000000000000000000000000000000000000--------------------000000000000000
000000000000000000000000000000000000000000000000000000000000000000000000000000000000000000000000000000000000--------------------000000000000000
000000000000000000000000000000000000000000000000000000000000000000000000000000000000000000000000000000000000--------------------000000000000000
00000000000000000000000000000000000000000000000000000000000000000000000000000000000000000000----------------XXXXX---------XXXXX-000000000000000
00000000000000000000000000000000000000000000000000000000000000000000000000000000000000000000--------TTT-----00000000000000000000000000000000000
00000000000000000000000000000000000000000000000000000000000000000000000000000000000000000000----------------00000000000000000000000000000000000
00000000000000000000000000000000000000000000000000000000000000000000000000000000000000000000----------------00000000000000000000000000000000000
00000000000000000000000000000000000000000000000000000000000000000000000000000000000000000000---------XXXXXXX00000000000000000000000000000000000
00000000000000000000000000000000000000000000000000000000000000000000000000000000000000000000----------------00000000000000000000000000000000000
00000000000000000000000000000000000000000000000000000000000000000000000000000000000000000000------XXXX------00000000000000000000000000000000000
00000000000000000000000000000000000000000000000000000000000000000000000000000000000000000000----------------00000000000000000000000000000000000
00000000000000000000000000000000000000000000000000000000000000000000000000000000000000000000---XXXX---------00000000000000000000000000000000000
00000000000000000000000000000000000000000000000000000000000000000000000000000000000000000000----------------00000000000000000000000000000000000
00000000000000000000000000000000000000000000000000000000000000000000000000000000000000000000----------------00000000000000000000000000000000000
00000000000000000000000000000000000000000000000000000000000000000000000000000000000000000000XXXX------------00000000000000000000000000000000000
00000000000000000000000000000000000000000000000000000000000000000000000000000000000000000000XXXX------------00000000000000000000000000000000000
00000000000000000000000000000000000000000000000000000000000000000000000000000000000000000000XXXX--TTTT------00000000000000000000000000000000000
00000000000000000000000000000000000000000000000000000000000000000000000000000000000000000000XXXX------------00000000000000000000000000000000000
00000000000000000000000000000000000000000000000000000000000000000000000000000000000000000000XX-------------X00000000000000000000000000000000000
00000000000000000000000000000000000000000000000000000000000000000000000000000000000000000000XX----------TTTT00000000000000000000000000000000000
00000000000000000000000000000000000000000000000000000000000000000000000000000000000000000000XD-------------X00000000000000000000000000000000000
00000000000000000000000000000000000000000000000000000000000000000000000000000000000000000000XD-------------X00000000000000000000000000000000000
00000000000000000000000000000000000000000000000000000000000000000000000000000000000000000000XXXXXXXXXXX-----00000000000000000000000000000000000
00000000000000000000000000000000000000000000000000000000000000000000000000000000000000000000-XXXX--------XXX00000000000000000000000000000000000
00000000000000000000000000000000000000000000000000000000000000000000000000000000000000000000XXXX--------XXXX00000000000000000000000000000000000
00000000000000000000000000000000000000000000000000000000000000000000000000000000000000000000XXXX--------XXXX00000000000000000000000000000000000
00000000000000000000000000000000000000000000000000000000000000000000000000000000000000000000XXXX--------XXXX00000000000000000000000000000000000
00000000000000000000000000000000000000000000000000000000000000000000000000000000000000000000XXXX--------XXXX00000000000000000000000000000000000
00000000000000000000000000000000000000000000000000000000000000000000000000000000000000000000XXXX--------XXXX00000000000000000000000000000000000
00000000000000000000000000000000000000000000000000000000000000000000000000000000000000000000XXXX--------XXXX00000000000000000000000000000000000
000000000000000000000000000000000000000000000000000000000000000000000000--------------------XXXX--------XXXX00000000000000000000000000000000000
000000000000000000000000000000000000000000000000000000000000000000000000--------------------XXXXXXX-----XXXX00000000000000000000000000000000000
000000000000000000000000000000000000000000000000000000000000000000000000--------------------XXXXXXXX----XXXX00000000000000000000000000000000000
000000000000000000000000000000000000000000000000000000000000000000000000--------------------XX----TTXXXXXXXX00000000000000000000000000000000000
000000000000000000000000000000000000000000000000000000000000000000000000--------------------XX--------------00000000000000000000000000000000000
000000000000000000000000000000000000000000000000000000000000000000000000--------------------XX--------------00000000000000000000000000000000000
000000000000000000000000000000000000000000000000000000000000000000000000--------------------XXXX--TTTT------00000000000000000000000000000000000
000000000000000000000000000000000000000000000000000000000000000000000000--------------------XXXX------------00000000000000000000000000000000000
000000000000000000000000000000000000000000000000000000000000000000000000--------------------XX-------------X00000000000000000000000000000000000
000000000000000000000000000000000000000000000000000000000000000000000000--------------------XX----------TTTT00000000000000000000000000000000000
000000000000000000000000000000000000000000000000000000000000000000000000--------------------XD-------------X00000000000000000000000000000000000
000000000000000000000000000000000000000000000000000000000000000000000000----------------E---XD-------------X00000000000000000000000000000000000
000000000000000000000000000000000000000000000000000000000000000000000000---------------<>--SXXXXXXXXXXX-----00000000000000000000000000000000000
000000000000000000000000000000000000000000000000000000000000000000000000---------------[]---000000000000000000000000000000000000000000000000000
000000000000000000000000000000000000000000000000000000000000000000000000------EE----E--[]---000000000000000000000000000000000000000000000000000
00000000000000000000000000000000000000000000000000000000-TTTT------TTTTTXXXXXXXXXXXXXXXXXXX-000000000000000000000000000000000000000000000000000
00000000000000000000000000000000000000000000000000000000X---------------00000000000000000000000000000000000000000000000000000000000000000000000
00000000000000000000000000000000000000000000000000000000X---------------00000000000000000000000000000000000000000000000000000000000000000000000
00000000000000000000000000000000000000000000000000000000X-------TTTT----00000000000000000000000000000000000000000000000000000000000000000000000
00000000000000000000000000000000000000000000000000000000X---------------00000000000000000000000000000000000000000000000000000000000000000000000
00000000000000000000000000000000000000000000000000000000XX--------------00000000000000000000000000000000000000000000000000000000000000000000000
00000000000000000000000000000000000000000000000000000000XD--TTTT--------00000000000000000000000000000000000000000000000000000000000000000000000
00000000000000000000000000000000000000000000000000000000XD--------------00000000000000000000000000000000000000000000000000000000000000000000000
00000000000000000000000000000000000000000000000000000000XTTTT-----------00000000000000000000000000000000000000000000000000000000000000000000000
00000000000000000000000000000000000000000000000000000000----------------00000000000000000000000000000000000000000000000000000000000000000000000
00000000000000000000000000000000000000000000000000000000---TTTT---------00000000000000000000000000000000000000000000000000000000000000000000000
00000000000000000000000000000000000000000000000000000000XX--------------00000000000000000000000000000000000000000000000000000000000000000000000
00000000000000000000000000000000000000000000000000000000XX--------------00000000000000000000000000000000000000000000000000000000000000000000000
00000000000000000000000000000000000000000000000000000000XXXX--TTTT------00000000000000000000000000000000000000000000000000000000000000000000000
00000000000000000000000000000000000000000000000000000000XXXX------------00000000000000000000000000000000000000000000000000000000000000000000000
00000000000000000000000000000000000000000000000000000000XX-------------X00000000000000000000000000000000000000000000000000000000000000000000000
00000000000000000000000000000000000000000000000000000000XX----------TTTT00000000000000000000000000000000000000000000000000000000000000000000000
00000000000000000000000000000000000000000000000000000000XD-------------X00000000000000000000000000000000000000000000000000000000000000000000000
00000000000000000000000000000000000000000000000000000000XD-------------X00000000000000000000000000000000000000000000000000000000000000000000000
00000000000000000000000000000000000000000000000000000000XXXXXXXXXXX-----00000000000000000000000000000000000000000000000000000000000000000000000
00000000000000000000000000000000000000000000000000000000--------X---X---00000000000000000000000000000000000000000000000000000000000000000000000
00000000000000000000000000000000000000000000000000000000----------------00000000000000000000000000000000000000000000000000000000000000000000000
00000000000000000000000000000000000000000000000000000000----X-----------00000000000000000000000000000000000000000000000000000000000000000000000
00000000000000000000000000000000000000000000000000000000----------------00000000000000000000000000000000000000000000000000000000000000000000000
00000000000000000000000000000000000000000000000000000000----------------00000000000000000000000000000000000000000000000000000000000000000000000
00000000000000000000000000000000000000000000000000000000----TTTT--------00000000000000000000000000000000000000000000000000000000000000000000000
00000000000000000000000000000000000000000000000000000000----------TTT---00000000000000000000000000000000000000000000000000000000000000000000000
00000000000000000000000000000000000000000000000000000000----------------00000000000000000000000000000000000000000000000000000000000000000000000
00000000000000000000000000000000000000000000000000000000----------------00000000000000000000000000000000000000000000000000000000000000000000000
00000000000000000000000000000000000000000000000000000000XX----------XXXX00000000000000000000000000000000000000000000000000000000000000000000000
00000000000000000000000000000000000000000000000000000000XX----TTXXXXXXXX00000000000000000000000000000000000000000000000000000000000000000000000
00000000000000000000000000000000000000000000000000000000XX--------------00000000000000000000000000000000000000000000000000000000000000000000000
00000000000000000000000000000000000000000000000000000000XX--------------00000000000000000000000000000000000000000000000000000000000000000000000
00000000000000000000000000000000000000000000000000000000XXXX--TTTT------00000000000000000000000000000000000000000000000000000000000000000000000
00000000000000000000000000000000000000000000000000000000XXXX------------00000000000000000000000000000000000000000000000000000000000000000000000
00000000000000000000000000000000000000000000000000000000XX-------------X00000000000000000000000000000000000000000000000000000000000000000000000
00000000000000000000000000000000000000000000000000000000XX----------TTTT00000000000000000000000000000000000000000000000000000000000000000000000
00000000000000000000000000000000000000000000000000000000XD-------------X00000000000000000000000000000000000000000000000000000000000000000000000
00000000000000000000000000000000000000000000000000000000XD-------------X00000000000000000000000000000000000000000000000000000000000000000000000
00000000000000000000000000000000000000000000000000000000XXXXXXXXXXX-----00000000000000000000000000000000000000000000000000000000000000000000000
00000000000000000000000000000000000000000000000000000000-XX------------X00000000000000000000000000000000000000000000000000000000000000000000000
00000000000000000000000000000000000000000000000000000000XX----XXXXXXXXXX00000000000000000000000000000000000000000000000000000000000000000000000
00000000000000000000000000000000000000000000000000000000XX------------XX00000000000000000000000000000000000000000000000000000000000000000000000
00000000000000000000000000000000000000000000000000000000XX------------XX00000000000000000000000000000000000000000000000000000000000000000000000
00000000000000000000000000000000000000000000000000000000XXXX--------XXXX00000000000000000000000000000000000000000000000000000000000000000000000
00000000000000000000000000000000000000000000000000000000XXXX--------XXXX00000000000000000000000000000000000000000000000000000000000000000000000
00000000000000000000000000000000000000000000000000000000XXXX--------XXXX00000000000000000000000000000000000000000000000000000000000000000000000
00000000000000000000000000000000000000000000000000000000XXXX--------XXXX00000000000000000000000000000000000000000000000000000000000000000000000
00000000000000000000000000000000000000000000000000000000XXXX--------XXXX00000000000000000000000000000000000000000000000000000000000000000000000
00000000000000000000000000000000000000000000000000000000XXXX--------XXXX00000000000000000000000000000000000000000000000000000000000000000000000
00000000000000000000000000000000000000000000000000000000XX----TTTTTTTTXX00000000000000000000000000000000000000000000000000000000000000000000000
00000000000000000000000000000000000000000000000000000000XX-----------XXX00000000000000000000000000000000000000000000000000000000000000000000000
00000000000000000000000000000000000000000000000000000000XX-----------XXX00000000000000000000000000000000000000000000000000000000000000000000000
00000000000000000000000000000000000000000000000000000000XX-----------XXX00000000000000000000000000000000000000000000000000000000000000000000000
00000000000000000000000000000000000000000000000000000000XX-----------XXX00000000000000000000000000000000000000000000000000000000000000000000000
00000000000000000000000000000000000000000000000000000000XX-----------XXX00000000000000000000000000000000000000000000000000000000000000000000000
00000000000000000000000000000000000000000000000000000000XX----------TTTT00000000000000000000000000000000000000000000000000000000000000000000000
00000000000000000000000000000000000000000000000000000000XD-------------X00000000000000000000000000000000000000000000000000000000000000000000000
00000000000000000000000000000000000000000000000000000000XD-------------X00000000000000000000000000000000000000000000000000000000000000000000000
000000000000000000000000000000000000--------------------XXXXXXXXXXX-----00000000000000000000000000000000000000000000000000000000000000000000000
000000000000000000000000000000000000--------------------000000000000000000000000000000000000000000000000000000000000000000000000000000000000000
000000000000000000000000000000000000--------------------000000000000000000000000000000000000000000000000000000000000000000000000000000000000000
000000000000000000000000000000000000--------------------000000000000000000000000000000000000000000000000000000000000000000000000000000000000000
000000000000000000000000000000000000--------------------000000000000000000000000000000000000000000000000000000000000000000000000000000000000000
000000000000000000000000000000000000--------------------000000000000000000000000000000000000000000000000000000000000000000000000000000000000000
000000000000000000000000000000000000--------------------000000000000000000000000000000000000000000000000000000000000000000000000000000000000000
000000000000000000000000000000000000--------------------000000000000000000000000000000000000000000000000000000000000000000000000000000000000000
000000000000000000000000000000000000--------------------000000000000000000000000000000000000000000000000000000000000000000000000000000000000000
000000000000000000000000000000000000--------------------000000000000000000000000000000000000000000000000000000000000000000000000000000000000000
000000000000000000000000000000000000--------------------000000000000000000000000000000000000000000000000000000000000000000000000000000000000000
000000000000000000000000000000000000-------------E------000000000000000000000000000000000000000000000000000000000000000000000000000000000000000
000000000000000000000000000000000000-----E---X--<>------000000000000000000000000000000000000000000000000000000000000000000000000000000000000000
000000000000000000000000000000000000----<>--XX--[]------000000000000000000000000000000000000000000000000000000000000000000000000000000000000000
00000000000000000000------TT------------[]-XXX--[]-EE-E-000000000000000000000000000000000000000000000000000000000000000000000000000000000000000
00000000000000000000----------------XXXXXXXXXXXXXXXXXXX-000000000000000000000000000000000000000000000000000000000000000000000000000000000000000
00000000000000000000---E-----E------00000000000000000000000000000000000000000000000000000000000000000000000000000000000000000000000000000000000
00000000000000000000MMMMMMMMMMMMMMMX00000000000000000000000000000000000000000000000000000000000000000000000000000000000000000000000000000000000
00000000000000000000----------------00000000000000000000000000000000000000000000000000000000000000000000000000000000000000000000000000000000000
00000000000000000000--E--------E----00000000000000000000000000000000000000000000000000000000000000000000000000000000000000000000000000000000000
00000000000000000000MMMMMMMMMMMMMMMM00000000000000000000000000000000000000000000000000000000000000000000000000000000000000000000000000000000000
00000000000000000000----------------00000000000000000000000000000000000000000000000000000000000000000000000000000000000000000000000000000000000
00000000000000000000----------------00000000000000000000000000000000000000000000000000000000000000000000000000000000000000000000000000000000000
00000000000000000000---X------------00000000000000000000000000000000000000000000000000000000000000000000000000000000000000000000000000000000000
00000000000000000000---------X------00000000000000000000000000000000000000000000000000000000000000000000000000000000000000000000000000000000000
00000000000000000000----------------00000000000000000000000000000000000000000000000000000000000000000000000000000000000000000000000000000000000
00000000000000000000-----X----------00000000000000000000000000000000000000000000000000000000000000000000000000000000000000000000000000000000000
00000000000000000000--------XX------00000000000000000000000000000000000000000000000000000000000000000000000000000000000000000000000000000000000
00000000000000000000--------XXXXX---00000000000000000000000000000000000000000000000000000000000000000000000000000000000000000000000000000000000
00000000000000000000----------XX----00000000000000000000000000000000000000000000000000000000000000000000000000000000000000000000000000000000000
00000000000000000000XX----------XXXX00000000000000000000000000000000000000000000000000000000000000000000000000000000000000000000000000000000000
00000000000000000000XD-------------X00000000000000000000000000000000000000000000000000000000000000000000000000000000000000000000000000000000000
00000000000000000000XD-------------X00000000000000000000000000000000000000000000000000000000000000000000000000000000000000000000000000000000000
--------------------XXXXXXXXXXX-----00000000000000000000000000000000000000000000000000000000000000000000000000000000000000000000000000000000000
--------------------000000000000000000000000000000000000000000000000000000000000000000000000000000000000000000000000000000000000000000000000000
--------------------000000000000000000000000000000000000000000000000000000000000000000000000000000000000000000000000000000000000000000000000000
--------------------000000000000000000000000000000000000000000000000000000000000000000000000000000000000000000000000000000000000000000000000000
--------------------000000000000000000000000000000000000000000000000000000000000000000000000000000000000000000000000000000000000000000000000000
--------------------000000000000000000000000000000000000000000000000000000000000000000000000000000000000000000000000000000000000000000000000000
--------------------000000000000000000000000000000000000000000000000000000000000000000000000000000000000000000000000000000000000000000000000000
--------------------000000000000000000000000000000000000000000000000000000000000000000000000000000000000000000000000000000000000000000000000000
--------------------000000000000000000000000000000000000000000000000000000000000000000000000000000000000000000000000000000000000000000000000000
--------------------000000000000000000000000000000000000000000000000000000000000000000000000000000000000000000000000000000000000000000000000000
----E---------------000000000000000000000000000000000000000000000000000000000000000000000000000000000000000000000000000000000000000000000000000
---SS---------------000000000000000000000000000000000000000000000000000000000000000000000000000000000000000000000000000000000000000000000000000
--------------------000000000000000000000000000000000000000000000000000000000000000000000000000000000000000000000000000000000000000000000000000
--------------------000000000000000000000000000000000000000000000000000000000000000000000000000000000000000000000000000000000000000000000000000
--------------------000000000000000000000000000000000000000000000000000000000000000000000000000000000000000000000000000000000000000000000000000
XXXXXXXXXXXXXXXXXXX-000000000000000000000000000000000000000000000000000000000000000000000000000000000000000000000000000000000000000000000000000
00000000000000000000000000000000000000000000000000000000000000000000000000000000000000000000000000000000000000000000000000000000000000000000000