000000000000000000000000000000000000----------------
000000000000000000000000000000000000--------TTT-----
000000000000000000000000000000000000----------------
000000000000000000000000000000000000----------------
000000000000000000000000000000000000---------XXXXXXX
000000000000000000000000000000000000----------------
000000000000000000000000000000000000------XXXX------
000000000000000000000000000000000000----------------
000000000000000000000000000000000000---TTTT---------
000000000000000000000000000000000000XX--------------
000000000000000000000000000000000000XX--------------
000000000000000000000000000000000000XXXX--TTTT------
000000000000000000000000000000000000XXXX------------
000000000000000000000000000000000000XX-------------X
000000000000000000000000000000000000XX----------TTTT
000000000000000000000000000000000000XD-------------X
000000000000000000000000000000000000XD--------------
000000000000000000000000000000000000TTTTXXXXXXXX--DX
000000000000000000000000000000000000--TTTTTTTT----DX
000000000000000000000000000000000000---------TTTTTTT
000000000000000000000000000000000000--XXXX--------XX
000000000000000000000000000000000000XX----TTTTTTTTXX
000000000000000000000000000000000000XX------------XX
000000000000000000000000000000000000XX------------XX
000000000000000000000000000000000000XX-----XXXX---XX
000000000000000000000000000000000000XX------------XX
000000000000000000000000000000000000XXXX--------XXXX
000000000000000000000000000000000000XXXX--------XXXX
000000000000000000000000000000000000XXXX--------XXXX
000000000000000000000000000000000000XX----------XXXX
000000000000000000000000000000000000XX----------XXXX
000000000000000000000000000000000000XXXXXXXX---XXXXX
000000000000000000000000000000000000XXXXXXXX------XX
000000000000000000000000000000000000XX------------XX
000000000000000000000000000000000000XX--------XXXXXX
000000000000000000000000000000000000XD-------------X
000000000000000000000000000000000000XD-------------X
000000000000000000000000000000000000TTTTXXXXXXXX--DX
000000000000000000000000000000000000--TTTTTTTT----DX
000000000000000000000000000000000000---------TTTTTTT
000000000000000000000000000000000000--XXXXMMMMMMMMMM
000000000000000000000000000000000000XXXX------------
000000000000000000000000000000000000XXXXXXXX--------
000000000000000000000000000000000000XX------------X-
000000000000000000000000000000000000----------------
000000000000000000000000000000000000---------TTTT---
000000000000000000000000000000000000----------------
000000000000000000000000000000000000----------------
000000000000000000000000000000000000XX------TTTTTTXX
000000000000000000000000000000000000XX------------XX
000000000000000000000000000000000000XX------------XX
000000000000000000000000000000000000XXXXXXXXX-----XX
000000000000000000000000000000000000XXXX----------XX
000000000000000000000000000000000000XXXXXXXXXX-----X
000000000000000000000000000000000000XX--------XXXXXX
000000000000000000000000000000000000XD-------------X
000000000000000000000000000000000000XD-------------X
000000000000000000000000000000000000TTTTXXXXXXXX--DX
000000000000000000000000000000000000--TTTTTTTT----DX
000000000000000000000000000000000000---------TTTTTTT
000000000000000000000000000000000000---XXXX------XXX
000000000000000000000000000000000000-XXXX----EXXXXX-
000000000000000000000000000000000000XX----------XXXX
000000000000000000000000000000000000XD----------XXXX
000000000000000000000000000000000000XXXXXXXXE---XXXX
000000000000000000000000000000000000XXXX------XXXXXX
000000000000000000000000000000000000XXXX------XXXX--
000000000000000000000000000000000000XXXXE-EXXXXXXX--
000000000000000000000000000000000000XXXX------XXXX--
000000000000000000000000000000000000XX-----------XXX
000000000000000000000000000000000000XX--TT-------XXX
000000000000000000000000000000000000XX-----------XXX
000000000000000000000000000000000000XX-----------XXX
000000000000000000000000000000000000XXXXXXXXE--XXXX-
000000000000000000000000000000000000XXXX------XXXXX-
000000000000000000000000000000000000XD------------TX
000000000000000000000000000000000000XD-------------X
000000000000000000000000000000000000TTTTXXXXXXXX--DX
000000000000000000000000000000000000--TTTTTTTT----DX
000000000000000000000000000000000000---------TTTTTTT
000000000000000000000000000000000000--XX-----------X
000000000000000000000000000000000000XX-----------XXX
000000000000000000000000000000000000XX-----------XXX
000000000000000000000000000000000000XX-----------XXX
000000000000000000000000000000000000XX--TT-------XXX
000000000000000000000000000000000000XX-----------XXX
000000000000000000000000000000000000XX-----------XXX
000000000000000000000000000000000000-XXXXXXXE--XXXX-
000000000000000000000000000000000000-XXXX------XXXX-
000000000000000000000000000000000000-XXXX------XXXX-
000000000000000000000000000000000000-XXXX----EXXXXX-
000000000000000000000000000000000000XX----------XXXX
000000000000000000000000000000000000XX----------XXXX
000000000000000000000000000000000000XXXXXXXXE---XXXX
000000000000000000000000000000000000XXXX------XXXXXX
000000000000000000000000000000000000XD------------XX
000000000000000000000000000000000000XD-------------X
000000000000000000000000000000000000TTTTXXXXXXXX--DX
000000000000000000000000000000000000--TTTTTTTT----DX
000000000000000000000000000000000000---------TTTTTTT
000000000000000000000000000000000000--XXXX----------
000000000000000000000000000000000000XXXX------------
000000000000000000000000000000000000XXXXXXXXXXXX----
000000000000000000000000000000000000XXXX------------
000000000000000000000000000000000000XXXX------------
000000000000000000000000000000000000XXXX------------
000000000000000000000000000000000000XXXX------------
000000000000000000000000000000000000XXXX------------
000000000000000000000000000000000000XXXX------------
000000000000000000000000000000000000XXXXXXXXXXXX----
000000000000000000000000000000000000XXXXXXXXXXXX----
000000000000000000000000000000000000XXXX------------
000000000000000000000000000000000000XX-------------X
000000000000000000000000000000000000XX----------TTTT
000000000000000000000000000000000000XD-------------X
000000000000000000000000000000000000XD-------------X
000000000000000000000000000000000000XD-------------X
000000000000000000000000000000000000TTTTXXXXXXXX--DX
000000000000000000000000000000000000--TTTTTTTT----DX
000000000000000000000000000000000000---------TTTTTTT
000000000000000000000000000000000000----------------
000000000000000000000000000000000000--------T-------
000000000000000000000000000000000000----------------
000000000000000000000000000000000000----------------
000000000000000000000000000000000000-------X---X----
000000000000000000000000000000000000----------------
000000000000000000000000000000000000----X-----------
000000000000000000000000000000000000----------------
000000000000000000000000000000000000----------------
000000000000000000000000000000000000XXXX------------
000000000000000000000000000000000000XXXX------------
000000000000000000000000000000000000XXXXXXXXE-------
000000000000000000000000000000000000XXXXXXXXXXXXXXXX
000000000000000000000000000000000000XX--------XXXXXX
000000000000000000000000000000000000XX------------XX
000000000000000000000000000000000000XD------------XX
000000000000000000000000000000000000XD-------------X
000000000000000000000000000000000000TTTTXXXXXXXX--DX
000000000000000000000000000000000000--TTTTTTTT----DX
0000000000000000-----------------------------TTTTTTT
0000000000000000--------------------0000000000000000
0000000000000000--------------------0000000000000000
0000000000000000--------------------0000000000000000
0000000000000000--------------------0000000000000000
0000000000000000--------------------0000000000000000
0000000000000000--------------------0000000000000000
0000000000000000--------------SSSS--0000000000000000
0000000000000000--------------------0000000000000000
0000000000000000--------------------0000000000000000
0000000000000000--------------------0000000000000000
0000000000000000--------------------0000000000000000
0000000000000000-----E------------E-0000000000000000
0000000000000000----<>-----------<>-0000000000000000
0000000000000000----[]-----------[]-0000000000000000
----------------XXXXXXXXXXXXXXXXXXX-0000000000000000
-----X---X---X--000000000000000000000000000000000000
--X--X---X---X--000000000000000000000000000000000000
--X--X--X--X----000000000000000000000000000000000000
--X--X--X--X----000000000000000000000000000000000000
TTX--X--X--X----000000000000000000000000000000000000
----------------000000000000000000000000000000000000
----------------000000000000000000000000000000000000
----XXXX--------000000000000000000000000000000000000
XX--------------000000000000000000000000000000000000
XX--------------000000000000000000000000000000000000
XXXX--TTTT------000000000000000000000000000000000000
XXXX------------000000000000000000000000000000000000
XX-------------X000000000000000000000000000000000000
XX----------TTTT000000000000000000000000000000000000
XD-------------X000000000000000000000000000000000000
XD-------------X000000000000000000000000000000000000
TTTTXXXXXXXX--DX000000000000000000000000000000000000
--TTTTTTTT----DX000000000000000000000000000000000000
---------TTTTTTT000000000000000000000000000000000000
----------------000000000000000000000000000000000000
----------------000000000000000000000000000000000000
-----TTTTT------000000000000000000000000000000000000
----------------000000000000000000000000000000000000
----------------000000000000000000000000000000000000
---------TTTT---000000000000000000000000000000000000
----------------000000000000000000000000000000000000
XXXX--------TTTT000000000000000000000000000000000000
----------------000000000000000000000000000000000000
--TTTT----TTTT--000000000000000000000000000000000000
----------------000000000000000000000000000000000000
----------------000000000000000000000000000000000000
XX------TTTT--XX000000000000000000000000000000000000
XX------------XX000000000000000000000000000000000000
XX------------XX000000000000000000000000000000000000
XD------------XX000000000000000000000000000000000000
XD-------------X000000000000000000000000000000000000
TTTTXXXXXXXXXXXX000000000000000000000000000000000000
--TTTTTTTT----DX000000000000000000000000000000000000
---------TTTTTTT000000000000000000000000000000000000