0000000000000000000XXXX------XXXX--
0000000000000000000XXXX------XXXX--
0000000000000000000XXXX------XXXX--
0000000000000000000XXXX------XXXX--
0000000000000000000XXXX------XXXX--
0000000000000000000XXXX------XXXX--
0000000000000000000XXXX------XXXX--
0000000000000000000XXXX------XXXX--
0000000000000000000XXXX------XXXX--
0000000000000000000XXXX------XXXX--
0000000000000000000XXXX------XXXX--
0000000000000000000XXXX------XXXX--
0000000000000000000XXXX------XXXX--
0000000000000000000XXXX------XXXX--
0000000000000000000XXXX------XXXX--
0000000000000000000XXXX------XXXX--
0000000000000000000XXXX------XXXX--
0000000000000000000XXXX------XXXX--
0000000000000000000XXXX------XXXX--
0000000000000000000XXXX------XXXX--
0000000000000000000XXXX------XXXX--
0000000000000000000XXXX------XXXX--
0000000000000000000XXXX------XXXX--
0000000000000000000XXXX------XXXX--
0000000000000000000XXXX------XXXX--
0000000000000000000XXXX------XXXX--
0000000000000000000XXXX------XXXX--
0000000000000000000XXXX------XXXX--
0000000000000000000XXXX------XXXX--
0000000000000000000XXXX------XXXX--
0000000000000000000XXXX------XXXX--
0000000000000000000XXXX------XXXX--
0000000000000000000XXXX------XXXX--
0000000000000000000XXXX------XXXX--
0000000000000000000XXXX------XXXX--
0000000000000000000XXXX------XXXX--
0000000000000000000XXXX------XXXX--
0000000000000000000XXXX------XXXX--
0000000000000000000XXXX------XXXX--
0000000000000000000XXXX------XXXX--
0000000000000000000XXXX------XXXX--
0000000000000000000XXXX------XXXX--
0000000000000000000XXXX------XXXX--
0000000000000000000XXXX------XXXX--
0000000000000000000XXXX------XXXX--
0000000000000000000XXXX------XXXX--
0000000000000000000XXXX------XXXX--
0000000000000000000XXXX------XXXX--
0000000000000000000XXXX------XXXX--
0000000000000000000XXXX------XXXX--
0000000000000000000XXXX------XXXX--
0000000000000000000XXXX------XXXX--
0000000000000000000XXXX------XXXX--
0000000000000000000XXXX------XXXX--
0000000000000000000XXXX------XXXX--
0000000000000000000XXXX------XXXX--
0000000000000000000XXXX------XXXX--
0000000000000000000XXXX------XXXX--
0000000000000000000XXXX------XXXX--
0000000000000000000XXXX------XXXX--
0000000000000000000XXXX------XXXX--
0000000000000000000XXXX------XXXX--
0000000000000000000XXXX------XXXX--
0000000000000000000XXXX------XXXX--
0000000000000000000XXXX------XXXX--
0000000000000000000XXXX------XXXX--
0000000000000000000XXXX------XXXX--
0000000000000000000XXXX------XXXX--
0000000000000000000XXXX------XXXX--
0000000000000000000XXXX------XXXX--
0000000000000000000XXXX------XXXX--
0000000000000000000XXXX------XXXX--
0000000000000000000XXXX------XXXX--
0000000000000000000XXXX------XXXX--
0000000000000000000XXXX------XXXX--
0000000000000000000XXXX------XXXX--
0000000000000000000XXXX------XXXX--
0000000000000000000XXXX------XXXX--
0000000000000000000XXXX------XXXX--
0000000000000000000XXXX------XXXX--
0000000000000000000XXXX------XXXX--
0000000000000000000XXXX------XXXX--
0000000000000000000XXXX------XXXX--
0000000000000000000XXXX------XXXX--
0000000000000000000XXXX------XXXX--
0000000000000000000XXXX------XXXX--
0000000000000000000XXXX------XXXX--
0000000000000000000XXXX------XXXX--
0000000000000000000XXXX------XXXX--
0000000000000000000XXXX------XXXX--
0000000000000000000XXXX------XXXX--
0000000000000000000XXXX------XXXX--
0000000000000000000XXXX------XXXX--
0000000000000000000XXXX------XXXX--
0000000000000000000XXXX------XXXX--
0000000000000000000XXXX------XXXX--
0000000000000000000XXXX------XXXX--
0000000000000000000XXXX------XXXX--
0000000000000000000XXXX------XXXX--
0000000000000000000XXXX------XXXX--
0000000000000000000XXXX------XXXX--
0000000000000000000XXXX------XXXX--
0000000000000000000XXXX------XXXX--
0000000000000000000XXXX------XXXX--
0000000000000000000XXXX------XXXX--
0000000000000000000XXXX------XXXX--
0000000000000000000XXXX------XXXX--
0000000000000000000XXXX------XXXX--
0000000000000000000XXXX------XXXX--
0000000000000000000XXXX------XXXX--
0000000000000000000XXXX------XXXX--
0000000000000000000XXXX------XXXX--
0000000000000000000XXXX----EXXXXX--
0000000000000000000XXXX------XXXX--
0000000000000000000XXXX------XXXX--
0000000000000000000XXXX------XXXX--
0000000000000000000XXXX------XXXX--
0000000000000000000XXXX------XXXX--
0000000000000000000XXXX------XXXX--
0000000000000000000XXXX------XXXX--
0000000000000000000XXXX------XXXX--
0000000000000000000XXXX------XXXX--
0000000000000000000XXXX------XXXX--
0000000000000000000XXXX------XXXX--
0000000000000000000XXXX------XXXX--
0000000000000000000XXXX------XXXX--
0000000000000000000XXXX------XXXX--
0000000000000000000XXXX----EXXXXX--
0000000000000000000XXXX------XXXX--
0000000000000000000XXXX------XXXX--
0000000000000000000XXXX------XXXX--
0000000000000000000XXXX------XXXX--
0000000000000000000XXXX------XXXX--
0000000000000000---XXXX------XXXX--
0000000000000000---XXXX------XXXX--
0000000000000000---XXXX------XXXX--
0000000000000000---XXXX------XXXX--
0000000000000000---XXXX------XXXX--
0000000000000000---XXXX------XXXX--
0000000000000000---XXXX------XXXX--
0000000000000000-----------XXXX----
0000000000000000-----------XXXX----
0000000000000000-----------DXXX----
----XXXXX----------------XXXXXX----
----------------X------------------
XXXX----------XXX------XXXX--------
XXXX----------XXX------------------
X-------------DXXXXXXXX----------XX
X-------------DXXXX0000000000000000
X----XXXXXXXXXXX0000000000000000000
X---XXXX---XXXXX0000000000000000000
X----XXXXXXXX---0000000000000000000
XXXX------XXXX--0000000000000000000
XXXX-------XXXX-0000000000000000000
XXXX-----TTTTXXX0000000000000000000
XXXX--------XXXX0000000000000000000
XXXX--------XXXX0000000000000000000
XXXX--------XXXX0000000000000000000
XXXX--------XXXX0000000000000000000
XXXX--------XXXX0000000000000000000
XXXX--------XXXX0000000000000000000
XXXX--------XXXX0000000000000000000
XXXX--------XXXX0000000000000000000
XXXX--------XXXX0000000000000000000
XXXX--------XXXX0000000000000000000
XXXX--------XXXX0000000000000000000
XXXX--------XXXX0000000000000000000
XXXX--------DXXX0000000000000000000
XXXX--------DXXX0000000000000000000
XXXX----XXXXXXXX0000000000000000000
XXXX--------XXXX0000000000000000000
XXXX--------XXXX0000000000000000000
XXTTTT------XXXX0000000000000000000
XXXX--------XXXX0000000000000000000
XXXX--------XXXX0000000000000000000
XXXXXX------XXXX0000000000000000000
XXXX--------XXXX0000000000000000000
XXXX--------XXXX0000000000000000000
XX----TTTTTTTTXX0000000000000000000
XX------------XX0000000000000000000
XX------------XX0000000000000000000
XXXXXX----XXXXXX0000000000000000000
XX------------XX0000000000000000000
XX------------XX0000000000000000000
XXXX-----------X0000000000000000000
XXXX-----------X0000000000000000000
XXXX-----------X0000000000000000000
XX-------TTTT-TT0000000000000000000
XD-------------X0000000000000000000
XD-------------X0000000000000000000
XXXXX---XXXXXXXX0000000000000000000
XXXXXXXXXXXXXXXX0000000000000000000