000000000000000000000000000000000000000000000000000000000000000000000000000000000000000000000000000000000000----------TTT---
000000000000000000000000000000000000000000000000000000000000000000000000000000000000000000000000000000000000----------------
000000000000000000000000000000000000000000000000000000000000000000000000000000000000000000000000000000000000----------------
000000000000000000000000000000000000000000000000000000000000000000000000000000000000000000000000000000000000---------XXXXXXX
000000000000000000000000000000000000000000000000000000000000000000000000000000000000000000000000000000000000----------------
000000000000000000000000000000000000000000000000000000000000000000000000000000000000000000000000000000000000-------XXXX-----
000000000000000000000000000000000000000000000000000000000000000000000000000000000000000000000000000000000000------TTTT------
000000000000000000000000000000000000000000000000000000000000000000000000000000000000000000000000000000000000---------------X
000000000000000000000000000000000000000000000000000000000000000000000000000000000000000000000000000000000000---------------X
000000000000000000000000000000000000000000000000000000000000000000000000000000000000000000000000000000000000------XXXX-----X
000000000000000000000000000000000000000000000000000000000000000000000000000000000000000000000000000000000000---XX-----------
000000000000000000000000000000000000000000000000000000000000000000000000000000000000000000000000000000000000---XX-----------
000000000000000000000000000000000000000000000000000000000000000000000000000000000000000000000000000000000000XXXXXXXX------XX
000000000000000000000000000000000000000000000000000000000000000000000000000000000000000000000000000000000000XXXX----------DX
000000000000000000000000000000000000000000000000000000000000000000000000000000000000000000000000000000000000XXXX----------DX
000000000000000000000000000000000000000000000000000000000000000000000000000000000000000000000000000000000000XXXX--------DXXX
000000000000000000000000000000000000000000000000000000000000000000000000000000000000000000000000000000000000XX----TTTTTTTTTT
000000000000000000000000000000000000000000000000000000000000000000000000000000000000000000000000000000000000XD-------------X
000000000000000000000000000000000000000000000000000000000000000000000000000000000000000000000000000000000000XD-------------X
0000000000000000000000000000000000000000000000000000000000000000000000000000000000000000--------------------XXXXXXXXXXX-----
0000000000000000000000000000000000000000000000000000000000000000000000000000000000000000--------------------0000000000000000
0000000000000000000000000000000000000000000000000000000000000000000000000000000000000000--------------------0000000000000000
0000000000000000000000000000000000000000000000000000000000000000000000000000000000000000--------------------0000000000000000
0000000000000000000000000000000000000000000000000000000000000000000000000000000000000000--------------------0000000000000000
0000000000000000000000000000000000000000000000000000000000000000000000000000000000000000--------------------0000000000000000
0000000000000000000000000000000000000000000000000000000000000000000000000000000000000000--------------------0000000000000000
0000000000000000000000000000000000000000000000000000000000000000000000000000000000000000--------------------0000000000000000
0000000000000000000000000000000000000000000000000000000000000000000000000000000000000000--------------E-----0000000000000000
0000000000000000000000000000000000000000000000000000000000000000000000000000000000000000--------------------0000000000000000
0000000000000000000000000000000000000000000000000000000000000000000000000000000000000000--------------------0000000000000000
0000000000000000000000000000000000000000000000000000000000000000000000000000000000000000--------------------0000000000000000
0000000000000000000000000000000000000000000000000000000000000000000000000000000000000000--------------------0000000000000000
0000000000000000000000000000000000000000000000000000000000000000000000000000000000000000---------------X----0000000000000000
000000000000000000000000000000000000000000000000000000000000000000000000------------------E-----------X-----0000000000000000
000000000000000000000000000000000000000000000000000000000000000000000000----------------XXXXXXXXX-----------0000000000000000
000000000000000000000000000000000000000000000000000000000000000000000000----------T-----000000000000000000000000000000000000
000000000000000000000000000000000000000000000000000000000000000000000000----------------000000000000000000000000000000000000
000000000000000000000000000000000000000000000000000000000000000000000000----------------000000000000000000000000000000000000
000000000000000000000000000000000000000000000000000000000000000000000000XMMMMMMMMMMMMMMM000000000000000000000000000000000000
000000000000000000000000000000000000000000000000000000000000000000000000----------------000000000000000000000000000000000000
000000000000000000000000000000000000000000000000000000000000000000000000----E--------E--000000000000000000000000000000000000
000000000000000000000000000000000000000000000000000000000000000000000000MMMMMMMMMMMMMMMM000000000000000000000000000000000000
000000000000000000000000000000000000000000000000000000000000000000000000----------------000000000000000000000000000000000000
000000000000000000000000000000000000000000000000000000000000000000000000----------------000000000000000000000000000000000000
000000000000000000000000000000000000000000000000000000000000000000000000XXXX------------000000000000000000000000000000000000
000000000000000000000000000000000000000000000000000000000000000000000000XXXX------------000000000000000000000000000000000000
000000000000000000000000000000000000000000000000000000000000000000000000XXXX--TTTT------000000000000000000000000000000000000
000000000000000000000000000000000000000000000000000000000000000000000000XXXX------------000000000000000000000000000000000000
000000000000000000000000000000000000000000000000000000000000000000000000XX-------------X000000000000000000000000000000000000
000000000000000000000000000000000000000000000000000000000000000000000000XX----------TTTT000000000000000000000000000000000000
000000000000000000000000000000000000000000000000000000000000000000000000XD-------------X000000000000000000000000000000000000
000000000000000000000000000000000000000000000000000000000000000000000000XD-------------X000000000000000000000000000000000000
000000000000000000000000000000000000000000000000000000000000000000000000XXXXXXXXXXX-----000000000000000000000000000000000000
000000000000000000000000000000000000000000000000000000000000000000000000----------------000000000000000000000000000000000000
000000000000000000000000000000000000000000000000000000000000000000000000------XXXX------000000000000000000000000000000000000
000000000000000000000000000000000000000000000000000000000000000000000000----------------000000000000000000000000000000000000
000000000000000000000000000000000000000000000000000000000000000000000000---TTTT---------000000000000000000000000000000000000
000000000000000000000000000000000000000000000000000000000000000000000000----------------000000000000000000000000000000000000
000000000000000000000000000000000000000000000000000000000000000000000000----------------000000000000000000000000000000000000
000000000000000000000000000000000000000000000000000000000000000000000000XX-----TTTT---XX000000000000000000000000000000000000
000000000000000000000000000000000000000000000000000000000000000000000000XX------------XX000000000000000000000000000000000000
000000000000000000000000000000000000000000000000000000000000000000000000XX------------XX000000000000000000000000000000000000
000000000000000000000000000000000000000000000000000000000000000000000000XXXX--------XXXX000000000000000000000000000000000000
000000000000000000000000000000000000000000000000000000000000000000000000XXXX--------XXXX000000000000000000000000000000000000
000000000000000000000000000000000000000000000000000000000000000000000000XXXX--------XXXX000000000000000000000000000000000000
000000000000000000000000000000000000000000000000000000000000000000000000XXXX--------XXXX000000000000000000000000000000000000
000000000000000000000000000000000000000000000000000000000000000000000000XX----TTTT---XXX000000000000000000000000000000000000
000000000000000000000000000000000000000000000000000000000000000000000000XX-----------XXX000000000000000000000000000000000000
000000000000000000000000000000000000000000000000000000000000000000000000XX-----------XXX000000000000000000000000000000000000
000000000000000000000000000000000000000000000000000000000000000000000000XX----------TTTT000000000000000000000000000000000000
000000000000000000000000000000000000000000000000000000000000000000000000XD-------------X000000000000000000000000000000000000
000000000000000000000000000000000000000000000000000000000000000000000000XD-------------X000000000000000000000000000000000000
000000000000000000000000000000000000000000000000000000000000000000000000XXXXXXXXXXX-----000000000000000000000000000000000000
000000000000000000000000000000000000000000000000000000000000000000000000----------------000000000000000000000000000000000000
000000000000000000000000000000000000000000000000000000000000000000000000-XXXX--------XXX000000000000000000000000000000000000
000000000000000000000000000000000000000000000000000000000000000000000000------------XXXX000000000000000000000000000000000000
000000000000000000000000000000000000000000000000000000000000000000000000----------------000000000000000000000000000000000000
000000000000000000000000000000000000000000000000000000000000000000000000--------TTT-----000000000000000000000000000000000000
000000000000000000000000000000000000000000000000000000000000000000000000----------------000000000000000000000000000000000000
000000000000000000000000000000000000000000000000000000000000000000000000----------------000000000000000000000000000000000000
000000000000000000000000000000000000000000000000000000000000000000000000XXXXXXXXXXXXXXXX000000000000000000000000000000000000
000000000000000000000000000000000000000000000000000000000000000000000000XXXX------------000000000000000000000000000000000000
000000000000000000000000000000000000000000000000000000000000000000000000XXXX------------000000000000000000000000000000000000
000000000000000000000000000000000000000000000000000000000000000000000000XXXXXXXXXXX-----000000000000000000000000000000000000
000000000000000000000000000000000000000000000000000000000000000000000000XXXX------------000000000000000000000000000000000000
000000000000000000000000000000000000000000000000000000000000000000000000XX--------------000000000000000000000000000000000000
000000000000000000000000000000000000000000000000000000000000000000000000XX--------------000000000000000000000000000000000000
000000000000000000000000000000000000000000000000000000000000000000000000XXXXXXXXX-------000000000000000000000000000000000000
000000000000000000000000000000000000000000000000000000000000000000000000XX-------------X000000000000000000000000000000000000
000000000000000000000000000000000000000000000000000000000000000000000000XX----------TTTT000000000000000000000000000000000000
000000000000000000000000000000000000000000000000000000000000000000000000XD-------------X000000000000000000000000000000000000
000000000000000000000000000000000000000000000000000000000000000000000000XD-------------X000000000000000000000000000000000000
000000000000000000000000000000000000000000000000000000000000000000000000XXXXXXXXXXX-----000000000000000000000000000000000000
000000000000000000000000000000000000000000000000000000000000000000000000--------------X-000000000000000000000000000000000000
000000000000000000000000000000000000000000000000000000000000000000000000----------------000000000000000000000000000000000000
000000000000000000000000000000000000000000000000000000000000000000000000----------------000000000000000000000000000000000000
000000000000000000000000000000000000000000000000000000000000000000000000----TTTT--------000000000000000000000000000000000000
000000000000000000000000000000000000000000000000000000000000000000000000----------TTT---000000000000000000000000000000000000
000000000000000000000000000000000000000000000000000000000000000000000000----------------000000000000000000000000000000000000
000000000000000000000000000000000000000000000000000000000000000000000000----------------000000000000000000000000000000000000
0000000000000000000000000000000000000000000000000000--------------------XX------TTTTTTXX000000000000000000000000000000000000
0000000000000000000000000000000000000000000000000000--------------------XX------------XX000000000000000000000000000000000000
0000000000000000000000000000000000000000000000000000--------------------XX------------XX000000000000000000000000000000000000
0000000000000000000000000000000000000000000000000000--------------------XXXX--------XXXX000000000000000000000000000000000000
0000000000000000000000000000000000000000000000000000--------------------XXXX--------XXXX000000000000000000000000000000000000
0000000000000000000000000000000000000000000000000000--------------------XXXX--------XXXX000000000000000000000000000000000000
0000000000000000000000000000000000000000000000000000--------------------XX----TTTTTTTTXX000000000000000000000000000000000000
0000000000000000000000000000000000000000000000000000--------------------XX------------XX000000000000000000000000000000000000
0000000000000000000000000000000000000000000000000000--------------------XX------------XX000000000000000000000000000000000000
0000000000000000000000000000000000000000000000000000--------------------XXXX----------XX000000000000000000000000000000000000
0000000000000000000000000000000000000000000000000000-----------------E--XD-------------X000000000000000000000000000000000000
0000000000000000000000000000000000000000000000000000----------S----XS---XD-------------X000000000000000000000000000000000000
0000000000000000000000000000000000000000000000000000---------------X---oXXXXXXXXXXX-----000000000000000000000000000000000000
000000000000000000000000000000000000-XXXXXX-XX---------------------X----0000000000000000000000000000000000000000000000000000
000000000000000000000000000000000000-------------------------------X----0000000000000000000000000000000000000000000000000000
000000000000000000000000000000000000----------------XXXXXXXXXXXXXXXXXXX-0000000000000000000000000000000000000000000000000000
000000000000000000000000000000000000--------TTTT----000000000000000000000000000000000000000000000000000000000000000000000000
000000000000000000000000000000000000----------------000000000000000000000000000000000000000000000000000000000000000000000000
000000000000000000000000000000000000--TTTTTTTT------000000000000000000000000000000000000000000000000000000000000000000000000
000000000000000000000000000000000000----------------000000000000000000000000000000000000000000000000000000000000000000000000
000000000000000000000000000000000000----------------000000000000000000000000000000000000000000000000000000000000000000000000
000000000000000000000000000000000000-----T----------000000000000000000000000000000000000000000000000000000000000000000000000
000000000000000000000000000000000000----------------000000000000000000000000000000000000000000000000000000000000000000000000
000000000000000000000000000000000000----------------000000000000000000000000000000000000000000000000000000000000000000000000
000000000000000000000000000000000000XXXX------------000000000000000000000000000000000000000000000000000000000000000000000000
000000000000000000000000000000000000XXXX------------000000000000000000000000000000000000000000000000000000000000000000000000
000000000000000000000000000000000000XXXX--TTTT------000000000000000000000000000000000000000000000000000000000000000000000000
000000000000000000000000000000000000XXXX------------000000000000000000000000000000000000000000000000000000000000000000000000
000000000000000000000000000000000000XX-------------X000000000000000000000000000000000000000000000000000000000000000000000000
000000000000000000000000000000000000XX----------TTTT000000000000000000000000000000000000000000000000000000000000000000000000
000000000000000000000000000000000000XD-------------X000000000000000000000000000000000000000000000000000000000000000000000000
000000000000000000000000000000000000XD-------------X000000000000000000000000000000000000000000000000000000000000000000000000
0000000000000000--------------------XXXXXXXXXXX-----000000000000000000000000000000000000000000000000000000000000000000000000
0000000000000000--------------------0000000000000000000000000000000000000000000000000000000000000000000000000000000000000000
0000000000000000--------------------0000000000000000000000000000000000000000000000000000000000000000000000000000000000000000
0000000000000000--------------------0000000000000000000000000000000000000000000000000000000000000000000000000000000000000000
0000000000000000--------------------0000000000000000000000000000000000000000000000000000000000000000000000000000000000000000
0000000000000000--------------------0000000000000000000000000000000000000000000000000000000000000000000000000000000000000000
0000000000000000--------------------0000000000000000000000000000000000000000000000000000000000000000000000000000000000000000
0000000000000000--------------------0000000000000000000000000000000000000000000000000000000000000000000000000000000000000000
0000000000000000--------------------0000000000000000000000000000000000000000000000000000000000000000000000000000000000000000
0000000000000000--------------------0000000000000000000000000000000000000000000000000000000000000000000000000000000000000000
0000000000000000--------------------0000000000000000000000000000000000000000000000000000000000000000000000000000000000000000
0000000000000000--------------------0000000000000000000000000000000000000000000000000000000000000000000000000000000000000000
0000000000000000---E----------------0000000000000000000000000000000000000000000000000000000000000000000000000000000000000000
0000000000000000--<>----------------0000000000000000000000000000000000000000000000000000000000000000000000000000000000000000
0000000000000000--[]----------------0000000000000000000000000000000000000000000000000000000000000000000000000000000000000000
-------------XX-XXXXXXXXXXXXXXXXXXX-0000000000000000000000000000000000000000000000000000000000000000000000000000000000000000
------------XX--000000000000000000000000000000000000000000000000000000000000000000000000000000000000000000000000000000000000
----------XXXX--000000000000000000000000000000000000000000000000000000000000000000000000000000000000000000000000000000000000
----------------000000000000000000000000000000000000000000000000000000000000000000000000000000000000000000000000000000000000
----------------000000000000000000000000000000000000000000000000000000000000000000000000000000000000000000000000000000000000
MMMMMMMMMMMMMMMM000000000000000000000000000000000000000000000000000000000000000000000000000000000000000000000000000000000000
----------------000000000000000000000000000000000000000000000000000000000000000000000000000000000000000000000000000000000000
-X--------------000000000000000000000000000000000000000000000000000000000000000000000000000000000000000000000000000000000000
XX----------XXXX000000000000000000000000000000000000000000000000000000000000000000000000000000000000000000000000000000000000
XX--------------000000000000000000000000000000000000000000000000000000000000000000000000000000000000000000000000000000000000
XX--------------000000000000000000000000000000000000000000000000000000000000000000000000000000000000000000000000000000000000
XXXXMMMMMMMMMMMM000000000000000000000000000000000000000000000000000000000000000000000000000000000000000000000000000000000000
XXXX------------000000000000000000000000000000000000000000000000000000000000000000000000000000000000000000000000000000000000
XXXX------------000000000000000000000000000000000000000000000000000000000000000000000000000000000000000000000000000000000000
XXXX------------000000000000000000000000000000000000000000000000000000000000000000000000000000000000000000000000000000000000
XX-------------X000000000000000000000000000000000000000000000000000000000000000000000000000000000000000000000000000000000000
XX----------TTTT000000000000000000000000000000000000000000000000000000000000000000000000000000000000000000000000000000000000
XD-------------X000000000000000000000000000000000000000000000000000000000000000000000000000000000000000000000000000000000000
XD-------------X000000000000000000000000000000000000000000000000000000000000000000000000000000000000000000000000000000000000
XXXXXXXXXXX-----000000000000000000000000000000000000000000000000000000000000000000000000000000000000000000000000000000000000