000000000000000000000000000000000000000000000000000000000000000000000000000000000000000000000000000000000000-----X----------
000000000000000000000000000000000000000000000000000000000000000000000000000000000000000000000000000000000000--X--X----------
000000000000000000000000000000000000000000000000000000000000000000000000000000000000000000000000000000000000-----X---X------
000000000000000000000000000000000000000000000000000000000000000000000000000000000000000000000000000000000000--X--X---XX-----
000000000000000000000000000000000000000000000000000000000000000000000000000000000000000000000000000000000000--X--X----------
0000000000000000000000000000000000000000000000000000000000000000000000000000000000000000----------------------XX-X---X------
0000000000000000000000000000000000000000000000000000000000000000000000000000000000000000----------------------X--X--X--X----
0000000000000000000000000000000000000000000000000000000000000000000000000000000000000000----------------------X--X--X--X----
0000000000000000000000000000000000000000000000000000000000000000000000000000000000000000--------------------TTX--X--X--X----
000000000000000000000000000000000000000000000000000000000000000000000000----------------S-----------------------------------
000000000000000000000000000000000000000000000000000000000000000000000000---------TTTT---S-----------------------------------
000000000000000000000000000000000000000000000000000000000000000000000000X-----------TTTTS--E--------------------XXXX--------
000000000000000000000000000000000000000000000000000000000000000000000000X--------------XS-------------------XXXX----XXXXXXXX
0000000000000000000000000000000000000000000000000000--------------------X-----------D--XS-------------------XXXX--------XXXX
0000000000000000000000000000000000000000000000000000--------------------X----------DX--XS-------------------XX-----------XXX
0000000000000000000000000000000000000000000000000000--------------------X------XXXXXXXXXS-------------------XX----XXXXXXXXXX
0000000000000000000000000000000000000000000000000000--------------------X--------------XS--------------E----XD-----------TXX
000000000000000000000000000000000000----------------S-------------------X--------------XS--------------E----XD------------XX
000000000000000000000000000000000000---XXXX---------S-----------------------------------S-------------------XXXXX-------XXXX
000000000000000000000000000000000000----------------S-------------------XMMMMMMMMMMMMMMXS--------------E-E-EXXXXXXXXXXXXXXXX
000000000000000000000000000000000000----------------S----------XXX------X--------------XXXXXXXXXXXXXXXXXXXXX0000000000000000
000000000000000000000000000000000000------TTTT------S---------XXXX------X--------------X000000000000000000000000000000000000
000000000000000000000000000000000000----------------S--------XXXXX------XXXXXXXX-------X000000000000000000000000000000000000
000000000000000000000000000000000000----------------S-------XXXXXX------XX-------------X000000000000000000000000000000000000
000000000000000000000000000000000000------TTTT------S-------XXXXXX------XX--------TTTTTT000000000000000000000000000000000000
000000000000000000000000000000000000----------------S-----XXXXXXXX------XD-------------X000000000000000000000000000000000000
000000000000000000000000000000000000---------XXXX---S----XXXXXXXXX------XD-------------X000000000000000000000000000000000000
000000000000000000000000000000000000----------------S--XXXXXXXXXXX------XXXXX-------XXXX000000000000000000000000000000000000
000000000000000000000000000000000000-XXXX-------XXXXXXXXXXXXXXXXXXXXXXXXXXXXXXXXXXXXXXXX000000000000000000000000000000000000
000000000000000000000000000000000000------------XXX-000000000000000000000000000000000000000000000000000000000000000000000000
000000000000000000000000000000000000----------------000000000000000000000000000000000000000000000000000000000000000000000000
000000000000000000000000000000000000XX-----------XXX000000000000000000000000000000000000000000000000000000000000000000000000
000000000000000000000000000000000000XX----XXXXXXXXXX000000000000000000000000000000000000000000000000000000000000000000000000
000000000000000000000000000000000000XD------------XX000000000000000000000000000000000000000000000000000000000000000000000000
000000000000000000000000000000000000XD------------XX000000000000000000000000000000000000000000000000000000000000000000000000
000000000000000000000000000000000000XXXXX-------XXXX000000000000000000000000000000000000000000000000000000000000000000000000
000000000000000000000000000000000000XXXXXXXXXXXXXXXX000000000000000000000000000000000000000000000000000000000000000000000000
000000000000000000000000000000000000XXXX--------XXXX000000000000000000000000000000000000000000000000000000000000000000000000
000000000000000000000000000000000000XX------------XX000000000000000000000000000000000000000000000000000000000000000000000000
000000000000000000000000000000000000XX-----XXXX---DX000000000000000000000000000000000000000000000000000000000000000000000000
000000000000000000000000000000000000XX------------DX000000000000000000000000000000000000000000000000000000000000000000000000
000000000000000000000000000000000000XXXX--------XXXX000000000000000000000000000000000000000000000000000000000000000000000000
0000000000000000--------------------XXXXXX------XXXX000000000000000000000000000000000000000000000000000000000000000000000000
0000000000000000--------------------XXXX--------XXXX000000000000000000000000000000000000000000000000000000000000000000000000
-----TT--TT-------------------------XXXX--------XXXX000000000000000000000000000000000000000000000000000000000000000000000000
------------------------------------XX----TTTTTTTTXX000000000000000000000000000000000000000000000000000000000000000000000000
----------------S-------------------XX------------XX000000000000000000000000000000000000000000000000000000000000000000000000
--------TTTT----S-------------------XX------------XX000000000000000000000000000000000000000000000000000000000000000000000000
----------------S-------------------XXXXXXXX------XX000000000000000000000000000000000000000000000000000000000000000000000000
--TTTTTTTT------S-------------------XXXXXXXXXX----XX000000000000000000000000000000000000000000000000000000000000000000000000
----------------S-------------------XX------------XX000000000000000000000000000000000000000000000000000000000000000000000000
----------------S-------------------XX------------XX000000000000000000000000000000000000000000000000000000000000000000000000
XXXXXX------XXXXS-------------------XX----XXXXXXXXXX000000000000000000000000000000000000000000000000000000000000000000000000
XXXX--------XXXXS-----EX------------XD------------XX000000000000000000000000000000000000000000000000000000000000000000000000
XXXX--------XXXXS-------------------XD------------XX000000000000000000000000000000000000000000000000000000000000000000000000
XX----TTTTTTTTXXS-------------------XXXXX-------XXXX000000000000000000000000000000000000000000000000000000000000000000000000
XX------------XXS---------XX-------EXXXXXXXXXXXXXXXX000000000000000000000000000000000000000000000000000000000000000000000000
XX------------XXXXXXXXXXXXXXXXXXXXXX0000000000000000000000000000000000000000000000000000000000000000000000000000000000000000
XXXXXXXX------XX000000000000000000000000000000000000000000000000000000000000000000000000000000000000000000000000000000000000
XX----XXXXX---XX000000000000000000000000000000000000000000000000000000000000000000000000000000000000000000000000000000000000
XD------------XX000000000000000000000000000000000000000000000000000000000000000000000000000000000000000000000000000000000000
XD------------XX000000000000000000000000000000000000000000000000000000000000000000000000000000000000000000000000000000000000
XXXXX-------XXXX000000000000000000000000000000000000000000000000000000000000000000000000000000000000000000000000000000000000
XXXXXXXXXXXXXXXX000000000000000000000000000000000000000000000000000000000000000000000000000000000000000000000000000000000000
----------------000000000000000000000000000000000000000000000000000000000000000000000000000000000000000000000000000000000000
----------------000000000000000000000000000000000000000000000000000000000000000000000000000000000000000000000000000000000000
-----TTTTTTT----000000000000000000000000000000000000000000000000000000000000000000000000000000000000000000000000000000000000
----------------000000000000000000000000000000000000000000000000000000000000000000000000000000000000000000000000000000000000
----------------000000000000000000000000000000000000000000000000000000000000000000000000000000000000000000000000000000000000
---------TTT----000000000000000000000000000000000000000000000000000000000000000000000000000000000000000000000000000000000000
----------------000000000000000000000000000000000000000000000000000000000000000000000000000000000000000000000000000000000000
X-----------TTTT000000000000000000000000000000000000000000000000000000000000000000000000000000000000000000000000000000000000
X--------------X000000000000000000000000000000000000000000000000000000000000000000000000000000000000000000000000000000000000
X--------------X000000000000000000000000000000000000000000000000000000000000000000000000000000000000000000000000000000000000
XXXXXXXXX------X000000000000000000000000000000000000000000000000000000000000000000000000000000000000000000000000000000000000
XX-------------X000000000000000000000000000000000000000000000000000000000000000000000000000000000000000000000000000000000000
XX--------TTTTTT000000000000000000000000000000000000000000000000000000000000000000000000000000000000000000000000000000000000
XX-------------X000000000000000000000000000000000000000000000000000000000000000000000000000000000000000000000000000000000000
XX-------------X000000000000000000000000000000000000000000000000000000000000000000000000000000000000000000000000000000000000
XX----XXXXXXXX-X000000000000000000000000000000000000000000000000000000000000000000000000000000000000000000000000000000000000
XD-------------X000000000000000000000000000000000000000000000000000000000000000000000000000000000000000000000000000000000000
XD------------DX000000000000000000000000000000000000000000000000000000000000000000000000000000000000000000000000000000000000
XXXXX-------XXXX000000000000000000000000000000000000000000000000000000000000000000000000000000000000000000000000000000000000
XXXXXXXXXXXXXXXX000000000000000000000000000000000000000000000000000000000000000000000000000000000000000000000000000000000000
----------------000000000000000000000000000000000000000000000000000000000000000000000000000000000000000000000000000000000000
------TTTT------000000000000000000000000000000000000000000000000000000000000000000000000000000000000000000000000000000000000
----------------000000000000000000000000000000000000000000000000000000000000000000000000000000000000000000000000000000000000
------------XX--000000000000000000000000000000000000000000000000000000000000000000000000000000000000000000000000000000000000
----XXXX---XXXX-000000000000000000000000000000000000000000000000000000000000000000000000000000000000000000000000000000000000
XXXX------XXXX--000000000000000000000000000000000000000000000000000000000000000000000000000000000000000000000000000000000000
XXXX-----TTTTTTT000000000000000000000000000000000000000000000000000000000000000000000000000000000000000000000000000000000000
XXXX--------XXXX000000000000000000000000000000000000000000000000000000000000000000000000000000000000000000000000000000000000
XXXX--------XXXX000000000000000000000000000000000000000000000000000000000000000000000000000000000000000000000000000000000000
XTTTTTTTT---XXXX000000000000000000000000000000000000000000000000000000000000000000000000000000000000000000000000000000000000
XXXX--------XXXX000000000000000000000000000000000000000000000000000000000000000000000000000000000000000000000000000000000000
XXXX--------XXXX000000000000000000000000000000000000000000000000000000000000000000000000000000000000000000000000000000000000
XXXX-----TTTT---000000000000000000000000000000000000000000000000000000000000000000000000000000000000000000000000000000000000
XXXX--------XXXX000000000000000000000000000000000000000000000000000000000000000000000000000000000000000000000000000000000000
XX------------XX000000000000000000000000000000000000000000000000000000000000000000000000000000000000000000000000000000000000
XX----XXXXX---XX000000000000000000000000000000000000000000000000000000000000000000000000000000000000000000000000000000000000
XD------------XX000000000000000000000000000000000000000000000000000000000000000000000000000000000000000000000000000000000000
XD------------XX000000000000000000000000000000000000000000000000000000000000000000000000000000000000000000000000000000000000
XXXXX-------XXXX000000000000000000000000000000000000000000000000000000000000000000000000000000000000000000000000000000000000
XXXXXXXXXXXXXXXX000000000000000000000000000000000000000000000000000000000000000000000000000000000000000000000000000000000000