000000000000000000000000000000000000000000000000000000000000000000000000000000000000000000000000000XXXX------XXXX--
000000000000000000000000000000000000000000000000000000000000000000000000000000000000000000000000000XXXX------XXXX--
000000000000000000000000000000000000000000000000000000000000000000000000000000000000000000000000000XXXX------XXXX--
000000000000000000000000000000000000000000000000000000000000000000000000000000000000000000000000000XXXX------XXXX--
000000000000000000000000000000000000000000000000000000000000000000000000000000000000000000000000000XXXX------XXXX--
000000000000000000000000000000000000000000000000000000000000000000000000000000000000000000000000000XXXX------XXXX--
000000000000000000000000000000000000000000000000000000000000000000000000000000000000000000000000000XXXX------XXXX--
000000000000000000000000000000000000000000000000000000000000000000000000000000000000000000000000000XXXX------XXXX--
000000000000000000000000000000000000000000000000000000000000000000000000000000000000000000000000000XXXX------XXXX--
000000000000000000000000000000000000000000000000000000000000000000000000000000000000000000000000000XXXX------XXXX--
000000000000000000000000000000000000000000000000000000000000000000000000000000000000000000000000000XXXX------XXXX--
000000000000000000000000000000000000000000000000000000000000000000000000000000000000000000000000000XXXX------XXXX--
000000000000000000000000000000000000000000000000000000000000000000000000000000000000000000000000000XXXX------XXXX--
000000000000000000000000000000000000000000000000000000000000000000000000000000000000000000000000000XXXX------XXXX--
000000000000000000000000000000000000000000000000000000000000000000000000000000000000000000000000000XXXX------XXXX--
000000000000000000000000000000000000000000000000000000000000000000000000000000000000000000000000000XXXX------XXXX--
000000000000000000000000000000000000000000000000000000000000000000000000000000000000000000000000000XXXX------XXXX--
000000000000000000000000000000000000000000000000000000000000000000000000000000000000000000000000000XXXX------XXXX--
000000000000000000000000000000000000000000000000000000000000000000000000000000000000000000000000000XXXX------XXXX--
000000000000000000000000000000000000000000000000000000000000000000000000000000000000000000000000000XXXX------XXXX--
000000000000000000000000000000000000000000000000000000000000000000000000000000000000000000000000000XXXX------XXXX--
000000000000000000000000000000000000000000000000000000000000000000000000000000000000000000000000000XXXX------XXXX--
000000000000000000000000000000000000000000000000000000000000000000000000000000000000000000000000000XXXX------XXXX--
000000000000000000000000000000000000000000000000000000000000000000000000000000000000000000000000000XXXX------XXXX--
000000000000000000000000000000000000000000000000000000000000000000000000000000000000000000000000000XXXX------XXXX--
000000000000000000000000000000000000000000000000000000000000000000000000000000000000000000000000000XXXX------XXXX--
000000000000000000000000000000000000000000000000000000000000000000000000000000000000000000000000000XXXX------XXXX--
000000000000000000000000000000000000000000000000000000000000000000000000000000000000000000000000000XXXX------XXXX--
000000000000000000000000000000000000000000000000000000000000000000000000000000000000000000000000000XXXX------XXXX--
000000000000000000000000000000000000000000000000000000000000000000000000000000000000000000000000000XXXX--------XXXX
000000000000000000000000000000000000000000000000000000000000000000000000000000000000000000000000000XXXX--------XXXX
000000000000000000000000000000000000000000000000000000000000000000000000000000000000000000000000000XXXX--------XXXX
000000000000000000000000000000000000000000000000000000000000000000000000000000000000000000000000000XXXX--------XXXX
000000000000000000000000000000000000000000000000000000000000000000000000000000000000000000000000000XXXX--------XXXX
000000000000000000000000000000000000000000000000000000000000000000000000000000000000000000000000000XXXX--------XXXX
000000000000000000000000000000000000000000000000000000000000000000000000000000000000000000000000000XXXX--------XXXX
000000000000000000000000000000000000000000000000000000000000000000000000000000000000000000000000000XXXX--------XXXX
000000000000000000000000000000000000000000000000000000000000000000000000000000000000000000000000000XXXX--------XXXX
000000000000000000000000000000000000000000000000000000000000000000000000000000000000000000000000000XXXX--------XXXX
000000000000000000000000000000000000000000000000000000000000000000000000000000000000000000000000000XXXX--------XXXX
000000000000000000000000000000000000000000000000000000000000000000000000000000000000000000000000000XXXX--------XXXX
000000000000000000000000000000000000000000000000000000000000000000000000000000000000000000000000000XXXX--XXXXXXXXXX
000000000000000000000000000000000000000000000000000000000000000000000000000000000000000000000000000XXXX--------XXXX
000000000000000000000000000000000000000000000000000000000000000000000000000000000000000000000000000XXXX--------XXXX
000000000000000000000000000000000000000000000000000000000000000000000000000000000000000000000000000XXXX--------XXXX
000000000000000000000000000000000000000000000000000000000000000000000000000000000000000000000000000XXXX--------XXXX
000000000000000000000000000000000000000000000000000000000000000000000000000000000000000000000000000XXXX--------XXXX
000000000000000000000000000000000000000000000000000000000000000000000000000000000000000000000000000XXXX--------XXXX
000000000000000000000000000000000000000000000000000000000000000000000000000000000000000000000000000XXXX--------XXXX
000000000000000000000000000000000000000000000000000000000000000000000000000000000000000000000000000XXXX--------XXXX
000000000000000000000000000000000000000000000000000000000000000000000000000000000000000000000000000XXXX--------XXXX
000000000000000000000000000000000000000000000000000000000000000000000000000000000000000000000000000XXXX--------XXXX
000000000000000000000000000000000000000000000000000000000000000000000000000000000000000000000000000XXXX--------XXXX
000000000000000000000000000000000000000000000000000000000000000000000000000000000000000000000000000XXXX--------XXXX
000000000000000000000000000000000000000000000000000000000000000000000000000000000000000000000000000XXXX--------XXXX
000000000000000000000000000000000000000000000000000000000000000000000000000000000000000000000000000XXXX--------XXXX
000000000000000000000000000000000000000000000000000000000000000000000000000000000000000000000000000XXXX--------XXXX
000000000000000000000000000000000000000000000000000000000000000000000000000000000000000000000000000XXXX--------XXXX
000000000000000000000000000000000000000000000000000000000000000000000000000000000000000000000000000XXXXXX------XXXX
000000000000000000000000000000000000000000000000000000000000000000000000000000000000000000000000000XXXX--------XXXX
000000000000000000000000000000000000000000000000000000000000000000000000000000000000000000000000000XXXX--------XXXX
000000000000000000000000000000000000000000000000000000000000000000000000000000000000000000000000000XX----TTTTTTTTXX
000000000000000000000000000000000000000000000000000000000000000000000000000000000000000000000000000XX------------XX
000000000000000000000000000000000000000000000000000000000000000000000000000000000000000000000000000XX------------XX
000000000000000000000000000000000000000000000000000000000000000000000000000000000000000000000000000XXXXXXXX------XX
000000000000000000000000000000000000000000000000000000000000000000000000000000000000000000000000000XX-----TTTT---XX
000000000000000000000000000000000000000000000000000000000000000000000000000000000000000000000000000XX------------XX
000000000000000000000000000000000000000000000000000000000000000000000000000000000000000000000000000XXXX--------XXXX
000000000000000000000000000000000000000000000000000000000000000000000000000000000000000000000000000XXXX--------XXXX
000000000000000000000000000000000000000000000000000000000000000000000000000000000000000000000000000XXXX--------XXXX
000000000000000000000000000000000000000000000000000000000000000000000000000000000000000000000000000XXXX--------XXXX
000000000000000000000000000000000000000000000000000000000000000000000000000000000000000000000000000XXXX--------XXXX
000000000000000000000000000000000000000000000000000000000000000000000000000000000000000000000000000XXXX--------XXXX
000000000000000000000000000000000000000000000000000000000000000000000000000000000000000000000000000XXXX--------XXXX
000000000000000000000000000000000000000000000000000000000000000000000000000000000000000000000000000XXXX--------XXXX
000000000000000000000000000000000000000000000000000000000000000000000000000000000000000000000000000XXXXXXX-----XXXX
000000000000000000000000000000000000000000000000000000000000000000000000000000000000000000000000000XXXX--------XXXX
000000000000000000000000000000000000000000000000000000000000000000000000000000000000000000000000000XX------------XX
000000000000000000000000000000000000000000000000000000000000000000000000000000000000000000000000000XX-----XXXX---XX
000000000000000000000000000000000000000000000000000000000000000000000000000000000000000000000000000XX------------XX
000000000000000000000000000000000000000000000000000000000000000000000000000000000000000000000000000XXXX--------XXXX
000000000000000000000000000000000000000000000000000000000000000000000000000000000000000000000000000XXXX--------XXXX
000000000000000000000000000000000000000000000000000000000000000000000000000000000000000000000000000XXXX--------XXXX
000000000000000000000000000000000000000000000000000000000000000000000000000000000000000000000000000XXXX--------XXXX
000000000000000000000000000000000000000000000000000000000000000000000000000000000000000000000000000XXXX--------XXXX
000000000000000000000000000000000000000000000000000000000000000000000000000000000000000000000000000XXXX--------XXXX
000000000000000000000000000000000000000000000000000000000000000000000000000000000000000000000000000XXXX--------XXXX
000000000000000000000000000000000000000000000000000000000000000000000000000000000000000000000000000XXXX--------XXXX
000000000000000000000000000000000000000000000000000000000000000000000000000000000000000000000000000XXXX--------XXXX
000000000000000000000000000000000000000000000000000000000000000000000000000000000000000000000000000XXXX--------XXXX
000000000000000000000000000000000000000000000000000000000000000000000000000000000000000000000000000XXXX--------XXXX
000000000000000000000000000000000000000000000000000000000000000000000000000000000000000000000000000XXXX--------XXXX
000000000000000000000000000000000000000000000000000000000000000000000000000000000000000000000000000XXXX--------XXXX
000000000000000000000000000000000000000000000000000000000000000000000000000000000000000000000000000XXXX--------XXXX
000000000000000000000000000000000000000000000000000000000000000000000000000000000000000000000000000XXTTTT------XXXX
000000000000000000000000000000000000000000000000000000000000000000000000000000000000000000000000000XXXX--------XXXX
000000000000000000000000000000000000000000000000000000000000000000000000000000000000000000000000000XXXX--------XXXX
000000000000000000000000000000000000000000000000000000000000000000000000000000000000000000000000000X---------TTTT--
000000000000000000000000000000000000000000000000000000000000000000000000000000000000000000000000000----------------
000000000000000000000000000000000000000000000000000000000000000000000000000000000000000000000000000----------------
000000000000000000000000000000000000000000000000000000000000000000000000000000000000000000000000000--TTTT----------
000000000000000000000000000000000000000000000000000000000000000000000000000000000000000000000000000----------------
000000000000000000000000000000000000000000000000000000000000000000000000000000000000000000000000000----------------
000000000000000000000000000000000000000000000000000000000000000000000000000000000000000000000000000-TTTTTTTT----TTT
000000000000000000000000000000000000000000000000000000000000000000000000000000000000000000000000000----------------
000000000000000000000000000000000000000000000000000000000000000000000000000000000000000000000000000----------------
000000000000000000000000000000000000000000000000000000000000000000000000000000000000000000000000000XMMMMMMMMMMMMMMM
000000000000000000000000000000000000000000000000000000000000000000000000000000000000000000000000000----------------
000000000000000000000000000000000000000000000000000000000000000000000000000000000000000000000000000----E--------E--
00000000000000000000000000000000000000000000-------------------------------------------------------MMMMMMMMMMMMMMMM
00000000000000000000000000000000000000000000-------------------------------------------------------0000000000000000
00000000000000000000000000000000000000000000-------------------------------------------------------0000000000000000
00000000000000000000000000000000000000000000-------------------------------------------------------0000000000000000
00000000000000000000000000000000000000000000-------------------------------------------------------0000000000000000
00000000000000000000000000000000000000000000-------------------------------------------------------0000000000000000
00000000000000000000000000000000000000000000-------------------------------------------------------0000000000000000
00000000000000000000000000000000000000000000-------------------------------------------------------0000000000000000
00000000000000000000000000000000000000000000-------------------------------------------------------0000000000000000
00000000000000000000000000000000000000000000-------------------------------------------------------0000000000000000
00000000000000000000000000000000000000000000-------------------------------------------------------0000000000000000
00000000000000000000000000000000000000000000----------------------------E--------------------------0000000000000000
00000000000000000000000000000000000000000000-------------------------------------------------------0000000000000000
00000000000000000000000000000000000000000000-------------------------------------------------------0000000000000000
0000000000000000000000000000----------------------------------------E----------E-------------------0000000000000000
0000000000000000000000000000----------------XXXXXXXXXXXXXXXXXXXXXXXXXXXXXXXXXXXXXXXXXXXXXXXXXXXX---0000000000000000
0000000000000000000000000000-------------X--00000000000000000000000000000000000000000000000000000000000000000000000
0000000000000000000000000000----------------00000000000000000000000000000000000000000000000000000000000000000000000
0000000000000000000000000000----------------00000000000000000000000000000000000000000000000000000000000000000000000
0000000000000000000000000000----TTTT--------00000000000000000000000000000000000000000000000000000000000000000000000
--------------------------------------TTT---00000000000000000000000000000000000000000000000000000000000000000000000
----------------------------000000000000000000000000000000000000000000000000000000000000000000000000000000000000000
----------------------------000000000000000000000000000000000000000000000000000000000000000000000000000000000000000
----------------------------000000000000000000000000000000000000000000000000000000000000000000000000000000000000000
----------------------------000000000000000000000000000000000000000000000000000000000000000000000000000000000000000
----------------------------000000000000000000000000000000000000000000000000000000000000000000000000000000000000000
----------------------------000000000000000000000000000000000000000000000000000000000000000000000000000000000000000
----------------------------000000000000000000000000000000000000000000000000000000000000000000000000000000000000000
----------------------------000000000000000000000000000000000000000000000000000000000000000000000000000000000000000
----------------------------000000000000000000000000000000000000000000000000000000000000000000000000000000000000000
----------------------------000000000000000000000000000000000000000000000000000000000000000000000000000000000000000
----------------SQQQQQQQXX--000000000000000000000000000000000000000000000000000000000000000000000000000000000000000
----------------------------000000000000000000000000000000000000000000000000000000000000000000000000000000000000000
----------------------------000000000000000000000000000000000000000000000000000000000000000000000000000000000000000
-----E----------------E-----000000000000000000000000000000000000000000000000000000000000000000000000000000000000000
XXXXXXXXXXXXXXXXXXXXXXXX----000000000000000000000000000000000000000000000000000000000000000000000000000000000000000
0000000000000000000000000000000000000000000000000000000000000000000000000000000000000000000000000000000000000000000