00000000000000000000000000000000000000000000000000000000------TTTT------
00000000000000000000000000000000000000000000000000000000----------------
00000000000000000000000000000000000000000000000000000000---------XXXX---
00000000000000000000000000000000000000000000000000000000----------------
00000000000000000000000000000000000000000000000000000000--XXXX----------
00000000000000000000000000000000000000000000000000000000----------------
00000000000000000000000000000000000000000000000000000000----------------
00000000000000000000000000000000000000000000000000000000---------TTT----
00000000000000000000000000000000000000000000000000000000----------------
00000000000000000000000000000000000000000000000000000000X-----------TTTT
00000000000000000000000000000000000000000000000000000000X--------------X
00000000000000000000000000000000000000000000000000000000X--------------X
00000000000000000000000000000000000000000000000000000000XXXXXXXXX------X
00000000000000000000000000000000000000000000000000000000XX-------------X
00000000000000000000000000000000000000000000000000000000X---------TTTTTT
00000000000000000000000000000000000000000000000000000000XD-------------X
00000000000000000000000000000000000000000000000000000000XD-------------X
00000000000000000000000000000000000000000000000000000000TTTTXXXXXXXX--XX
00000000000000000000000000000000000000000000000000000000--TTTTTTTT-----X
00000000000000000000000000000000000000000000000000000000---------TTTTTTT
00000000000000000000000000000000000000000000000000000000-XXXXXXXX------X
00000000000000000000000000000000000000000000000000000000XX----XXXXX---XX
00000000000000000000000000000000000000000000000000000000XD------------XX
00000000000000000000000000000000000000000000000000000000XD------------XX
00000000000000000000000000000000000000000000000000000000XXXXXXXXXXXXXXXX
00000000000000000000000000000000000000000000000000000000XXXXXXXXXXXX---X
00000000000000000000000000000000000000000000000000000000XXXXXXXXXXXXXXXX
00000000000000000000000000000000000000000000000000000000XXXX----------XX
00000000000000000000000000000000000000000000000000000000XXXX----------XX
00000000000000000000000000000000000000000000000000000000XXXX---------XXX
00000000000000000000000000000000000000000000000000000000XXXX----------X-
00000000000000000000000000000000000000000000000000000000XXXX------------
00000000000000000000000000000000000000000000000000000000XXXX------------
00000000000000000000000000000000000000000000000000000000XX--------------
00000000000000000000000000000000000000000000000000000000X---------TTTTTT
00000000000000000000000000000000000000000000000000000000XD-------------X
00000000000000000000000000000000000000000000000000000000XD-------------X
00000000000000000000000000000000000000000000000000000000TTTTXXXXXXXX--XX
00000000000000000000000000000000000000000000000000000000--TTTTTTTT-----X
00000000000000000000000000000000000000000000000000000000---------TTTTTTT
00000000000000000000000000000000000000000000000000000000---E---E--------
00000000000000000000000000000000000000000000000000000000MMMMMMMMMMMMMMMM
00000000000000000000000000000000000000000000000000000000----------------
00000000000000000000000000000000000000000000000000000000----------------
00000000000000000000000000000000000000000000000000000000MMMMMMMMMMMMMMMM
00000000000000000000000000000000000000000000000000000000----------------
00000000000000000000000000000000000000000000000000000000----------------
00000000000000000000000000000000000000000000000000000000---------TTT----
00000000000000000000000000000000000000000000000000000000----------------
00000000000000000000000000000000000000000000000000000000X-----------TTTT
00000000000000000000000000000000000000000000000000000000X--------------X
00000000000000000000000000000000000000000000000000000000X--------------X
00000000000000000000000000000000000000000000000000000000XXXX-----------X
00000000000000000000000000000000000000000000000000000000XXXXXXXX-------X
00000000000000000000000000000000000000000000000000000000XXXXXXXX------XX
00000000000000000000000000000000000000000000000000000000XD-------------X
00000000000000000000000000000000000000000000000000000000XD-------------X
00000000000000000000000000000000000000000000000000000000TTTTXXXXXXXX---X
00000000000000000000000000000000000000000000000000000000--TTTTTTTT-----X
00000000000000000000000000000000000000000000000000000000---------TTTTTTT
00000000000000000000000000000000000000000000000000000000----------------
00000000000000000000000000000000000000000000000000000000----------------
00000000000000000000000000000000000000000000000000000000----TTTT--------
00000000000000000000000000000000000000000000000000000000----------TTT---
00000000000000000000000000000000000000000000000000000000----------------
00000000000000000000000000000000000000000000000000000000----------------
00000000000000000000000000000000000000000000000000000000XX----------XXXX
00000000000000000000000000000000000000000000000000000000------------XXX-
00000000000000000000000000000000000000000000000000000000----------------
00000000000000000000000000000000000000000000000000000000XX-----------XXX
00000000000000000000000000000000000000000000000000000000XX----XXXXXXXXXX
00000000000000000000000000000000000000000000000000000000XX------------XX
00000000000000000000000000000000000000000000000000000000XXXXX---------XX
00000000000000000000000000000000000000000000000000000000XX------------XX
00000000000000000000000000000000000000000000000000000000X---TT--------XX
00000000000000000000000000000000000000000000000000000000XD-------------X
00000000000000000000000000000000000000000000000000000000XD-------------X
00000000000000000000000000000000000000000000000000000000TTTTXXXXXXXX--XX
00000000000000000000000000000000000000000000000000000000--TTTTTTTT-----X
00000000000000000000000000000000000000000000000000000000---------TTTTTTT
00000000000000000000000000000000000000000000000000000000XMMMMMMMMMMMMMMM
00000000000000000000000000000000000000000000000000000000----------------
00000000000000000000000000000000000000000000000000000000----E--------E--
00000000000000000000000000000000000000000000000000000000MMMMMMMMMMMMMMMM
000000000000000000000000000000000000------------------------------------
000000000000000000000000000000000000------------------------------------
000000000000000000000000000000000000------------------------------------
000000000000000000000000000000000000-----------------------------XXXXX--
000000000000000000000000000000000000------------------------------------
000000000000000000000000000000000000----------------------------XXXX----
000000000000000000000000000000000000----------------------------XXXXX---
000000000000000000000000000000000000------------------------------XXXX--
000000000000000000000000000000000000------------------------XXXX---XXXX-
000000000000000000000000000000000000--------------------XXXXXXXXXXXXXXXX
000000000000000000000000000000000000-------------oo-----XXXXXXXXXXXXXXXX
000000000000000000000000000000000000-----------X--------XD-------------X
000000000000000000000000000000000000--------XXXX--------XD-------------X
000000000000000000000000000000000000-------XXXXX--------TTTTXXXXXXXX---X
00000000000000000000--------XXXXXXXX------XXXXXX----------TTTTTTTT-----X
00000000000000000000----------------XXXXXXXXXXXXXXXXXXXX---------TTTTTTT
00000000000000000000---TTTT--TTTT---000000000000000000000000000000000000
00000000000000000000----------------000000000000000000000000000000000000
00000000000000000000----------------000000000000000000000000000000000000
00000000000000000000-----TTTT-------000000000000000000000000000000000000
00000000000000000000----------------000000000000000000000000000000000000
00000000000000000000XXXX--------XXXX000000000000000000000000000000000000
00000000000000000000X----------DXXX-000000000000000000000000000000000000
00000000000000000000X----------XXXXX000000000000000000000000000000000000
00000000000000000000X------XXXXXXXXX000000000000000000000000000000000000
00000000000000000000XXXX-----TTTTTTT000000000000000000000000000000000000
00000000000000000000XXXX--------XXXX000000000000000000000000000000000000
00000000000000000000XX------------XX000000000000000000000000000000000000
00000000000000000000XX----XXXXX---XX000000000000000000000000000000000000
00000000000000000000XD------------XX000000000000000000000000000000000000
00000000000000000000XD------------XX000000000000000000000000000000000000
00000000000000000000TTTTXXXXXXXX--XX000000000000000000000000000000000000
00000000000000000000--TTTTTTTT-----X000000000000000000000000000000000000
00000000000000000000---------TTTTTTT000000000000000000000000000000000000
00000000000000000000----------XXXX--000000000000000000000000000000000000
00000000000000000000----------------000000000000000000000000000000000000
00000000000000000000---------D------000000000000000000000000000000000000
00000000000000000000--------TTTT----000000000000000000000000000000000000
00000000000000000000----------------000000000000000000000000000000000000
00000000000000000000----------------000000000000000000000000000000000000
00000000000000000000XXXX----XXXXXXXX000000000000000000000000000000000000
00000000000000000000XXXX---------DXX000000000000000000000000000000000000
00000000000000000000XXXX---------DXX000000000000000000000000000000000000
00000000000000000000XXXX----XXXXXXXX000000000000000000000000000000000000
00000000000000000000---X-X----------000000000000000000000000000000000000
00000000000000000000---X------------000000000000000000000000000000000000
00000000000000000000XXXX----------XX000000000000000000000000000000000000
00000000000000000000XXXXXXXX------XX000000000000000000000000000000000000
00000000000000000000XXXXXXXX------XX000000000000000000000000000000000000
00000000000000000000XD-------------X000000000000000000000000000000000000
00000000000000000000XD-------------X000000000000000000000000000000000000
00000000000000000000TTTTXXXXXXXX---X000000000000000000000000000000000000
00000000000000000000--TTTTTTTT-----X000000000000000000000000000000000000
00000000000000000000---------TTTTTTT000000000000000000000000000000000000
00000000000000000000XXXX---XX------X000000000000000000000000000000000000
00000000000000000000XXXXXXXXXXXX---X000000000000000000000000000000000000
00000000000000000000XXXXXXXXXXXXXXXX000000000000000000000000000000000000
00000000000000000000XXXX----------XX000000000000000000000000000000000000
--------------------XXXX----------XX000000000000000000000000000000000000
--------------------XXXX----------DX000000000000000000000000000000000000
--------------------XXXX----------DX000000000000000000000000000000000000
--------------------XXXX----XXXXXXXX000000000000000000000000000000000000
-----------------------X-X----------000000000000000000000000000000000000
-----------------------X------------000000000000000000000000000000000000
--------------------XXXX----------XX000000000000000000000000000000000000
-------------XX-----XXXX----------XX000000000000000000000000000000000000
------------XXX-----XXXX----------XX000000000000000000000000000000000000
-----------XXXX-----XXXX---XXXXXXXXX000000000000000000000000000000000000
----------XXXXX-----XXXXXXXXXXXX---X000000000000000000000000000000000000
----------XXXXX-----XD-------------X000000000000000000000000000000000000
-------XXXXXXXX-----XD-------------X000000000000000000000000000000000000
------XXXXXXXXX-----TTTTXXXXXXXX---X000000000000000000000000000000000000
----------XXXXX-------TTTTTTTT-----X000000000000000000000000000000000000
XXXXXXXXXXXXXXXXXXXX---------TTTTTTT000000000000000000000000000000000000
000000000000000000000000000000000000000000000000000000000000000000000000