--------------------------------------------------------------------------------------------------------------------------------------------------------------------------------------------------------000000000000000
--------------------------------------------------------------------------------------------------------------------------------------------------------------------------------------------------------000000000000000
--------------------------------------------------------------------------------------------------------------------------------------------------------------------------------------------------------000000000000000
--------------------------------------------------------------------------------------------------------------------------------------------------------------------------------------------------------000000000000000
--------------------------------------------------------------------------------------------------------------------------------------------------------------------------------------------------------000000000000000
--------------------------------------------------------------------------------------------------------------------------------------------------------------------------------------------------------000000000000000
--------------------------------------------------------------------------------------------------------------------------------------------------------------------------------------------------------000000000000000
--------------------------------------------------------------------------------------------------------------------------------------------------------------XX----------------------------------------000000000000000
----------------------------------------------------------------------------------------------------------------------------------------o--------------------XXX----------------------------------------000000000000000
-----------------------------------------------------------------------------------------------------------------------------------------------------------XXXXX----------------------------------------000000000000000
--------------------------------------------------------------------------------------------E--------------------------------------S---X------------------XXXXXX---------------------------------------X000000000000000
----------------S--------------E------------E-----------------------------------------E----<>-----------------------------------------------E------------XXXXXXX------------------------------------X-XX000000000000000
-----------------------------E----------------------------E--------------------------<>----[]-----------------------------------------------------------XXXXXXXX------------------------------------XXXX000000000000000
----------------------------<>---------------------------<>--------------------------[]----[]-----------------------------------------------------------XXXXXXXX------------------------------------XXXX000000000000000
-----E--E----E------E-EE----[]-------E-----E--------E----[]-----E-----------E--------[]----[]-----------------------------------------------------------XXXXXXXX-----E-E---------E------------------XXXX000000000000000
XXXXXXXXXXXXXXXXXXXXXXXXXXXXXXXXXXXXXXXXXXXXXXXXXXXXXXXXXXXXXXXXXXXXXXXXXXXXXXXXXXXXXXXXXXXXXXXXXXXXXXXXXXXXXXXXXXXXXXXXXXXXXXXXXXXXXXXXXXXXXXXXXXXXXXXXXXXXXXXXXXXXXXXXXXXXXXXXXXXXXXXXXXXXXXXXXXXXXXXX000000000000000
00000000000000000000000000000000000000000000000000000000000000000000000000000000000000000000000000000000000000000000000000000000000000000000000000000000000000000000000000000000000000000000000000000000000000000000000