000000000000000000000000000000000000000000000000000000000000000000000000000000000000000000000000000000000000----------------
000000000000000000000000000000000000000000000000000000000000000000000000000000000000000000000000000000000000----------------
000000000000000000000000000000000000000000000000000000000000000000000000000000000000000000000000000000000000------TTT-------
000000000000000000000000000000000000000000000000000000000000000000000000000000000000000000000000000000000000----------------
000000000000000000000000000000000000000000000000000000000000000000000000000000000000000000000000000000000000----------------
000000000000000000000000000000000000000000000000000000000000000000000000000000000000000000000000000000000000--TTTT----TTTT--
000000000000000000000000000000000000000000000000000000000000000000000000000000000000000000000000000000000000----------------
000000000000000000000000000000000000000000000000000000000000000000000000000000000000000000000000000000000000----------------
000000000000000000000000000000000000000000000000000000000000000000000000000000000000000000000000000000000000XX----TTTT----XX
000000000000000000000000000000000000000000000000000000000000000000000000000000000000000000000000000000000000XX------------XX
000000000000000000000000000000000000000000000000000000000000000000000000000000000000000000000000000000000000XXXX----------XX
000000000000000000000000000000000000000000000000000000000000000000000000000000000000000000000000000000000000XXXXXXXX------XX
000000000000000000000000000000000000000000000000000000000000000000000000000000000000000000000000000000000000XXXXXXXX------XX
000000000000000000000000000000000000000000000000000000000000000000000000000000000000000000000000000000000000XX------------XX
000000000000000000000000000000000000000000000000000000000000000000000000000000000000000000000000000000000000XX--------XXXXXX
000000000000000000000000000000000000000000000000000000000000000000000000000000000000000000000000000000000000XD-------------X
000000000000000000000000000000000000000000000000000000000000000000000000000000000000000000000000000000000000XD-------------X
000000000000000000000000000000000000000000000000000000000000000000000000000000000000000000000000000000000000TTTTXXXXXXXX--DX
000000000000000000000000000000000000000000000000000000000000000000000000000000000000000000000000000000000000--TTTTTTTT----DX
000000000000000000000000000000000000000000000000000000000000000000000000000000000000000000000000000000000000---------TTTTTTT
000000000000000000000000000000000000000000000000000000000000000000000000000000000000000000000000000000000000-XXXX--------XXX
000000000000000000000000000000000000000000000000000000000000000000000000000000000000000000000000000000000000----------------
000000000000000000000000000000000000000000000000000000000000000000000000000000000000000000000000000000000000---------TTTT---
000000000000000000000000000000000000000000000000000000000000000000000000000000000000000000000000000000000000----------------
000000000000000000000000000000000000000000000000000000000000000000000000000000000000000000000000000000000000----------------
000000000000000000000000000000000000000000000000000000000000000000000000000000000000000000000000000000000000---------XXXXXXX
000000000000000000000000000000000000000000000000000000000000000000000000000000000000000000000000000000000000----------------
000000000000000000000000000000000000000000000000000000000000000000000000000000000000000000000000000000000000-------XXXX-----
000000000000000000000000000000000000000000000000000000000000000000000000000000000000000000000000000000000000-------TTTT-----
000000000000000000000000000000000000000000000000000000000000000000000000000000000000000000000000000000000000---------------X
000000000000000000000000000000000000000000000000000000000000000000000000000000000000000000000000000000000000-XXXX--------XXX
000000000000000000000000000000000000000000000000000000000000000000000000000000000000000000000000000000000000XX----------XXXX
000000000000000000000000000000000000000000000000000000000000000000000000000000000000000000000000000000000000XXXX-----------X
000000000000000000000000000000000000000000000000000000000000000000000000000000000000000000000000000000000000XX-------------X
000000000000000000000000000000000000000000000000000000000000000000000000000000000000000000000000000000000000XX--------TTTTTT
000000000000000000000000000000000000000000000000000000000000000000000000000000000000000000000000000000000000XD-------------X
000000000000000000000000000000000000000000000000000000000000000000000000000000000000000000000000000000000000XD-------------X
000000000000000000000000000000000000000000000000000000000000000000000000000000000000000000000000000000000000TTTTXXXXXXXX---X
000000000000000000000000000000000000000000000000000000000000000000000000000000000000000000000000000000000000--TTTTTTTT----DX
000000000000000000000000000000000000000000000000000000000000000000000000000000000000000000000000000000000000---------TTTTTTT
000000000000000000000000000000000000000000000000000000000000000000000000000000000000000000000000000000000000----------------
000000000000000000000000000000000000000000000000000000000000000000000000000000000000000000000000000000000000--------TTTT----
000000000000000000000000000000000000000000000000000000000000000000000000000000000000000000000000000000000000----------------
000000000000000000000000000000000000000000000000000000000000000000000000000000000000000000000000000000000000----------------
000000000000000000000000000000000000000000000000000000000000000000000000000000000000000000000000000000000000XX-----TTTT---XX
000000000000000000000000000000000000000000000000000000000000000000000000000000000000000000000000000000000000XX------------XX
000000000000000000000000000000000000000000000000000000000000000000000000000000000000000000000000000000000000XX------------XX
000000000000000000000000000000000000000000000000000000000000000000000000000000000000000000000000000000000000XXXX--------XXXX
000000000000000000000000000000000000000000000000000000000000000000000000000000000000000000000000000000000000XXXX--------XXXX
000000000000000000000000000000000000000000000000000000000000000000000000000000000000000000000000000000000000XXXX--------XXXX
000000000000000000000000000000000000000000000000000000000000000000000000000000000000000000000000000000000000XXXX--------XXXX
000000000000000000000000000000000000000000000000000000000000000000000000000000000000000000000000000000000000XX----TTTTTTTTXX
000000000000000000000000000000000000000000000000000000000000000000000000000000000000000000000000000000000000XX------------XX
000000000000000000000000000000000000000000000000000000000000000000000000000000000000000000000000000000000000XX------------XX
000000000000000000000000000000000000000000000000000000000000000000000000000000000000000000000000000000000000XX--------XXXXXX
000000000000000000000000000000000000000000000000000000000000000000000000000000000000000000000000000000000000XD-------------X
000000000000000000000000000000000000000000000000000000000000000000000000000000000000000000000000000000000000XD-------------X
000000000000000000000000000000000000000000000000000000000000000000000000000000000000000000000000000000000000TTTTXXXXXXXX--DX
000000000000000000000000000000000000000000000000000000000000000000000000000000000000000000000000000000000000--TTTTTTTT----DX
0000000000000000000000000000000000000000000000000000000000000000000000000000000000000000-----------------------------TTTTTTT
0000000000000000000000000000000000000000000000000000000000000000000000000000000000000000--------------------0000000000000000
0000000000000000000000000000000000000000000000000000000000000000000000000000000000000000--------------------0000000000000000
0000000000000000000000000000000000000000000000000000000000000000000000000000000000000000--------------------0000000000000000
0000000000000000000000000000000000000000000000000000000000000000000000000000000000000000--------------------0000000000000000
0000000000000000000000000000000000000000000000000000000000000000000000000000000000000000--------------------0000000000000000
0000000000000000000000000000000000000000000000000000000000000000000000000000000000000000--------------------0000000000000000
0000000000000000000000000000000000000000000000000000000000000000000000000000000000000000--------------------0000000000000000
0000000000000000000000000000000000000000000000000000000000000000000000000000000000000000--------------------0000000000000000
0000000000000000000000000000000000000000000000000000000000000000000000000000000000000000--------------------0000000000000000
0000000000000000000000000000000000000000000000000000000000000000000000000000000000000000--------------------0000000000000000
0000000000000000000000000000000000000000000000000000000000000000000000000000000000000000--------------S?----0000000000000000
0000000000000000000000000000000000000000000000000000000000000000000000000000000000000000--------------------0000000000000000
0000000000000000000000000000000000000000000000000000000000000000000000000000000000000000--------------------0000000000000000
0000000000000000000000000000000000000000000000000000000000000000000000000000000000000000-------------E------0000000000000000
000000000000000000000000000000000000000000000000000000000000000000000000----------------XXXXXXXXXXXXXXXXXX--0000000000000000
000000000000000000000000000000000000000000000000000000000000000000000000-----X----------000000000000000000000000000000000000
000000000000000000000000000000000000000000000000000000000000000000000000-----------X----000000000000000000000000000000000000
000000000000000000000000000000000000000000000000000000000000000000000000----------------000000000000000000000000000000000000
000000000000000000000000000000000000000000000000000000000000000000000000----------------000000000000000000000000000000000000
000000000000000000000000000000000000000000000000000000000000000000000000-------------X--000000000000000000000000000000000000
000000000000000000000000000000000000000000000000000000000000000000000000----------------000000000000000000000000000000000000
000000000000000000000000000000000000000000000000000000000000000000000000---------TTT----000000000000000000000000000000000000
000000000000000000000000000000000000000000000000000000000000000000000000----------------000000000000000000000000000000000000
000000000000000000000000000000000000000000000000000000000000000000000000X-----------TTTT000000000000000000000000000000000000
000000000000000000000000000000000000000000000000000000000000000000000000X--------------X000000000000000000000000000000000000
0000000000000000000000000000000000000000000000000000--------------------X--------------X000000000000000000000000000000000000
0000000000000000000000000000000000000000000000000000--------------------XXXXXXXXX------X000000000000000000000000000000000000
0000000000000000000000000000000000000000000000000000--------------------XX-------------X000000000000000000000000000000000000
0000000000000000000000000000000000000000000000000000--------------------XX-------TTTTTTT000000000000000000000000000000000000
0000000000000000000000000000000000000000000000000000--------------------XD-------------X000000000000000000000000000000000000
0000000000000000000000000000000000000000000000000000--------------------XD-------------X000000000000000000000000000000000000
0000000000000000000000000000000000000000000000000000--------------------TTTTXXXXXXXX--DX000000000000000000000000000000000000
0000000000000000000000000000000000000000000000000000--------o------ooo----TTTTTTTT----DX000000000000000000000000000000000000
0000000000000000000000000000000000000000000000000000-------o-----------X---------TTTTTTT000000000000000000000000000000000000
0000000000000000000000000000000000000000000000000000--------------------0000000000000000000000000000000000000000000000000000
0000000000000000000000000000000000000000000000000000--------X-----------0000000000000000000000000000000000000000000000000000
0000000000000000000000000000000000000000000000000000---------X-------XX-0000000000000000000000000000000000000000000000000000
0000000000000000000000000000000000000000000000000000------------XXX-----0000000000000000000000000000000000000000000000000000
0000000000000000000000000000000000000000000000000000--------------------0000000000000000000000000000000000000000000000000000
0000000000000000000000000000000000000000000000000000--------------------0000000000000000000000000000000000000000000000000000
000000000000000000000000000000000000--------DX------XX------------------0000000000000000000000000000000000000000000000000000
000000000000000000000000000000000000------DX--------000000000000000000000000000000000000000000000000000000000000000000000000
000000000000000000000000000000000000XXXXXXXX----XXXX000000000000000000000000000000000000000000000000000000000000000000000000
000000000000000000000000000000000000----------------000000000000000000000000000000000000000000000000000000000000000000000000
000000000000000000000000000000000000---------XXXX---000000000000000000000000000000000000000000000000000000000000000000000000
000000000000000000000000000000000000----------------000000000000000000000000000000000000000000000000000000000000000000000000
000000000000000000000000000000000000----------------000000000000000000000000000000000000000000000000000000000000000000000000
000000000000000000000000000000000000---------XXXXXXX000000000000000000000000000000000000000000000000000000000000000000000000
0000000000000000------------------------------------000000000000000000000000000000000000000000000000000000000000000000000000
0000000000000000--------------------------XXXX------000000000000000000000000000000000000000000000000000000000000000000000000
0000000000000000------------------------------------000000000000000000000000000000000000000000000000000000000000000000000000
0000000000000000-----------------------TTTT---------000000000000000000000000000000000000000000000000000000000000000000000000
0000000000000000------------------------------------000000000000000000000000000000000000000000000000000000000000000000000000
0000000000000000------------------------------------000000000000000000000000000000000000000000000000000000000000000000000000
0000000000000000--------------------XX-----TTTT---XX000000000000000000000000000000000000000000000000000000000000000000000000
0000000000000000----------S---------XX------------XX000000000000000000000000000000000000000000000000000000000000000000000000
0000000000000000------------S-------XD-------------X000000000000000000000000000000000000000000000000000000000000000000000000
0000000000000000--------------------TTTTXXXXXXXX--DX000000000000000000000000000000000000000000000000000000000000000000000000
0000000000000000----------------------TTTTTTTT----DX000000000000000000000000000000000000000000000000000000000000000000000000
0000000000000000-----<E------------S---------TTTTTTT000000000000000000000000000000000000000000000000000000000000000000000000
0000000000000000-----[>-------------0000000000000000000000000000000000000000000000000000000000000000000000000000000000000000
0000000000000000-----[]-------------0000000000000000000000000000000000000000000000000000000000000000000000000000000000000000
0000000000000000-----[]-------------0000000000000000000000000000000000000000000000000000000000000000000000000000000000000000
----------------XXXXXXXXXXXXXXXXXXXE0000000000000000000000000000000000000000000000000000000000000000000000000000000000000000
-X--------------000000000000000000000000000000000000000000000000000000000000000000000000000000000000000000000000000000000000
XX----------XXXX000000000000000000000000000000000000000000000000000000000000000000000000000000000000000000000000000000000000
XX--------------000000000000000000000000000000000000000000000000000000000000000000000000000000000000000000000000000000000000
XX--------------000000000000000000000000000000000000000000000000000000000000000000000000000000000000000000000000000000000000
XXXXMMMMMMMMMMMM000000000000000000000000000000000000000000000000000000000000000000000000000000000000000000000000000000000000
XXXXX-----------000000000000000000000000000000000000000000000000000000000000000000000000000000000000000000000000000000000000
XXXX------------000000000000000000000000000000000000000000000000000000000000000000000000000000000000000000000000000000000000
XX--------------000000000000000000000000000000000000000000000000000000000000000000000000000000000000000000000000000000000000
XX--------------000000000000000000000000000000000000000000000000000000000000000000000000000000000000000000000000000000000000
XXXX--TTTT------000000000000000000000000000000000000000000000000000000000000000000000000000000000000000000000000000000000000
XXXX------------000000000000000000000000000000000000000000000000000000000000000000000000000000000000000000000000000000000000
XX-------------X000000000000000000000000000000000000000000000000000000000000000000000000000000000000000000000000000000000000
XX----------TTTT000000000000000000000000000000000000000000000000000000000000000000000000000000000000000000000000000000000000
XD-------------X000000000000000000000000000000000000000000000000000000000000000000000000000000000000000000000000000000000000
XD-------------X000000000000000000000000000000000000000000000000000000000000000000000000000000000000000000000000000000000000
XD-------------X000000000000000000000000000000000000000000000000000000000000000000000000000000000000000000000000000000000000
TTTTXXXXXXXX--DX000000000000000000000000000000000000000000000000000000000000000000000000000000000000000000000000000000000000
--TTTTTTTT----DX000000000000000000000000000000000000000000000000000000000000000000000000000000000000000000000000000000000000
---------TTTTTTT000000000000000000000000000000000000000000000000000000000000000000000000000000000000000000000000000000000000
--X-------------000000000000000000000000000000000000000000000000000000000000000000000000000000000000000000000000000000000000
X-------------XX000000000000000000000000000000000000000000000000000000000000000000000000000000000000000000000000000000000000
X-------------XX000000000000000000000000000000000000000000000000000000000000000000000000000000000000000000000000000000000000
XMMMMMMMMMMMMMXX000000000000000000000000000000000000000000000000000000000000000000000000000000000000000000000000000000000000
XX--------------000000000000000000000000000000000000000000000000000000000000000000000000000000000000000000000000000000000000
XX--------------000000000000000000000000000000000000000000000000000000000000000000000000000000000000000000000000000000000000
XXXX--------XXXX000000000000000000000000000000000000000000000000000000000000000000000000000000000000000000000000000000000000
XXXX--------XXXX000000000000000000000000000000000000000000000000000000000000000000000000000000000000000000000000000000000000
XTTTTTTTT---XXXX000000000000000000000000000000000000000000000000000000000000000000000000000000000000000000000000000000000000
XXXX--------XXXX000000000000000000000000000000000000000000000000000000000000000000000000000000000000000000000000000000000000
XXXX--------XXXX000000000000000000000000000000000000000000000000000000000000000000000000000000000000000000000000000000000000
XX----TTTTTTTTXX000000000000000000000000000000000000000000000000000000000000000000000000000000000000000000000000000000000000
XX------------XX000000000000000000000000000000000000000000000000000000000000000000000000000000000000000000000000000000000000
XX------------XX000000000000000000000000000000000000000000000000000000000000000000000000000000000000000000000000000000000000
XX--------XXXXXX000000000000000000000000000000000000000000000000000000000000000000000000000000000000000000000000000000000000
XD-------------X000000000000000000000000000000000000000000000000000000000000000000000000000000000000000000000000000000000000
XD-------------X000000000000000000000000000000000000000000000000000000000000000000000000000000000000000000000000000000000000
TTTTXXXXXXXX--DX000000000000000000000000000000000000000000000000000000000000000000000000000000000000000000000000000000000000
--TTTTTTTT----DX000000000000000000000000000000000000000000000000000000000000000000000000000000000000000000000000000000000000
---------TTTTTTT000000000000000000000000000000000000000000000000000000000000000000000000000000000000000000000000000000000000