00000000000000000000000000000000000000000000000000000000000000000000000000000000000000000000000000000000000000000000000000000000--------------------000000000000000
00000000000000000000000000000000000000000000000000000000000000000000000000000000000000000000000000000000000000000000000000000000--------------------000000000000000
00000000000000000000000000000000000000000000000000000000000000000000000000000000000000000000000000000000000000000000000000000000--------------------000000000000000
00000000000000000000000000000000000000000000000000000000000000000000000000000000000000000000000000000000000000000000000000000000--------------------000000000000000
0000000000000000000000000000000000000000000000000000000000000000000000000000000000000000000000000000000000000000------XXXX------S-------------------000000000000000
0000000000000000000000000000000000000000000000000000000000000000000000000000000000000000000000000000000000000000------XX--------S-------------------000000000000000
0000000000000000000000000000000000000000000000000000000000000000000000000000000000000000000000000000000000000000---XXXXX--------S-------------------000000000000000
0000000000000000000000000000000000000000000000000000000000000000000000000000000000000000000000000000000000000000---XX-----------S-------------------000000000000000
0000000000000000000000000000000000000000000000000000000000000000000000000000000000000000000000000000000000000000---XX-----------S-------------------000000000000000
0000000000000000000000000000000000000000000000000000000000000000000000000000000000000000000000000000000000000000XXXX----------XXS-------------------000000000000000
0000000000000000000000000000000000000000000000000000000000000000000000000000000000000000000000000000000000000000XXXX----------DXS-------------------000000000000000
0000000000000000000000000000000000000000000000000000000000000000000000000000000000000000000000000000000000000000XXXX----------DXS-------------------000000000000000
0000000000000000000000000000000000000000000000000000000000000000000000000000000000000000000000000000000000000000XXXX----XXXXXXXXS-------------------000000000000000
0000000000000000000000000000000000000000000000000000000000000000000000000000000000000000000000000000000000000000---X-X----------S-------------------000000000000000
0000000000000000000000000000000000000000000000000000000000000000000000000000000000000000000000000000000000000000---X------------S-------------------000000000000000
0000000000000000000000000000000000000000000000000000000000000000000000000000000000000000000000000000000000000000XXX-----------XXXXXXXXXXXXXXXXXXXXXX000000000000000
000000000000000000000000000000000000000000000000000000000000000000000000----------------------------------------XXXXXXXXXX----XX00000000000000000000000000000000000
000000000000000000000000000000000000000000000000000000000000000000000000----------------------------------------XX------------XX00000000000000000000000000000000000
000000000000000000000000000000000000000000000000000000000000000000000000----------------------------------------XX------------XX00000000000000000000000000000000000
000000000000000000000000000000000000000000000000000000000000000000000000----------------------------------------XX----XXXXXXXXXX00000000000000000000000000000000000
00000000000000000000000000000000000000000000000000000000----------------S-------------------S-------------------XD------------XX00000000000000000000000000000000000
00000000000000000000000000000000000000000000000000000000---E---E--------S-------------------S-------------------XD------------XX00000000000000000000000000000000000
00000000000000000000000000000000000000000000000000000000MMMMMMMMMMMMMMMMS-------------------S-------------------XXXXX-------XXXX00000000000000000000000000000000000
00000000000000000000000000000000000000000000000000000000----------------S-------------------S------------------XXXXXXXXXXXXXXXXX00000000000000000000000000000000000
00000000000000000000000000000000000000000000000000000000----------------S-------------------S-----------------XX000000000000000000000000000000000000000000000000000
00000000000000000000000000000000000000000000000000000000---TTTT---------S-------------------S----------------XXX000000000000000000000000000000000000000000000000000
00000000000000000000000000000000000000000000000000000000----------------S-------------------S---------------XXXX000000000000000000000000000000000000000000000000000
00000000000000000000000000000000000000000000000000000000----------------S------------------ES--------------XXXXX000000000000000000000000000000000000000000000000000
00000000000000000000000000000000000000000000000000000000XX-----TTTT---XXS--SSSS-----------<>S------------XXXXXXX000000000000000000000000000000000000000000000000000
00000000000000000000000000000000000000000000000000000000XX------------XXS-S---------------[]S-----------XXXXXXXX000000000000000000000000000000000000000000000000000
00000000000000000000000000000000000000000000000000000000XX------------XXS----------E------[]S----------XXXXXXXXX000000000000000000000000000000000000000000000000000
00000000000000000000000000000000000000000000000000000000XXXXXXXX------XXXX-----XXXXXXXXXXXXXXXXXXXXXXXXXXXXXXXXX000000000000000000000000000000000000000000000000000
00000000000000000000000000000000000000000000000000000000XXXX----------XX0000000000000000000000000000000000000000000000000000000000000000000000000000000000000000000
00000000000000000000000000000000000000000000000000000000XX------------XX0000000000000000000000000000000000000000000000000000000000000000000000000000000000000000000
00000000000000000000000000000000000000000000000000000000XX--------XXXXXX0000000000000000000000000000000000000000000000000000000000000000000000000000000000000000000
00000000000000000000000000000000000000000000000000000000XX------------XX0000000000000000000000000000000000000000000000000000000000000000000000000000000000000000000
00000000000000000000000000000000000000000000000000000000XD------------DX0000000000000000000000000000000000000000000000000000000000000000000000000000000000000000000
00000000000000000000000000000000000000000000000000000000XD------------DX0000000000000000000000000000000000000000000000000000000000000000000000000000000000000000000
00000000000000000000000000000000000000000000000000000000XXXXX-------XXXX0000000000000000000000000000000000000000000000000000000000000000000000000000000000000000000
00000000000000000000000000000000000000000000000000000000XXXXXXXXXXXXXXXX0000000000000000000000000000000000000000000000000000000000000000000000000000000000000000000
00000000000000000000000000000000000000000000000000000000-XXXXXXX----XXXX0000000000000000000000000000000000000000000000000000000000000000000000000000000000000000000
00000000000000000000000000000000000000000000000000000000XXXX--------XXXX0000000000000000000000000000000000000000000000000000000000000000000000000000000000000000000
00000000000000000000000000000000000000000000000000000000XXXX--------XXXX0000000000000000000000000000000000000000000000000000000000000000000000000000000000000000000
00000000000000000000000000000000000000000000000000000000XXXXXXX-----XXXX0000000000000000000000000000000000000000000000000000000000000000000000000000000000000000000
00000000000000000000000000000000000000000000000000000000XXXX--------XXXX0000000000000000000000000000000000000000000000000000000000000000000000000000000000000000000
00000000000000000000000000000000000000000000000000000000XX------------XX0000000000000000000000000000000000000000000000000000000000000000000000000000000000000000000
00000000000000000000000000000000000000000000000000000000XX-----XXXX---DX0000000000000000000000000000000000000000000000000000000000000000000000000000000000000000000
00000000000000000000000000000000000000000000000000000000XX------------DX0000000000000000000000000000000000000000000000000000000000000000000000000000000000000000000
00000000000000000000000000000000000000000000000000000000XXXX--------XXXX0000000000000000000000000000000000000000000000000000000000000000000000000000000000000000000
00000000000000000000000000000000000000000000000000000000XXXXXX------XXXX0000000000000000000000000000000000000000000000000000000000000000000000000000000000000000000
00000000000000000000000000000000000000000000000000000000XXXX--------XXXX0000000000000000000000000000000000000000000000000000000000000000000000000000000000000000000
00000000000000000000000000000000000000000000000000000000XXXX--------XXXX0000000000000000000000000000000000000000000000000000000000000000000000000000000000000000000
0000000000000000----------------------------------------XX----TTTTTTTTXX0000000000000000000000000000000000000000000000000000000000000000000000000000000000000000000
0000000000000000----------------------------------------XX------------XX0000000000000000000000000000000000000000000000000000000000000000000000000000000000000000000
0000000000000000----------------------------------------XX------------XX0000000000000000000000000000000000000000000000000000000000000000000000000000000000000000000
------XXXX----------------------------------------------XX----XXXXX---XX0000000000000000000000000000000000000000000000000000000000000000000000000000000000000000000
----------------S-------------------S-------------------XD------------XX0000000000000000000000000000000000000000000000000000000000000000000000000000000000000000000
---XXXX---------S-------------------S-------------------XD------------XX0000000000000000000000000000000000000000000000000000000000000000000000000000000000000000000
----------------S-------------------S-------------------XXXXX-------XXXX0000000000000000000000000000000000000000000000000000000000000000000000000000000000000000000
----------------S-------------------S---------------XXXXXXXXXXXXXXXXXXXX0000000000000000000000000000000000000000000000000000000000000000000000000000000000000000000
XXXX------------S-------------------S---------------XXXX00000000000000000000000000000000000000000000000000000000000000000000000000000000000000000000000000000000000
----------------S-------------------S--------------XXXXX00000000000000000000000000000000000000000000000000000000000000000000000000000000000000000000000000000000000
--TTTT----------S------------------ES-------------XXXXXX00000000000000000000000000000000000000000000000000000000000000000000000000000000000000000000000000000000000
----------------S-----------------<>S------------EXXXXXX00000000000000000000000000000000000000000000000000000000000000000000000000000000000000000000000000000000000
----------------S-----------------[]S------------XXXXXXX00000000000000000000000000000000000000000000000000000000000000000000000000000000000000000000000000000000000
X--TTTT----TTTT-S---E-------------[]S-----------XXXXXXXX00000000000000000000000000000000000000000000000000000000000000000000000000000000000000000000000000000000000
X---------------S--------------EE-[]S----------XXXXXXXXX00000000000000000000000000000000000000000000000000000000000000000000000000000000000000000000000000000000000
X---------------XXXXXXXXXXXXXXXXXXXXXXEXXXXXXXXXXXXXXXXX00000000000000000000000000000000000000000000000000000000000000000000000000000000000000000000000000000000000
XXXX------------000000000000000000000000000000000000000000000000000000000000000000000000000000000000000000000000000000000000000000000000000000000000000000000000000
XXXX------------000000000000000000000000000000000000000000000000000000000000000000000000000000000000000000000000000000000000000000000000000000000000000000000000000
XXXXXXX---------000000000000000000000000000000000000000000000000000000000000000000000000000000000000000000000000000000000000000000000000000000000000000000000000000
XD--------------000000000000000000000000000000000000000000000000000000000000000000000000000000000000000000000000000000000000000000000000000000000000000000000000000
XD-------------X000000000000000000000000000000000000000000000000000000000000000000000000000000000000000000000000000000000000000000000000000000000000000000000000000
XXXXX-------XXXX000000000000000000000000000000000000000000000000000000000000000000000000000000000000000000000000000000000000000000000000000000000000000000000000000
XXXXXXXXXXXXXXXX000000000000000000000000000000000000000000000000000000000000000000000000000000000000000000000000000000000000000000000000000000000000000000000000000
---------XXXXXXX000000000000000000000000000000000000000000000000000000000000000000000000000000000000000000000000000000000000000000000000000000000000000000000000000
----------------000000000000000000000000000000000000000000000000000000000000000000000000000000000000000000000000000000000000000000000000000000000000000000000000000
------XXXX------000000000000000000000000000000000000000000000000000000000000000000000000000000000000000000000000000000000000000000000000000000000000000000000000000
------XX--------000000000000000000000000000000000000000000000000000000000000000000000000000000000000000000000000000000000000000000000000000000000000000000000000000
---XXXXX--------000000000000000000000000000000000000000000000000000000000000000000000000000000000000000000000000000000000000000000000000000000000000000000000000000
---XX-----------000000000000000000000000000000000000000000000000000000000000000000000000000000000000000000000000000000000000000000000000000000000000000000000000000
---XX-----------000000000000000000000000000000000000000000000000000000000000000000000000000000000000000000000000000000000000000000000000000000000000000000000000000
XXXX----------XX000000000000000000000000000000000000000000000000000000000000000000000000000000000000000000000000000000000000000000000000000000000000000000000000000
XXXX----------DX000000000000000000000000000000000000000000000000000000000000000000000000000000000000000000000000000000000000000000000000000000000000000000000000000
XXXX----------DX000000000000000000000000000000000000000000000000000000000000000000000000000000000000000000000000000000000000000000000000000000000000000000000000000
XXXX----XXXXXXXX000000000000000000000000000000000000000000000000000000000000000000000000000000000000000000000000000000000000000000000000000000000000000000000000000
---X-X----------000000000000000000000000000000000000000000000000000000000000000000000000000000000000000000000000000000000000000000000000000000000000000000000000000
---X------------000000000000000000000000000000000000000000000000000000000000000000000000000000000000000000000000000000000000000000000000000000000000000000000000000
XXX-----------XX000000000000000000000000000000000000000000000000000000000000000000000000000000000000000000000000000000000000000000000000000000000000000000000000000
XXXXXXXXXX----XX000000000000000000000000000000000000000000000000000000000000000000000000000000000000000000000000000000000000000000000000000000000000000000000000000
XX------------XX000000000000000000000000000000000000000000000000000000000000000000000000000000000000000000000000000000000000000000000000000000000000000000000000000
XD------------XX000000000000000000000000000000000000000000000000000000000000000000000000000000000000000000000000000000000000000000000000000000000000000000000000000
XD------------DX000000000000000000000000000000000000000000000000000000000000000000000000000000000000000000000000000000000000000000000000000000000000000000000000000
XXXXX-------XXXX000000000000000000000000000000000000000000000000000000000000000000000000000000000000000000000000000000000000000000000000000000000000000000000000000
XXXXXXXXXXXXXXXX000000000000000000000000000000000000000000000000000000000000000000000000000000000000000000000000000000000000000000000000000000000000000000000000000