0000000000000000000000000000000000000000000000000000----------------------------------------000000000000000
0000000000000000000000000000000000000000000000000000----------------------------------------000000000000000
0000000000000000000000000000000000000000000000000000----------------------------------------000000000000000
0000000000000000000000000000000000000000000000000000----------------------------------------000000000000000
0000000000000000000000000000000000000000000000000000----------------------------------------000000000000000
0000000000000000000000000000000000000000000000000000----------------------------------------000000000000000
0000000000000000000000000000000000000000000000000000----------------------------------------000000000000000
0000000000000000000000000000000000000000000000000000-----------------------------------?S---000000000000000
0000000000000000000000000000000000000000000000000000----------------------------------------000000000000000
0000000000000000000000000000000000000000000000000000----------------------------------------000000000000000
0000000000000000000000000000000000000000000000000000---------------------------------E------000000000000000
0000000000000000000000000000000000000000000000000000--------------------------------<>--Q---000000000000000
0000000000000000000000000000000000000000000000000000------------<>-----------E--X---[]-----X000000000000000
0000000000000000000000000000000000000000000000000000------------[]----<E----<>--XX--[]-----X000000000000000
0000000000000000000000000000000000000000000000000000------------[]----[>----[]--XXX-[]-----X000000000000000
000000000000000000000000000000000000-XX------------XXXXXXXXXXXXXXXXXXXX]XXXXXXXXXXXXXXXXXXXX000000000000000
000000000000000000000000000000000000XD------------XX0000000000000000000000000000000000000000000000000000000
000000000000000000000000000000000000XD------------XX0000000000000000000000000000000000000000000000000000000
000000000000000000000000000000000000XXTTTXXXX-----XX0000000000000000000000000000000000000000000000000000000
000000000000000000000000000000000000XX------------XX0000000000000000000000000000000000000000000000000000000
000000000000000000000000000000000000----------------0000000000000000000000000000000000000000000000000000000
000000000000000000000000000000000000---------TTTT---0000000000000000000000000000000000000000000000000000000
000000000000000000000000000000000000----------------0000000000000000000000000000000000000000000000000000000
000000000000000000000000000000000000------XXXX------0000000000000000000000000000000000000000000000000000000
000000000000000000000000000000000000----------------0000000000000000000000000000000000000000000000000000000
000000000000000000000000000000000000---TTTT---------0000000000000000000000000000000000000000000000000000000
000000000000000000000000000000000000XX--------------0000000000000000000000000000000000000000000000000000000
000000000000000000000000000000000000XX--------------0000000000000000000000000000000000000000000000000000000
000000000000000000000000000000000000XXXX--TTTT------0000000000000000000000000000000000000000000000000000000
000000000000000000000000000000000000XXXX------------0000000000000000000000000000000000000000000000000000000
000000000000000000000000000000000000XX-------------X0000000000000000000000000000000000000000000000000000000
000000000000000000000000000000000000XX----------TTTT0000000000000000000000000000000000000000000000000000000
000000000000000000000000000000000000XD-------------X0000000000000000000000000000000000000000000000000000000
000000000000000000000000000000000000XD-------------X0000000000000000000000000000000000000000000000000000000
000000000000000000000000000000000000XXXXXXXXXXX-----0000000000000000000000000000000000000000000000000000000
000000000000000000000000000000000000------X---------0000000000000000000000000000000000000000000000000000000
000000000000000000000000000000000000-----------X----0000000000000000000000000000000000000000000000000000000
000000000000000000000000000000000000----------------0000000000000000000000000000000000000000000000000000000
000000000000000000000000000000000000----------------0000000000000000000000000000000000000000000000000000000
000000000000000000000000000000000000-----TT--TT-----0000000000000000000000000000000000000000000000000000000
000000000000000000000000000000000000----------------0000000000000000000000000000000000000000000000000000000
000000000000000000000000000000000000----------------0000000000000000000000000000000000000000000000000000000
000000000000000000000000000000000000--------TTTT----0000000000000000000000000000000000000000000000000000000
000000000000000000000000000000000000----------------0000000000000000000000000000000000000000000000000000000
000000000000000000000000000000000000--TTTTTTTT------0000000000000000000000000000000000000000000000000000000
000000000000000000000000000000000000----------------0000000000000000000000000000000000000000000000000000000
000000000000000000000000000000000000----------------0000000000000000000000000000000000000000000000000000000
000000000000000000000000000000000000XX----------XXXX0000000000000000000000000000000000000000000000000000000
000000000000000000000000000000000000XX----------XXXX0000000000000000000000000000000000000000000000000000000
000000000000000000000000000000000000XXXXXXXX----XXXX0000000000000000000000000000000000000000000000000000000
000000000000000000000000000000000000XX-----------XXX0000000000000000000000000000000000000000000000000000000
000000000000000000000000000000000000XX----------TTTT0000000000000000000000000000000000000000000000000000000
000000000000000000000000000000000000XD-------------X0000000000000000000000000000000000000000000000000000000
000000000000000000000000000000000000XD-------------X0000000000000000000000000000000000000000000000000000000
000000000000000000000000000000000000XXXXXXXXXXX-----0000000000000000000000000000000000000000000000000000000
000000000000000000000000000000000000------T-XXXXXX-X0000000000000000000000000000000000000000000000000000000
000000000000000000000000000000000000----------------0000000000000000000000000000000000000000000000000000000
000000000000000000000000000000000000----------------0000000000000000000000000000000000000000000000000000000
000000000000000000000000000000000000-------TT-------0000000000000000000000000000000000000000000000000000000
000000000000000000000000000000000000----------------0000000000000000000000000000000000000000000000000000000
000000000000000000000000000000000000----------------0000000000000000000000000000000000000000000000000000000
000000000000000000000000000000000000--------TTTT----0000000000000000000000000000000000000000000000000000000
000000000000000000000000000000000000----------------0000000000000000000000000000000000000000000000000000000
000000000000000000000000000000000000----------------0000000000000000000000000000000000000000000000000000000
000000000000000000000000000000000000XX----------XXXX0000000000000000000000000000000000000000000000000000000
000000000000000000000000000000000000XX----TTXXXXXXXX0000000000000000000000000000000000000000000000000000000
000000000000000000000000000000000000XX--------------0000000000000000000000000000000000000000000000000000000
000000000000000000000000000000000000XX--------------0000000000000000000000000000000000000000000000000000000
000000000000000000000000000000000000XXXX--TTTT------0000000000000000000000000000000000000000000000000000000
000000000000000000000000000000000000XXXX------------0000000000000000000000000000000000000000000000000000000
000000000000000000000000000000000000XX-------------X0000000000000000000000000000000000000000000000000000000
000000000000000000000000000000000000XX----------TTTT0000000000000000000000000000000000000000000000000000000
000000000000000000000000000000000000XD-------------X0000000000000000000000000000000000000000000000000000000
000000000000000000000000000000000000XD-------------X0000000000000000000000000000000000000000000000000000000
0000000000000000--------------------XXXXXXXXXXX-----0000000000000000000000000000000000000000000000000000000
0000000000000000--------------------00000000000000000000000000000000000000000000000000000000000000000000000
0000000000000000--------------------00000000000000000000000000000000000000000000000000000000000000000000000
0000000000000000--------------------00000000000000000000000000000000000000000000000000000000000000000000000
0000000000000000--------------------00000000000000000000000000000000000000000000000000000000000000000000000
0000000000000000--------------------00000000000000000000000000000000000000000000000000000000000000000000000
0000000000000000--------------------00000000000000000000000000000000000000000000000000000000000000000000000
0000000000000000--------------------00000000000000000000000000000000000000000000000000000000000000000000000
0000000000000000-------------X------00000000000000000000000000000000000000000000000000000000000000000000000
0000000000000000--------------XX----00000000000000000000000000000000000000000000000000000000000000000000000
0000000000000000--------------------00000000000000000000000000000000000000000000000000000000000000000000000
0000000000000000--------------------00000000000000000000000000000000000000000000000000000000000000000000000
0000000000000000--------------------00000000000000000000000000000000000000000000000000000000000000000000000
0000000000000000--------------------00000000000000000000000000000000000000000000000000000000000000000000000
-XMMMMMMMMMMMMMM-----E-E------------00000000000000000000000000000000000000000000000000000000000000000000000
----------------XXXXXXXXXX-------XX-00000000000000000000000000000000000000000000000000000000000000000000000
----E--------E--0000000000000000000000000000000000000000000000000000000000000000000000000000000000000000000
MMMMMMMMMMMMMMMM0000000000000000000000000000000000000000000000000000000000000000000000000000000000000000000
----------------0000000000000000000000000000000000000000000000000000000000000000000000000000000000000000000
-X--------------0000000000000000000000000000000000000000000000000000000000000000000000000000000000000000000
XX----------XXXX0000000000000000000000000000000000000000000000000000000000000000000000000000000000000000000
XX--------------0000000000000000000000000000000000000000000000000000000000000000000000000000000000000000000
XX--------------0000000000000000000000000000000000000000000000000000000000000000000000000000000000000000000
XXXXMMMMMMMMMMMM0000000000000000000000000000000000000000000000000000000000000000000000000000000000000000000
XXXX------------0000000000000000000000000000000000000000000000000000000000000000000000000000000000000000000
XXXXXXXXX-------0000000000000000000000000000000000000000000000000000000000000000000000000000000000000000000
XXXX------------0000000000000000000000000000000000000000000000000000000000000000000000000000000000000000000
XXXXXXXXX-------0000000000000000000000000000000000000000000000000000000000000000000000000000000000000000000
XXXX------------0000000000000000000000000000000000000000000000000000000000000000000000000000000000000000000
XX-------------X0000000000000000000000000000000000000000000000000000000000000000000000000000000000000000000
XX----------TTTT0000000000000000000000000000000000000000000000000000000000000000000000000000000000000000000
XD-------------X0000000000000000000000000000000000000000000000000000000000000000000000000000000000000000000
XD-------------X0000000000000000000000000000000000000000000000000000000000000000000000000000000000000000000
XXXXXXXXXXX-----0000000000000000000000000000000000000000000000000000000000000000000000000000000000000000000
----------------0000000000000000000000000000000000000000000000000000000000000000000000000000000000000000000
XMMMMMMMMMMMMMMM0000000000000000000000000000000000000000000000000000000000000000000000000000000000000000000
----------------0000000000000000000000000000000000000000000000000000000000000000000000000000000000000000000
----E--------E--0000000000000000000000000000000000000000000000000000000000000000000000000000000000000000000
MMMMMMMMMMMMMMMM0000000000000000000000000000000000000000000000000000000000000000000000000000000000000000000
----------------0000000000000000000000000000000000000000000000000000000000000000000000000000000000000000000
----------------0000000000000000000000000000000000000000000000000000000000000000000000000000000000000000000
--------------XX0000000000000000000000000000000000000000000000000000000000000000000000000000000000000000000
-X------------XX0000000000000000000000000000000000000000000000000000000000000000000000000000000000000000000
XX----------XXXX0000000000000000000000000000000000000000000000000000000000000000000000000000000000000000000
XX----TTXXXXXXXX0000000000000000000000000000000000000000000000000000000000000000000000000000000000000000000
XX--------------0000000000000000000000000000000000000000000000000000000000000000000000000000000000000000000
XX--------------0000000000000000000000000000000000000000000000000000000000000000000000000000000000000000000
XXXX--TTTT------0000000000000000000000000000000000000000000000000000000000000000000000000000000000000000000
XXXX------------0000000000000000000000000000000000000000000000000000000000000000000000000000000000000000000
XX-------------X0000000000000000000000000000000000000000000000000000000000000000000000000000000000000000000
XX----------TTTT0000000000000000000000000000000000000000000000000000000000000000000000000000000000000000000
XD-------------X0000000000000000000000000000000000000000000000000000000000000000000000000000000000000000000
XD-------------X0000000000000000000000000000000000000000000000000000000000000000000000000000000000000000000
XXXXXXXXXXX-----0000000000000000000000000000000000000000000000000000000000000000000000000000000000000000000
-X--------------0000000000000000000000000000000000000000000000000000000000000000000000000000000000000000000
X--------------X0000000000000000000000000000000000000000000000000000000000000000000000000000000000000000000
X---XXXX-------X0000000000000000000000000000000000000000000000000000000000000000000000000000000000000000000
X---XXXX-------X0000000000000000000000000000000000000000000000000000000000000000000000000000000000000000000
----------------0000000000000000000000000000000000000000000000000000000000000000000000000000000000000000000
XMMMMMMMMMMMMMMX0000000000000000000000000000000000000000000000000000000000000000000000000000000000000000000
----------------0000000000000000000000000000000000000000000000000000000000000000000000000000000000000000000
----------------0000000000000000000000000000000000000000000000000000000000000000000000000000000000000000000
MMMMMMMMMMMMMMMM0000000000000000000000000000000000000000000000000000000000000000000000000000000000000000000
----------------0000000000000000000000000000000000000000000000000000000000000000000000000000000000000000000
----------------0000000000000000000000000000000000000000000000000000000000000000000000000000000000000000000
XXXX------------0000000000000000000000000000000000000000000000000000000000000000000000000000000000000000000
XXXX------------0000000000000000000000000000000000000000000000000000000000000000000000000000000000000000000
XXXX--TTTT------0000000000000000000000000000000000000000000000000000000000000000000000000000000000000000000
XXXX------------0000000000000000000000000000000000000000000000000000000000000000000000000000000000000000000
XX-------------X0000000000000000000000000000000000000000000000000000000000000000000000000000000000000000000
XX----------TTTT0000000000000000000000000000000000000000000000000000000000000000000000000000000000000000000
XD-------------X0000000000000000000000000000000000000000000000000000000000000000000000000000000000000000000
XD-------------X0000000000000000000000000000000000000000000000000000000000000000000000000000000000000000000
XXXXXXXXXXX-----0000000000000000000000000000000000000000000000000000000000000000000000000000000000000000000
----------------0000000000000000000000000000000000000000000000000000000000000000000000000000000000000000000
----E--------E--0000000000000000000000000000000000000000000000000000000000000000000000000000000000000000000
MMMMMMMMMMMMMMMM0000000000000000000000000000000000000000000000000000000000000000000000000000000000000000000
----------------0000000000000000000000000000000000000000000000000000000000000000000000000000000000000000000
----------------0000000000000000000000000000000000000000000000000000000000000000000000000000000000000000000
MMMMMMMMM-MMMMMM0000000000000000000000000000000000000000000000000000000000000000000000000000000000000000000
----------------0000000000000000000000000000000000000000000000000000000000000000000000000000000000000000000
----------------0000000000000000000000000000000000000000000000000000000000000000000000000000000000000000000
------------X---0000000000000000000000000000000000000000000000000000000000000000000000000000000000000000000
------------XXXX0000000000000000000000000000000000000000000000000000000000000000000000000000000000000000000
------------XXXX0000000000000000000000000000000000000000000000000000000000000000000000000000000000000000000
------------XX--0000000000000000000000000000000000000000000000000000000000000000000000000000000000000000000
-XXXX-------XXXX0000000000000000000000000000000000000000000000000000000000000000000000000000000000000000000
XX----------XXXX0000000000000000000000000000000000000000000000000000000000000000000000000000000000000000000
XXXXXXXX----XXXX0000000000000000000000000000000000000000000000000000000000000000000000000000000000000000000
XX-----------XXX0000000000000000000000000000000000000000000000000000000000000000000000000000000000000000000
XX----------TTTT0000000000000000000000000000000000000000000000000000000000000000000000000000000000000000000
XD-------------X0000000000000000000000000000000000000000000000000000000000000000000000000000000000000000000
XD-------------X0000000000000000000000000000000000000000000000000000000000000000000000000000000000000000000
XXXXXXXXXXX-----0000000000000000000000000000000000000000000000000000000000000000000000000000000000000000000