0000000000000000000000XXXX------XXXX--
0000000000000000000000XXXX------XXXX--
0000000000000000000000XXXX------XXXX--
0000000000000000000000XXXX------XXXX--
0000000000000000000000XXXX------XXXX--
0000000000000000000000XXXX------XXXX--
0000000000000000000000XXXX------XXXX--
0000000000000000000000XXXX------XXXX--
0000000000000000000000XXXX------XXXX--
0000000000000000000000XXXX------XXXX--
0000000000000000000000XXXX------XXXX--
0000000000000000000000XXXX------XXXX--
0000000000000000000000XXXX------XXXX--
0000000000000000000000XXXX------XXXX--
0000000000000000000000XXXX------XXXX--
0000000000000000000000XXXX------XXXX--
0000000000000000000000XXXX------XXXX--
0000000000000000000000XXXX------XXXX--
0000000000000000000000XXXX------XXXX--
0000000000000000000000XXXX------XXXX--
0000000000000000000000XXXX------XXXX--
0000000000000000000000XXXX------XXXX--
0000000000000000000000XXXX------XXXX--
0000000000000000000000XXXX------XXXX--
0000000000000000000000XXXX------XXXX--
0000000000000000000000XXXX------XXXX--
0000000000000000000000XXXX------XXXX--
0000000000000000000000XXXX------XXXX--
0000000000000000000000XXXX------XXXX--
0000000000000000000000XXXX------XXXX--
0000000000000000000000XXXX------XXXX--
0000000000000000000000XXXX------XXXX--
0000000000000000000000XXXX------XXXX--
0000000000000000000000XXXX------XXXX--
0000000000000000000000XXXX------XXXX--
0000000000000000000000XXXX------XXXX--
0000000000000000000000XXXX------XXXX--
0000000000000000000000XXXX------XXXX--
0000000000000000000000XXXX------XXXX--
0000000000000000000000XXXX------XXXX--
0000000000000000000000XXXX------XXXX--
0000000000000000000000XXXX------XXXX--
0000000000000000000000XXXX------XXXX--
0000000000000000000000XXXX------XXXX--
0000000000000000000000XXXX------XXXX--
0000000000000000000000XXXX------XXXX--
0000000000000000000000XXXX------XXXX--
0000000000000000000000XXXX------XXXX--
0000000000000000000000XXXX------XXXX--
0000000000000000000000XXXX------XXXX--
0000000000000000000000XXXX------XXXX--
0000000000000000000000XXXX------XXXX--
0000000000000000000000XXXX------XXXX--
0000000000000000000000XXXX------XXXX--
0000000000000000000000XXXX------XXXX--
0000000000000000000000XXXX------XXXX--
0000000000000000000000XXXX------XXXX--
0000000000000000000000XXXX------XXXX--
0000000000000000000000XXXX------XXXX--
0000000000000000000000XXXX------XXXX--
0000000000000000000000XXXX------XXXX--
0000000000000000000000XXXX------XXXX--
0000000000000000000000XXXX------XXXX--
0000000000000000000000XXXX------XXXX--
0000000000000000000000XXXX------XXXX--
0000000000000000000000XXXX------XXXX--
0000000000000000000000XXXX------XXXX--
0000000000000000000000XXXX------XXXX--
0000000000000000000000XXXX------XXXX--
0000000000000000000000XXXX------XXXX--
0000000000000000000000XXXX------XXXX--
0000000000000000000000XXXX------XXXX--
0000000000000000000000XXXX------XXXX--
0000000000000000000000XXXX------XXXX--
0000000000000000000000XXXX------XXXX--
0000000000000000000000XXXX------XXXX--
0000000000000000000000XXXX------XXXX--
0000000000000000000000XXXX------XXXX--
0000000000000000000000XXXX------XXXX--
0000000000000000000000XXXX------XXXX--
0000000000000000000000XXXX------XXXX--
0000000000000000000000XXXX------XXXX--
0000000000000000000000XXXX------XXXX--
0000000000000000000000XXXX------XXXX--
0000000000000000000000XXXX------XXXX--
0000000000000000000000XXXX------XXXX--
0000000000000000000000XXXX------XXXX--
0000000000000000000000XXXX------XXXX--
0000000000000000000000XXXX------XXXX--
0000000000000000000000XXXX------XXXX--
0000000000000000000000XXXX------XXXX--
0000000000000000000000XXXX------XXXX--
0000000000000000000000XXXX------XXXX--
0000000000000000000000XXXX------XXXX--
0000000000000000000000XXXX------XXXX--
0000000000000000000000XXXX------XXXX--
0000000000000000000000XXXX------XXXX--
0000000000000000000000XXXX------XXXX--
0000000000000000000000XXXX------XXXX--
0000000000000000000000XXXX------XXXX--
0000000000000000000000XXXX------XXXX--
0000000000000000000000XXXX------XXXX--
0000000000000000000000XXXX------XXXX--
0000000000000000000000XXXX------XXXX--
0000000000000000000000XXXX------XXXX--
0000000000000000000000XXXX------XXXX--
0000000000000000000000XXXX------XXXX--
0000000000000000000000XXXX------XXXX--
0000000000000000000000XXXX----E-XXXX--
0000000000000000000000XXXX------XXXX--
0000000000000000000000XXXX------XXXX--
0000000000000000000000XXXX------XXXX--
0000000000000000000000XXXX------XXXX--
0000000000000000000000XXXX------XXXX--
0000000000000000000000XXXX------XXXX--
0000000000000000000000XXXX------XXXX--
0000000000000000000000XXXX------XXXX--
0000000000000000000000XXXX------XXXX--
0000000000000000000000XXXXE-EXXXXXXX--
0000000000000000000000XXXX------XXXX--
0000000000000000000000XX-----------XXX
0000000000000000000000XX--TT-------XXX
0000000000000000000000XX-----------XXX
0000000000000000000000XX-----------XXX
0000000000000000000000-XXXXXXXE--XXXX-
0000000000000000000000-XXXX------XXXX-
0000000000000000000000-XXXX------XXXX-
0000000000000000000000-XXXX----EXXXXX-
0000000000000000000000XD----------XXXX
0000000000000000000000XD----------XXXX
0000000000000000000000XXXXXXXXE---XXXX
0000000000000000000000XXXX------XXXXXX
0000000000000000000000XXXX------XXXX--
0000000000000000000000XXXXE-EXXXXXXX--
0000000000000000000000XXXX------XXXX--
0000000000000000000000XX-----------XXX
0000000000000000000000XX--TT-------XXX
0000000000000000000000XX-----------XXX
0000000000000000000000XX-----------XXX
0000000000000000000000-XXXXXXXE--XXXX-
0000000000000000000000-XXXX------XXXX-
0000000000000000000000-XXXX------XXXX-
0000000000000000000000-XXXX----EXXXXX-
0000000000000000000000XX----------XXXX
0000000000000000000000XX----------XXXX
0000000000000000000000XXXXXXXXE---XXXX
0000000000000000000000XXXXXXXXXXX-----
0000000000000000000000XXXX------------
0000000000000000000000XXXX------------
0000000000000000000000XXXXXXXXXXXX----
0000000000000000000000XXXXXXXXXXXXXXXX
0000000000000000000000XXXX----------XX
0000000000000000000000XX------------XX
0000000000000000000000XX-----------XXX
0000000000000000000000XXXXXXXXXXXXXXXX
0000000000000000000000XXXX-----------X
0000000000000000000000XX-------------X
0000000000000000000000XX-------------X
0000000000000000000000XX------XXXXXXXX
0000000000000000000000XXXX--------XXXX
0000000000000000000000XXXX--------XXXX
0000000000000000000000XXTTTT------XXXX
0000000000000000000000XXXX--------XXXX
0000000000000000000000XXXX--------XXXX
0000000000000000000000XXXX--------XXXX
0000000000000000000000XXXX--------XXXX
0000000000000000000000XXXX--------XXXX
0000000000000000000000XXXX--------XXXX
0000000000000000000000XXXX--------XXXX
0000000000000000000000XXXX--------XXXX
0000000000000000000000XXXX--------XXXX
0000000000000000000000XXXX--------XXXX
0000000000000000000000XXXX--------XXXX
0000000000000000000000XXXX--------XXXX
0000000000000000000000XXXX--------XXXX
0000000000000000000000XXTTTT------XXXX
0000000000000000000000XXXX--------XXXX
0000000000000000000000XXXX--------XXXX
0000000000000000000000XXXX--------XXXX
0000000000000000000000XXXX--------XXXX
0000000000000000000000XXXX--------XXXX
0000000000000000000000XXXX--------XXXX
0000000000000000000000XXXX--------XXXX
0000000000000000000000XXXX--------XXXX
0000000000000000000000XXXX---------XXX
0000000000000000000000----------------
0000000000000000000000--------TTTT----
0000000000000000000000----------------
0000000000000000--------TTTTTTTT------
0000000000000000------0000000000000000
0000000000000000------0000000000000000
0000000000000000------0000000000000000
0000000000000000------0000000000000000
0000000000000000------0000000000000000
0000000000000000------0000000000000000
0000000000000000------0000000000000000
0000000000000000------0000000000000000
0000000000000000------0000000000000000
0000000000000000------0000000000000000
0000000000000000------0000000000000000
0000000000000000--X---0000000000000000
XXXX------------X-X---0000000000000000
XD-------------XXXX---0000000000000000
XD-------------XXXX---0000000000000000
XXXXX---XXXXXXXX0000000000000000000000
XXXXXXXXXXXXXXXX0000000000000000000000