000000000000000000000000000000000000000000000000000000000000000000000000000000000000000000000000000000000000----------------------------------------000000000000000
000000000000000000000000000000000000000000000000000000000000000000000000000000000000000000000000000000000000----------------------------------------000000000000000
000000000000000000000000000000000000000000000000000000000000000000000000000000000000000000000000000000000000----------------------------------------000000000000000
000000000000000000000000000000000000000000000000000000000000000000000000000000000000000000000000000000000000----------------------------------------000000000000000
000000000000000000000000000000000000000000000000000000000000000000000000000000000000000000000000000000000000----------------------------------------000000000000000
000000000000000000000000000000000000000000000000000000000000000000000000000000000000000000000000000000000000----------------------------------------000000000000000
000000000000000000000000000000000000000000000000000000000000000000000000000000000000000000000000000000000000----------------------------------------000000000000000
000000000000000000000000000000000000000000000000000000000000000000000000000000000000000000000000000000000000----------------------------------------000000000000000
000000000000000000000000000000000000000000000000000000000000000000000000000000000000000000000000000000000000----------------------------------------000000000000000
000000000000000000000000000000000000000000000000000000000000000000000000000000000000000000000000000000000000----------------------------------------000000000000000
000000000000000000000000000000000000000000000000000000000000000000000000000000000000000000000000000000000000----------------------------------E-----000000000000000
000000000000000000000000000000000000000000000000000000000000000000000000000000000000000000000000000000000000------------------------S--------<>-----000000000000000
000000000000000000000000000000000000000000000000000000000000000000000000000000000000000000000000000000000000---------------------------------[]-----000000000000000
000000000000000000000000000000000000000000000000000000000000000000000000000000000000000000000000000000000000---------------------------------[]-----000000000000000
00000000000000000000000000000000000000000000000000000000000000000000000000000000000000000000-------------------------------------------E-E---[]-----000000000000000
00000000000000000000000000000000000000000000000000000000000000000000000000000000000000000000----------------XX---XXXXXXXXXXXXXX-XXXXXXXXXXXXXXXXXXX-000000000000000
00000000000000000000000000000000000000000000000000000000000000000000000000000000000000000000---XXXX---------0000000000000000000000000000000000000000000000000000000
00000000000000000000000000000000000000000000000000000000000000000000000000000000000000000000----------TT----0000000000000000000000000000000000000000000000000000000
00000000000000000000000000000000000000000000000000000000000000000000000000000000000000000000---------------X0000000000000000000000000000000000000000000000000000000
00000000000000000000000000000000000000000000000000000000000000000000000000000000000000000000--------------D-0000000000000000000000000000000000000000000000000000000
00000000000000000000000000000000000000000000000000000000000000000000000000000000000000000000XXXX----XXXXXXXX0000000000000000000000000000000000000000000000000000000
00000000000000000000000000000000000000000000000000000000000000000000000000000000000000000000XXXX--------XXXX0000000000000000000000000000000000000000000000000000000
00000000000000000000000000000000000000000000000000000000000000000000000000000000000000000000XXXX--------XXXX0000000000000000000000000000000000000000000000000000000
00000000000000000000000000000000000000000000000000000000000000000000000000000000000000000000XXXX--------XXXX0000000000000000000000000000000000000000000000000000000
00000000000000000000000000000000000000000000000000000000000000000000000000000000000000000000XXXX--------XXXX0000000000000000000000000000000000000000000000000000000
00000000000000000000000000000000000000000000000000000000000000000000000000000000000000000000XX----TTTTTTTTXX0000000000000000000000000000000000000000000000000000000
00000000000000000000000000000000000000000000000000000000000000000000000000000000000000000000XX------------XX0000000000000000000000000000000000000000000000000000000
00000000000000000000000000000000000000000000000000000000000000000000000000000000000000000000XX------------XX0000000000000000000000000000000000000000000000000000000
00000000000000000000000000000000000000000000000000000000000000000000000000000000000000000000XX----XXXXX---XX0000000000000000000000000000000000000000000000000000000
00000000000000000000000000000000000000000000000000000000000000000000000000000000000000000000XX------------XX0000000000000000000000000000000000000000000000000000000
00000000000000000000000000000000000000000000000000000000000000000000000000000000000000000000XD------------XX0000000000000000000000000000000000000000000000000000000
00000000000000000000000000000000000000000000000000000000000000000000000000000000000000000000XD------------XX0000000000000000000000000000000000000000000000000000000
00000000000000000000000000000000000000000000000000000000000000000000000000000000000000000000XXXXX-------XXXX0000000000000000000000000000000000000000000000000000000
000000000000000000000000000000000000000000000000000000000000000000000000--------------------XXXXXXXXXXXXXXXX0000000000000000000000000000000000000000000000000000000
000000000000000000000000000000000000000000000000000000000000000000000000--------------------00000000000000000000000000000000000000000000000000000000000000000000000
000000000000000000000000000000000000000000000000000000000000000000000000--------------------00000000000000000000000000000000000000000000000000000000000000000000000
000000000000000000000000000000000000000000000000000000000000000000000000--------------------00000000000000000000000000000000000000000000000000000000000000000000000
000000000000000000000000000000000000000000000000000000000000000000000000--------------------00000000000000000000000000000000000000000000000000000000000000000000000
000000000000000000000000000000000000000000000000000000000000000000000000--------------------00000000000000000000000000000000000000000000000000000000000000000000000
000000000000000000000000000000000000000000000000000000000000000000000000--------------------00000000000000000000000000000000000000000000000000000000000000000000000
000000000000000000000000000000000000000000000000000000000000000000000000--------------------00000000000000000000000000000000000000000000000000000000000000000000000
000000000000000000000000000000000000000000000000000000000000000000000000--------------------00000000000000000000000000000000000000000000000000000000000000000000000
000000000000000000000000000000000000000000000000000000000000000000000000--------------------00000000000000000000000000000000000000000000000000000000000000000000000
000000000000000000000000000000000000000000000000000000000000000000000000--------------------00000000000000000000000000000000000000000000000000000000000000000000000
000000000000000000000000000000000000000000000000000000000000000000000000-------------E------00000000000000000000000000000000000000000000000000000000000000000000000
000000000000000000000000000000000000000000000000000000000000000000000000------------<>------00000000000000000000000000000000000000000000000000000000000000000000000
000000000000000000000000000000000000000000000000000000000000000000000000------------[]------00000000000000000000000000000000000000000000000000000000000000000000000
000000000000000000000000000000000000000000000000000000000000000000000000----E-------[]----X-00000000000000000000000000000000000000000000000000000000000000000000000
00000000000000000000000000000000000000000000000000000000-XXXX----------XXXXXXXX-XXXXXXXXXXX-00000000000000000000000000000000000000000000000000000000000000000000000
00000000000000000000000000000000000000000000000000000000XXXXXXXX------XX0000000000000000000000000000000000000000000000000000000000000000000000000000000000000000000
00000000000000000000000000000000000000000000000000000000XXXX----------XX0000000000000000000000000000000000000000000000000000000000000000000000000000000000000000000
00000000000000000000000000000000000000000000000000000000XX------------XX0000000000000000000000000000000000000000000000000000000000000000000000000000000000000000000
00000000000000000000000000000000000000000000000000000000XX--------TTTTXX0000000000000000000000000000000000000000000000000000000000000000000000000000000000000000000
00000000000000000000000000000000000000000000000000000000XX------------XX0000000000000000000000000000000000000000000000000000000000000000000000000000000000000000000
00000000000000000000000000000000000000000000000000000000XX------------XX0000000000000000000000000000000000000000000000000000000000000000000000000000000000000000000
00000000000000000000000000000000000000000000000000000000XXXX--------XXXX0000000000000000000000000000000000000000000000000000000000000000000000000000000000000000000
00000000000000000000000000000000000000000000000000000000XXXX--------XXXX0000000000000000000000000000000000000000000000000000000000000000000000000000000000000000000
00000000000000000000000000000000000000000000000000000000XXXX--------XXXX0000000000000000000000000000000000000000000000000000000000000000000000000000000000000000000
00000000000000000000000000000000000000000000000000000000XXXX--------XXXX0000000000000000000000000000000000000000000000000000000000000000000000000000000000000000000
00000000000000000000000000000000000000000000000000000000XX----TTTTTTTTXX0000000000000000000000000000000000000000000000000000000000000000000000000000000000000000000
00000000000000000000000000000000000000000000000000000000XX------------XX0000000000000000000000000000000000000000000000000000000000000000000000000000000000000000000
00000000000000000000000000000000000000000000000000000000XX------------XX0000000000000000000000000000000000000000000000000000000000000000000000000000000000000000000
00000000000000000000000000000000000000000000000000000000XXXXXXXX------XX0000000000000000000000000000000000000000000000000000000000000000000000000000000000000000000
00000000000000000000000000000000000000000000000000000000XX----XXXXX---XX0000000000000000000000000000000000000000000000000000000000000000000000000000000000000000000
00000000000000000000000000000000000000000000000000000000XD------------XX0000000000000000000000000000000000000000000000000000000000000000000000000000000000000000000
00000000000000000000000000000000000000000000000000000000XD------------XX0000000000000000000000000000000000000000000000000000000000000000000000000000000000000000000
00000000000000000000000000000000000000000000000000000000XXXXX-------XXXX0000000000000000000000000000000000000000000000000000000000000000000000000000000000000000000
00000000000000000000000000000000000000000000000000000000XXXXXXXXXXXXXXXX0000000000000000000000000000000000000000000000000000000000000000000000000000000000000000000
00000000000000000000000000000000000000000000000000000000----------------0000000000000000000000000000000000000000000000000000000000000000000000000000000000000000000
00000000000000000000000000000000000000000000000000000000-------------X--0000000000000000000000000000000000000000000000000000000000000000000000000000000000000000000
00000000000000000000000000000000000000000000000000000000----------------0000000000000000000000000000000000000000000000000000000000000000000000000000000000000000000
00000000000000000000000000000000000000000000000000000000---------TTT----0000000000000000000000000000000000000000000000000000000000000000000000000000000000000000000
00000000000000000000000000000000000000000000000000000000----------------0000000000000000000000000000000000000000000000000000000000000000000000000000000000000000000
00000000000000000000000000000000000000000000000000000000X-----------TTTT0000000000000000000000000000000000000000000000000000000000000000000000000000000000000000000
00000000000000000000000000000000000000000000000000000000X--------------X0000000000000000000000000000000000000000000000000000000000000000000000000000000000000000000
00000000000000000000000000000000000000000000000000000000X--------------X0000000000000000000000000000000000000000000000000000000000000000000000000000000000000000000
00000000000000000000000000000000000000000000000000000000XXXXXXXXXXX----X0000000000000000000000000000000000000000000000000000000000000000000000000000000000000000000
00000000000000000000000000000000000000000000000000000000TTTTTTTT-------X0000000000000000000000000000000000000000000000000000000000000000000000000000000000000000000
00000000000000000000000000000000000000000000000000000000---------------X0000000000000000000000000000000000000000000000000000000000000000000000000000000000000000000
00000000000000000000000000000000000000000000000000000000------------XXXX0000000000000000000000000000000000000000000000000000000000000000000000000000000000000000000
00000000000000000000000000000000000000000000000000000000XXXXX-------XXXX0000000000000000000000000000000000000000000000000000000000000000000000000000000000000000000
00000000000000000000000000000000000000000000000000000000XXXXXXXXXXXXXXXX0000000000000000000000000000000000000000000000000000000000000000000000000000000000000000000
00000000000000000000000000000000000000000000000000000000XX----XXXXX-X-XX0000000000000000000000000000000000000000000000000000000000000000000000000000000000000000000
00000000000000000000000000000000000000000000000000000000XX------------XX0000000000000000000000000000000000000000000000000000000000000000000000000000000000000000000
00000000000000000000000000000000000000000000000000000000XD------------XX0000000000000000000000000000000000000000000000000000000000000000000000000000000000000000000
00000000000000000000000000000000000000000000000000000000XD------------XX0000000000000000000000000000000000000000000000000000000000000000000000000000000000000000000
00000000000000000000000000000000000000000000000000000000XXXXX-------XXXX0000000000000000000000000000000000000000000000000000000000000000000000000000000000000000000
00000000000000000000000000000000000000000000000000000000XXXXXXXXXXXXXXXX0000000000000000000000000000000000000000000000000000000000000000000000000000000000000000000
00000000000000000000000000000000000000000000000000000000-XXXX--------XXX0000000000000000000000000000000000000000000000000000000000000000000000000000000000000000000
00000000000000000000000000000000000000000000000000000000XXXX--------XXXX0000000000000000000000000000000000000000000000000000000000000000000000000000000000000000000
00000000000000000000000000000000000000000000000000000000XX----TTTTTTTTXX0000000000000000000000000000000000000000000000000000000000000000000000000000000000000000000
00000000000000000000000000000000000000000000000000000000XX------------XX0000000000000000000000000000000000000000000000000000000000000000000000000000000000000000000
000000000000000000000000000000000000--------------------XX------------XX0000000000000000000000000000000000000000000000000000000000000000000000000000000000000000000
000000000000000000000000000000000000--------------------XXXX--------XXXX0000000000000000000000000000000000000000000000000000000000000000000000000000000000000000000
000000000000000000000000000000000000--------------------XXXX--------XXXX0000000000000000000000000000000000000000000000000000000000000000000000000000000000000000000
000000000000000000000000000000000000--------------------XXXX--------XXXX0000000000000000000000000000000000000000000000000000000000000000000000000000000000000000000
000000000000000000000000000000000000--------------------XXXX--------XXXX0000000000000000000000000000000000000000000000000000000000000000000000000000000000000000000
000000000000000000000000000000000000--------------------XXXX--------XXXX0000000000000000000000000000000000000000000000000000000000000000000000000000000000000000000
000000000000000000000000000000000000---------------E----XXXX--------XXXX0000000000000000000000000000000000000000000000000000000000000000000000000000000000000000000
000000000000000000000000000000000000--------------->----XX----TTTTTTTTXX0000000000000000000000000000000000000000000000000000000000000000000000000000000000000000000
000000000000000000000000000000000000--------------<]----XX------------XX0000000000000000000000000000000000000000000000000000000000000000000000000000000000000000000
000000000000000000000000000000000000--------------[]----XX------------XX0000000000000000000000000000000000000000000000000000000000000000000000000000000000000000000
000000000000000000000000000000000000--------------[]----XXXXXX--------XX0000000000000000000000000000000000000000000000000000000000000000000000000000000000000000000
000000000000000000000000000000000000--------------XXX---XX----XXXXX---XX0000000000000000000000000000000000000000000000000000000000000000000000000000000000000000000
000000000000000000000000000000000000--------------------XD------------XX0000000000000000000000000000000000000000000000000000000000000000000000000000000000000000000
000000000000000000000000000000000000--------------------XD------------XX0000000000000000000000000000000000000000000000000000000000000000000000000000000000000000000
000000000000000000000000000000000000-------E-E-E--------XXXXX-------XXXX0000000000000000000000000000000000000000000000000000000000000000000000000000000000000000000
00000000000000000000--------------XXXXXXXXXXXXXXXXXXXXXXXXXXXXXXXXXXXXXX0000000000000000000000000000000000000000000000000000000000000000000000000000000000000000000
00000000000000000000-----------T-XXX0000000000000000000000000000000000000000000000000000000000000000000000000000000000000000000000000000000000000000000000000000000
00000000000000000000-------XEEEEEEXX0000000000000000000000000000000000000000000000000000000000000000000000000000000000000000000000000000000000000000000000000000000
00000000000000000000-----T-XXXXXX-X-0000000000000000000000000000000000000000000000000000000000000000000000000000000000000000000000000000000000000000000000000000000
00000000000000000000----------------0000000000000000000000000000000000000000000000000000000000000000000000000000000000000000000000000000000000000000000000000000000
00000000000000000000----------------0000000000000000000000000000000000000000000000000000000000000000000000000000000000000000000000000000000000000000000000000000000
00000000000000000000----XXXX--------0000000000000000000000000000000000000000000000000000000000000000000000000000000000000000000000000000000000000000000000000000000
00000000000000000000----------------0000000000000000000000000000000000000000000000000000000000000000000000000000000000000000000000000000000000000000000000000000000
00000000000000000000XXXX----------XX0000000000000000000000000000000000000000000000000000000000000000000000000000000000000000000000000000000000000000000000000000000
00000000000000000000XXXX----------XX0000000000000000000000000000000000000000000000000000000000000000000000000000000000000000000000000000000000000000000000000000000
00000000000000000000XXXX----------XX0000000000000000000000000000000000000000000000000000000000000000000000000000000000000000000000000000000000000000000000000000000
00000000000000000000XX------------XX0000000000000000000000000000000000000000000000000000000000000000000000000000000000000000000000000000000000000000000000000000000
00000000000000000000XX--------TTTTXX0000000000000000000000000000000000000000000000000000000000000000000000000000000000000000000000000000000000000000000000000000000
00000000000000000000XX------------XX0000000000000000000000000000000000000000000000000000000000000000000000000000000000000000000000000000000000000000000000000000000
00000000000000000000XX------------XX0000000000000000000000000000000000000000000000000000000000000000000000000000000000000000000000000000000000000000000000000000000
00000000000000000000XX----XXXX----XX0000000000000000000000000000000000000000000000000000000000000000000000000000000000000000000000000000000000000000000000000000000
00000000000000000000XD------------XX0000000000000000000000000000000000000000000000000000000000000000000000000000000000000000000000000000000000000000000000000000000
00000000000000000000XD------------XX0000000000000000000000000000000000000000000000000000000000000000000000000000000000000000000000000000000000000000000000000000000
00000000000000000000XXXXX-------XXXX0000000000000000000000000000000000000000000000000000000000000000000000000000000000000000000000000000000000000000000000000000000
--------------------XXXXXXXXXXXXXXXX0000000000000000000000000000000000000000000000000000000000000000000000000000000000000000000000000000000000000000000000000000000
--------------------00000000000000000000000000000000000000000000000000000000000000000000000000000000000000000000000000000000000000000000000000000000000000000000000
--------------------00000000000000000000000000000000000000000000000000000000000000000000000000000000000000000000000000000000000000000000000000000000000000000000000
--------------------00000000000000000000000000000000000000000000000000000000000000000000000000000000000000000000000000000000000000000000000000000000000000000000000
--------------------00000000000000000000000000000000000000000000000000000000000000000000000000000000000000000000000000000000000000000000000000000000000000000000000
--------------------00000000000000000000000000000000000000000000000000000000000000000000000000000000000000000000000000000000000000000000000000000000000000000000000
--------------------00000000000000000000000000000000000000000000000000000000000000000000000000000000000000000000000000000000000000000000000000000000000000000000000
--------------E-----00000000000000000000000000000000000000000000000000000000000000000000000000000000000000000000000000000000000000000000000000000000000000000000000
-------------<>-----00000000000000000000000000000000000000000000000000000000000000000000000000000000000000000000000000000000000000000000000000000000000000000000000
-------------[]-----00000000000000000000000000000000000000000000000000000000000000000000000000000000000000000000000000000000000000000000000000000000000000000000000
-------------[]-----00000000000000000000000000000000000000000000000000000000000000000000000000000000000000000000000000000000000000000000000000000000000000000000000
-------------XXX----00000000000000000000000000000000000000000000000000000000000000000000000000000000000000000000000000000000000000000000000000000000000000000000000
------------------X-00000000000000000000000000000000000000000000000000000000000000000000000000000000000000000000000000000000000000000000000000000000000000000000000
--------------------00000000000000000000000000000000000000000000000000000000000000000000000000000000000000000000000000000000000000000000000000000000000000000000000
---EE---------------00000000000000000000000000000000000000000000000000000000000000000000000000000000000000000000000000000000000000000000000000000000000000000000000
XXXXXXXXXX-X-XXX----00000000000000000000000000000000000000000000000000000000000000000000000000000000000000000000000000000000000000000000000000000000000000000000000
0000000000000000000000000000000000000000000000000000000000000000000000000000000000000000000000000000000000000000000000000000000000000000000000000000000000000000000