0000000000000000000000000000000000000000000000000000000000000000000000000000000000000000000000000000000000000000000000000000000000000000000000000000000000000000000000000000---E---E--------
0000000000000000000000000000000000000000000000000000000000000000000000000000000000000000000000000000000000000000000000000000000000000000000000000000000000000000000000000000MMMMMMMMMMMMMMMM
0000000000000000000000000000000000000000000000000000000000000000000000000000000000000000000000000000000000000000000000000000000000000000000000000000000000000000000000000000----------------
0000000000000000000000000000000000000000000000000000000000000000000000000000000000000000000000000000000000000000000000000000000000000000000000000000000000000000000000000000----------------
0000000000000000000000000000000000000000000000000000000000000000000000000000000000000000000000000000000000000000------------------------------------------------------------XXXX------------
0000000000000000000000000000000000000000000000000000000000000000000000000000000000000000000000000000000000000000----------------------------------------------------------------------------
0000000000000000000000000000000000000000000000000000000000000000000000000000000000000000000000000000000000000000-----------------------------------------------------------------TTTT-------
0000000000000000000000000000000000000000000000000000000000000000000000000000000000000000000000000000000000000000----------------------------------------------------------------------------
0000000000000000000000000000000000000000000000000000000000000000000000000000000000000000000000000000000000000000------------------------------------------------------------XXXX--------XXXX
0000000000000000000000000000000000000000000000000000000000000000000000000000000000000000000000000000000000000000------------------------------------------------------------XXXX--------XXXX
0000000000000000000000000000000000000000000000000000000000000000000000000000000000000000000000000000000000000000------------------------------------------------------------XXXXXXX-----XXXX
0000000000000000000000000000000000000000000000000000000000000000000000000000000000000000000000000000000000000000------S-----------------------------------------------------XXXX--------XXXX
0000000000000000000000000000000000000000000000000000000000000000000000000000000000000000000000000000000000000000------------------------------------------------------------XX------------XX
0000000000000000000000000000000000000000000000000000000000000000000000000000000000000000000000000000000000000000------------------------------------------------------------XX------XXXX--XX
0000000000000000000000000000000000000000000000000000000000000000000000000000000000000000000000000000000000000000---------------------------------------------------------X--XX------XXXXXXXX
0000000000000000000000000000000000000000000000000000000000000000000000000000000000000000000000000000000000000000------S-------------------------------------------------XX--XX-----------XXX
0000000000000000000000000000000000000000000000000000000000000000000000000000000000000000000000000000000000000000-------------------------------------------------------XXX--XD-----------XXX
0000000000000000000000000000000000000000000000000000000000000000000000000000000000000000000000000000000000000000------------------------------------------------------XXXX--XD-----------XXX
0000000000000000000000000000000000000000000000000000000000000000000000000000000000000000000000000000000000000000-----------------X-----------XX--------------------EEXXXXX--XXXXXXXXXXXXXXXX
000000000000000000000000000000000000000000000000000000000000000000000000000000000000000000000000XXXX--------XXXXXXXXXXXXXXXXXXXXXXXXXXXXXXXXXXXXXXXXXXXXXXXXXXXXXXXXXXXXXXXXXXXXXXXXXXXXXXXX
000000000000000000000000000000000000000000000000000000000000000000000000000000000000000000000000XX----TTTTTTTTXX0000000000000000000000000000000000000000000000000000000000000000000000000000
000000000000000000000000000000000000000000000000000000000000000000000000000000000000000000000000XX------------XX0000000000000000000000000000000000000000000000000000000000000000000000000000
000000000000000000000000000000000000000000000000000000000000000000000000000000000000000000000000XX------------XX0000000000000000000000000000000000000000000000000000000000000000000000000000
000000000000000000000000000000000000------------------------------------------------------------XXXXXXXX------XX0000000000000000000000000000000000000000000000000000000000000000000000000000
000000000000000000000000000000000000------------------------------------------------------------XX------------XX0000000000000000000000000000000000000000000000000000000000000000000000000000
000000000000000000000000000000000000------------------------------------------------------------XX--TT--------XX0000000000000000000000000000000000000000000000000000000000000000000000000000
000000000000000000000000000000000000------------------------------------------------------------XX------------DX0000000000000000000000000000000000000000000000000000000000000000000000000000
000000000000000000000000000000000000------------------------------------------------------------XX---------XXXXX0000000000000000000000000000000000000000000000000000000000000000000000000000
000000000000000000000000000000000000------------------------------------------------------------XX------XXXXXXXX0000000000000000000000000000000000000000000000000000000000000000000000000000
000000000000000000000000000000000000------------------------------------------------------------XX----------XXXX0000000000000000000000000000000000000000000000000000000000000000000000000000
000000000000000000000000000000000000-----------------------------------------------------XX-----XX-----------XXX0000000000000000000000000000000000000000000000000000000000000000000000000000
000000000000000000000000000000000000-----------------------------------------------------XX-----XX-----------XXX0000000000000000000000000000000000000000000000000000000000000000000000000000
000000000000000000000000000000000000----------------------------------------------------XXX-----XX-----------XXX0000000000000000000000000000000000000000000000000000000000000000000000000000
000000000000000000000000000000000000-------------------X---------------X---------------XXXX-----XX-----------XXX0000000000000000000000000000000000000000000000000000000000000000000000000000
000000000000000000000000000000000000------------------XX------------------------------XXXXX-----XX-----------XXX0000000000000000000000000000000000000000000000000000000000000000000000000000
000000000000000000000000000000000000-----------------XXX------X-----------XX---------XXXXXX-----XD-----------XXX0000000000000000000000000000000000000000000000000000000000000000000000000000
000000000000000000000000000000000000----------------XXXX-----------------XXX--------XXXXXXX-----XD-----------XXX0000000000000000000000000000000000000000000000000000000000000000000000000000
000000000000000000000000000000000000---------------XXXXX----------------XXXX-------XXXXXXXX-----XXXXXXXXXXXXXXXX0000000000000000000000000000000000000000000000000000000000000000000000000000
00000000000000000000XXXX--------XXXXXXXXXXXXXXXXXXXXXXXXXXXXXXXXXXXXXXXXXXX-XXXXXXXXXXXXXXXXXXXXXXXXXXXXXXXXXXXX0000000000000000000000000000000000000000000000000000000000000000000000000000
00000000000000000000XXXX----------X-00000000000000000000000000000000000000000000000000000000000000000000000000000000000000000000000000000000000000000000000000000000000000000000000000000000
00000000000000000000XXXX------------00000000000000000000000000000000000000000000000000000000000000000000000000000000000000000000000000000000000000000000000000000000000000000000000000000000
00000000000000000000XXXX------------00000000000000000000000000000000000000000000000000000000000000000000000000000000000000000000000000000000000000000000000000000000000000000000000000000000
00000000000000000000XXXXXXX---------00000000000000000000000000000000000000000000000000000000000000000000000000000000000000000000000000000000000000000000000000000000000000000000000000000000
00000000000000000000X---------TTTT--00000000000000000000000000000000000000000000000000000000000000000000000000000000000000000000000000000000000000000000000000000000000000000000000000000000
00000000000000000000X---------------00000000000000000000000000000000000000000000000000000000000000000000000000000000000000000000000000000000000000000000000000000000000000000000000000000000
--------------------XXXX--------XXXX00000000000000000000000000000000000000000000000000000000000000000000000000000000000000000000000000000000000000000000000000000000000000000000000000000000
--------------------XXXX--------XXXX00000000000000000000000000000000000000000000000000000000000000000000000000000000000000000000000000000000000000000000000000000000000000000000000000000000
--------------------XXXX------T-XXXX00000000000000000000000000000000000000000000000000000000000000000000000000000000000000000000000000000000000000000000000000000000000000000000000000000000
--------------------XX----------XXXX00000000000000000000000000000000000000000000000000000000000000000000000000000000000000000000000000000000000000000000000000000000000000000000000000000000
--------------------XX----------XXXX00000000000000000000000000000000000000000000000000000000000000000000000000000000000000000000000000000000000000000000000000000000000000000000000000000000
--------------------XX-----------XXX00000000000000000000000000000000000000000000000000000000000000000000000000000000000000000000000000000000000000000000000000000000000000000000000000000000
--------------------XX-----------XXX00000000000000000000000000000000000000000000000000000000000000000000000000000000000000000000000000000000000000000000000000000000000000000000000000000000
--------------------XX-----------XXX00000000000000000000000000000000000000000000000000000000000000000000000000000000000000000000000000000000000000000000000000000000000000000000000000000000
--------------------XX-----------XXX00000000000000000000000000000000000000000000000000000000000000000000000000000000000000000000000000000000000000000000000000000000000000000000000000000000
--------------------XD-----------XXX00000000000000000000000000000000000000000000000000000000000000000000000000000000000000000000000000000000000000000000000000000000000000000000000000000000
--------------------XD-----------XXX00000000000000000000000000000000000000000000000000000000000000000000000000000000000000000000000000000000000000000000000000000000000000000000000000000000
--------------------XXXXXXXXXXXXXXXX00000000000000000000000000000000000000000000000000000000000000000000000000000000000000000000000000000000000000000000000000000000000000000000000000000000
----------------E--<XXXXXXXXXXXXXXXX00000000000000000000000000000000000000000000000000000000000000000000000000000000000000000000000000000000000000000000000000000000000000000000000000000000
---------------<>--[000000000000000000000000000000000000000000000000000000000000000000000000000000000000000000000000000000000000000000000000000000000000000000000000000000000000000000000000
---EE-E-E------[]--[000000000000000000000000000000000000000000000000000000000000000000000000000000000000000000000000000000000000000000000000000000000000000000000000000000000000000000000000
XXXXXXXXXXXXXXXXXXXX000000000000000000000000000000000000000000000000000000000000000000000000000000000000000000000000000000000000000000000000000000000000000000000000000000000000000000000000
00000000000000000000000000000000000000000000000000000000000000000000000000000000000000000000000000000000000000000000000000000000000000000000000000000000000000000000000000000000000000000000