000000000000000000000000000000000000000000000000000000---XXXX--TTT----
000000000000000000000000000000000000000000000000000000---XXXX---XXXX--
000000000000000000000000000000000000000000000000000000-TTTXXD---XXXX--
000000000000000000000000000000000000000000000000000000---XXXXX--XXXX--
000000000000000000000000000000000000000000000000000000----XXXX--XXXX--
000000000000000000000000000000000000000000000000000000----XXXX--XXXX--
000000000000000000000000000000000000000000000000000000----XXXX-TTTTTTT
000000000000000000000000000000000000000000000000000000----XXXX--XXXX--
000000000000000000000000000000000000000000000000000000----XXXX--XXXX--
000000000000000000000000000000000000000000000000000000----------XXXX--
000000000000000000000000000000000000000000000000000000----------XXXX--
000000000000000000000000000000000000000000000000000000----------XXXX--
000000000000000000000000000000000000000000000000000000----------XXXX--
000000000000000000000000000000000000000000000000000000----------XXXX--
000000000000000000000000000000000000000000000000000000----------XXXX--
000000000000000000000000000000000000000000000000000000----------XXXX--
000000000000000000000000000000000000000000000000000000----------XXXX--
000000000000000000000000000000000000000000000000000000-------XXXXXX---
000000000000000000000000000000000000000000000000000000------XXXX------
000000000000000000000000000000000000000000000000000000------------XX--
000000000000000000000000000000000000000000000000000000------------XX--
000000000000000000000000000000000000000000000000000000----------XXXX--
000000000000000000000000000000000000000000000000000000----------------
000000000000000000000000000000000000000000000000000000--E--------E----
000000000000000000000000000000000000000000000000000000MMMMMMMMMMMMMMMM
000000000000000000000000000000000000000000000000000000----------------
000000000000000000000000000000000000000000000000000000----------------
000000000000000000000000000000000000000000000000000000XMMMMMMMMMMMMMMM
000000000000000000000000000000000000000000000000000000----------------
000000000000000000000000000000000000000000000000000000----------------
000000000000000000000000000000000000000000000000000000MMMMMMMMMMMMMMMM
000000000000000000000000000000000000000000000000000000----------------
000000000000000000000000000000000000000000000000000000----------------
000000000000000000000000000000000000000000000000000------------T------
000000000000000000000000000000000000000000000000000---0000000000000000
000000000000000000000000000000000000000000000000000---0000000000000000
000000000000000000000000000000000000000000000000000---0000000000000000
000000000000000000000000000000000000000000000000000---0000000000000000
000000000000000000000000000000000000000000000000000---0000000000000000
000000000000000000000000000000000000000000000000000---0000000000000000
000000000000000000000000000000000000000000000000000---0000000000000000
000000000000000000000000000000000000000000000000000---0000000000000000
00000000000000000000000000000000000----------------X--0000000000000000
00000000000000000000000000000000000------XXXX------X--0000000000000000
00000000000000000000000000000000000----------------X--0000000000000000
00000000000000000000000000000000000---XXXX---------X--0000000000000000
00000000000000000000000000000000000XXXXXXXX--------X--0000000000000000
00000000000000000000000000000000000----------------X--0000000000000000
00000000000000000000000000000000000----------TTTT--X--0000000000000000
00000000000000000000000000000000000----------------0000000000000000000
00000000000000000000000000000000000----------------0000000000000000000
00000000000000000000000000000000000----TTTT--------0000000000000000000
00000000000000000000000000000000000----------TTT---0000000000000000000
00000000000000000000000000000000000----------------0000000000000000000
00000000000000000000000000000000000----------------0000000000000000000
00000000000000000000000000000000000------T---TT----0000000000000000000
00000000000000000000000000000000000----------------0000000000000000000
00000000000000000000000000000000000----------------0000000000000000000
00000000000000000000000000000000000-----T---TT-----0000000000000000000
00000000000000000000000000000000000----------------0000000000000000000
00000000000000000000000000000000000----------------0000000000000000000
00000000000000000000000000000000000-----TT--TT-----0000000000000000000
00000000000000000000000000000000000----------------0000000000000000000
00000000000000000000000000000000000----------------0000000000000000000
00000000000000000000000000000000000--------TTTT----0000000000000000000
00000000000000000000000000000000000----------------0000000000000000000
00000000000000000000000000000000000----------------0000000000000000000
00000000000000000000000000000000000-------X---X----0000000000000000000
00000000000000000000000000000000000----------------0000000000000000000
00000000000000000000000000000000000----X-----------0000000000000000000
00000000000000000000000000000000000----------------0000000000000000000
00000000000000000000000000000000000----------------0000000000000000000
00000000000000000000000000000000000-------TT-------0000000000000000000
00000000000000000000000000000000000----------------0000000000000000000
00000000000000000000000000000000000----------------0000000000000000000
00000000000000000000000000000000000-------TTTTTTTT-0000000000000000000
00000000000000000000000000000000000----------------0000000000000000000
00000000000000000000000000000000000----------------0000000000000000000
00000000000000000000000000000000000----TTTT--------0000000000000000000
00000000000000000000000000000000000----------TTT---0000000000000000000
00000000000000000000000000000000000----------------0000000000000000000
00000000000000000000000000000000000----------------0000000000000000000
00000000000000000000000000000000000XX----------XXXX0000000000000000000
00000000000000000000000000000000000XX----------XXXX0000000000000000000
00000000000000000000000000000000000XXXXXXXXE---XXXX0000000000000000000
00000000000000000000000000000000000XXXX------XXXXXX0000000000000000000
00000000000000000000000000000000000XXXX------XXXX--0000000000000000000
00000000000000000000000000000000000XXXXE-EXXXXXXX--0000000000000000000
00000000000000000000000000000000000XXXX------XXXX--0000000000000000000
00000000000000000000000000000000000XX-----------XXX0000000000000000000
00000000000000000000000000000000000XX--TT-------XXX0000000000000000000
00000000000000000000000000000000000XX-----------XXX0000000000000000000
00000000000000000000000000000000000XX-----------XXX0000000000000000000
00000000000000000000000000000000000-XXXXXX----XXXX-0000000000000000000
00000000000000000000000000000000000----XXXX---XXXX-0000000000000000000
00000000000000000000000000000000000---------XXXXXX-0000000000000000000
00000000000000000000000000000000000----------XXXX--0000000000000000000
00000000000000000000000000000000000---E-----TTTXX--0000000000000000000
00000000000000000000000000000000000---E---E--------0000000000000000000
00000000000000000000000000000000000MMMMMMMMMMMMMMMM0000000000000000000
00000000000000000000000000000000000----------------0000000000000000000
00000000000000000000000000000000000----------------0000000000000000000
00000000000000000000000000000000000XMMMMMMMMMMMMMMM0000000000000000000
00000000000000000000000000000000000----------------0000000000000000000
00000000000000000000000000000000000----E--------E--0000000000000000000
00000000000000000000000000000000000MMMMMMMMMMMMMMMM0000000000000000000
00000000000000000000000000000000000----------------0000000000000000000
00000000000000000000000000000000000----------------0000000000000000000
00000000000000000000000000000000000-----TT---------0000000000000000000
00000000000000000000000000000000000----------------0000000000000000000
00000000000000000000000000000000000---E-----E------0000000000000000000
00000000000000000000000000000000000MMMMMMMMMMMMMMMX0000000000000000000
00000000000000000000000000000000000----------------0000000000000000000
00000000000000000000000000000000000--E--------E----0000000000000000000
00000000000000000000000000000000000MMMMMMMMMMMMMMMM0000000000000000000
00000000000000000000000000000000000----------------0000000000000000000
0000000000000000000000000000000000-----------------0000000000000000000
0000000000000000000000000000000000-XXXX------------0000000000000000000
0000000000000000000000000000000000-----------------0000000000000000000
0000000000000000000000000000000000-------TTTT------0000000000000000000
0000000000000000--0000000000000000-----------------0000000000000000000
0000000000000000--0000000000000000-----------------0000000000000000000
0000000000000000--0000000000000000--------X--------0000000000000000000
0000000000000000--0000000000000000--------X--------0000000000000000000
0000000000000000--0000000000000000--------X--------0000000000000000000
0000000000000000--0000000000000000-------X---------0000000000000000000
0000000000000000------------------------EX---------0000000000000000000
0000000000000000------------------X-----X-----X----0000000000000000000
0000000000000000---------------X---00000000000000000000000000000000000
0000000000000000-------------------00000000000000000000000000000000000
0000000000000000-------------------00000000000000000000000000000000000
XX----------XXXXXX----XXXXXXXX-----00000000000000000000000000000000000
XX----------------0000000000000000000000000000000000000000000000000000
XX----------------0000000000000000000000000000000000000000000000000000
XXXXMMMMMMMMMMMM--0000000000000000000000000000000000000000000000000000
XXXX--------------0000000000000000000000000000000000000000000000000000
XXXX------------000000000000000000000000000000000000000000000000000000
XXXX----------X-000000000000000000000000000000000000000000000000000000
XXXX----------X-000000000000000000000000000000000000000000000000000000
XXXX------------000000000000000000000000000000000000000000000000000000
XXXX------------000000000000000000000000000000000000000000000000000000
XXXX-----TTTT---000000000000000000000000000000000000000000000000000000
XXXX------------000000000000000000000000000000000000000000000000000000
XXXX----------X-000000000000000000000000000000000000000000000000000000
XXXX----------X-000000000000000000000000000000000000000000000000000000
XXXX------------000000000000000000000000000000000000000000000000000000
XXXX------------000000000000000000000000000000000000000000000000000000
XX----XXXX------000000000000000000000000000000000000000000000000000000
XX--------------000000000000000000000000000000000000000000000000000000
XD--------TTTTTT000000000000000000000000000000000000000000000000000000
XD--------------000000000000000000000000000000000000000000000000000000
XXXX------------000000000000000000000000000000000000000000000000000000
XMMMMMMMMMMMMMMM000000000000000000000000000000000000000000000000000000
----------------000000000000000000000000000000000000000000000000000000
----E--------E--000000000000000000000000000000000000000000000000000000
MMMMMMMMMMMMMMMM000000000000000000000000000000000000000000000000000000
----------------000000000000000000000000000000000000000000000000000000
----------------000000000000000000000000000000000000000000000000000000
---------TTTT---000000000000000000000000000000000000000000000000000000
----------------000000000000000000000000000000000000000000000000000000
------XXXX------000000000000000000000000000000000000000000000000000000
----------------000000000000000000000000000000000000000000000000000000
---XXXX---------000000000000000000000000000000000000000000000000000000
----------------000000000000000000000000000000000000000000000000000000
----------------000000000000000000000000000000000000000000000000000000
-----TT---------000000000000000000000000000000000000000000000000000000
----------------000000000000000000000000000000000000000000000000000000
----------------000000000000000000000000000000000000000000000000000000
--------TTTT----000000000000000000000000000000000000000000000000000000
----------------000000000000000000000000000000000000000000000000000000
--TTTTTTTT------000000000000000000000000000000000000000000000000000000
----------------000000000000000000000000000000000000000000000000000000
----------------000000000000000000000000000000000000000000000000000000
-TTTT-----------000000000000000000000000000000000000000000000000000000
----------------000000000000000000000000000000000000000000000000000000
----------------000000000000000000000000000000000000000000000000000000
----TTTT--------000000000000000000000000000000000000000000000000000000
----------------000000000000000000000000000000000000000000000000000000
----------------000000000000000000000000000000000000000000000000000000
----------------000000000000000000000000000000000000000000000000000000
----TTTT--------000000000000000000000000000000000000000000000000000000
----------TTT---000000000000000000000000000000000000000000000000000000
----------------000000000000000000000000000000000000000000000000000000
----------------000000000000000000000000000000000000000000000000000000
-----TT--TT-----000000000000000000000000000000000000000000000000000000
----------------000000000000000000000000000000000000000000000000000000
----------------000000000000000000000000000000000000000000000000000000
---------TTT----000000000000000000000000000000000000000000000000000000
----------------000000000000000000000000000000000000000000000000000000
X-----------TTTT000000000000000000000000000000000000000000000000000000
X--------------X000000000000000000000000000000000000000000000000000000
X--------------X000000000000000000000000000000000000000000000000000000
XXXXXXXXX------X000000000000000000000000000000000000000000000000000000
XX-------------X000000000000000000000000000000000000000000000000000000
XX--------TTTTTT000000000000000000000000000000000000000000000000000000
XD-------------X000000000000000000000000000000000000000000000000000000
XD-------------X000000000000000000000000000000000000000000000000000000
XXXXX---XXXXXXXX000000000000000000000000000000000000000000000000000000
XXXXXXXXXXXXXXXX000000000000000000000000000000000000000000000000000000