0000000000000000000000000000000000000000000000000000000000000000000000000000000000000000000000000000000000000000000000000000000000000000000000000000000000000000000000000000--------------------000000000000000
0000000000000000000000000000000000000000000000000000000000000000000000000000000000000000000000000000000000000000000000000000000000000000000000000000000000000000000000000000--------------------000000000000000
0000000000000000000000000000000000000000000000000000000000000000000000000000000000000000000000000000000000000000000000000000000000000000000000000000000000000000000000000000--------------------000000000000000
0000000000000000000000000000000000000000000000000000000000000000000000000000000000000000000000000000000000000000000000000000000000000000000000000000000000000000000000000000--------------------000000000000000
000000000000000000000000000000000000000000000000000000000000000000000000000000000000000000000000000000000000000000000000000000000000000000000000000000000000------X---------S-------------------000000000000000
000000000000000000000000000000000000000000000000000000000000000000000000000000000000000000000000000000000000000000000000000000000000000000000000000000000000------X---------S-------------------000000000000000
000000000000000000000000000000000000000000000000000000000000000000000000000000000000000000000000000000000000000000000000000000000000000000000000000000000000------X---------S--E----------------000000000000000
000000000000000000000000000000000000000000000000000000000000000000000000000000000000000000000000000000000000000000000000000000000000000000000000000000000000----------------S------------------X000000000000000
0000000000000000--------------------------------------------------------------------------------------------------------------------------------------------------------XX--S-----------------XX000000000000000
0000000000000000-----------------------------------------------------------------------------------------------------------------------------------------------------XXXXX--S-----------------XX000000000000000
0000000000000000----------------------------------------------------------------------------------------------------------------------------------------------------XXXXX---S---E------------XXX000000000000000
0000000000000000---------------------------------------------------------------------------------------------------------------------------------------------------XXXXX----S--->-----------XXXX000000000000000
XTTTTTTTT---XXXXS-------------------S-------------------S-------------------S-------------------S-------------------S-------------------S-------------------XX------TTTTTTTTS--<]----E-----XXXXX000000000000000
X-----------XXXXS-------------------S-------------------S-------------------S-------------------S-------------------S-------------------S-------------------XX----------XXXXS--[]----------XXXXX000000000000000
X------------DXXS-------------------S-------------------S-------------------S-------------------S-------------------S-------------------S-------------------XX----------XXXXS--[]----------XXXXX000000000000000
XXXXX-------XXXXS-----------------o-S-------------------S---S---------------S-------------XXXXXXS-------------------S--S----------------S---SS--S-----------XX----------XXXXXXXXXXXXXXXXXXXXXXXX000000000000000
XXXXXXXXXXXXXXXXS------------------oS-------------------S-------------------S-------------XXXXXXS-------------------S---Xooo------------S-------------------XX------XXXXXXXX00000000000000000000000000000000000
XX-------TTTTTTTS-------------------S-------------------S-------------------S------------XXXXXXXS-------------------S-------------------S-------------------XX------------XX00000000000000000000000000000000000
XX----------XXXXS-------------------S-------------------S-------------------S----E------XXXXXXXXS------E---E--------S---------------X---S-------------------XX------------XX00000000000000000000000000000000000
XXXX--------XXXXS-------------------S-------XX---E------S--SS---------------S---<>-----XXXXXXXXXS-----<>--->--------S-SS-----------XX---S--X------XX--------XX----XXXXXXXXXX00000000000000000000000000000000000
XXXXXX------XXXXS-------------------S------XXX---E------S-------------------S---[]----XXXXXXXXXXS-----[]--<]--------S--------E----XXX---S--X------XX--------XD------------XX00000000000000000000000000000000000
XXXX--------XXXXS-------------------S-----XXXXX-------X-S-------------------S---[]---XXXXXXXXXXXS-----[]--[]----X---S------------XXXX---S--X-----XXX--------XD------------XX00000000000000000000000000000000000
XXXX--------XXXXS---------E---------S----XXXX-X-------X-S----------------X--S---[]--XXXXXXXXXXXXS--E--[]--[]----X---S-----------XXXXX---S--XX--XXXXX--------XXXXX-------XXXX00000000000000000000000000000000000
XX----TTTTTTTTXXXXXXXXXXXXXXXXXXXXXXXXXXXXXXX-XXXXXXXXXXXXXXXXXXXXXXXXXXXXXXXXXXXXXXXXXXXXXXXXXXXXEXXXXXXXXXXXXXXXXXXXXXXXXXXXXXXXXXXXXXXXXXXXXXXXXXXXXXXXXXXXXXXXXXXXXXXXXX00000000000000000000000000000000000
XX------------XX00000000000000000000000000000000000000000000000000000000000000000000000000000000000000000000000000000000000000000000000000000000000000000000000000000000000000000000000000000000000000000000000
XX------------XX00000000000000000000000000000000000000000000000000000000000000000000000000000000000000000000000000000000000000000000000000000000000000000000000000000000000000000000000000000000000000000000000
XXXXXXXX------XX00000000000000000000000000000000000000000000000000000000000000000000000000000000000000000000000000000000000000000000000000000000000000000000000000000000000000000000000000000000000000000000000
XX----XXXXX---XX00000000000000000000000000000000000000000000000000000000000000000000000000000000000000000000000000000000000000000000000000000000000000000000000000000000000000000000000000000000000000000000000
XD------------XX00000000000000000000000000000000000000000000000000000000000000000000000000000000000000000000000000000000000000000000000000000000000000000000000000000000000000000000000000000000000000000000000
XD------------XX00000000000000000000000000000000000000000000000000000000000000000000000000000000000000000000000000000000000000000000000000000000000000000000000000000000000000000000000000000000000000000000000
XXXXX-------XXXX00000000000000000000000000000000000000000000000000000000000000000000000000000000000000000000000000000000000000000000000000000000000000000000000000000000000000000000000000000000000000000000000
XXXXXXXXXXXXXXXX00000000000000000000000000000000000000000000000000000000000000000000000000000000000000000000000000000000000000000000000000000000000000000000000000000000000000000000000000000000000000000000000