00000000000000000000000000000000000000000000000000000000000000000000000000000000000000000000000000000000000000000000000000000000--------------------000000000000000
00000000000000000000000000000000000000000000000000000000000000000000000000000000000000000000000000000000000000000000000000000000--------------------000000000000000
00000000000000000000000000000000000000000000000000000000000000000000000000000000000000000000000000000000000000000000000000000000--------------------000000000000000
00000000000000000000000000000000000000000000000000000000000000000000000000000000000000000000000000000000000000000000000000000000--------------------000000000000000
00000000000000000000000000000000000000000000000000000000000000000000000000000000000000000000000000000000000000000000000000000000--------------------000000000000000
00000000000000000000000000000000000000000000000000000000000000000000000000000000000000000000000000000000000000000000000000000000--------------------000000000000000
00000000000000000000000000000000000000000000000000000000000000000000000000000000000000000000000000000000000000000000000000000000--------------------000000000000000
00000000000000000000000000000000000000000000000000000000000000000000000000000000000000000000000000000000000000000000000000000000--------------------000000000000000
00000000000000000000000000000000000000000000000000000000000000000000000000000000000000000000000000000000000000000000000000000000--------------------000000000000000
00000000000000000000000000000000000000000000000000000000000000000000000000000000000000000000000000000000000000000000000000000000--------------------000000000000000
00000000000000000000000000000000000000000000000000000000000000000000000000000000000000000000000000000000000000000000000000000000--------------------000000000000000
00000000000000000000000000000000000000000000000000000000000000000000000000000000000000000000000000000000000000000000000000000000--------------------000000000000000
00000000000000000000000000000000000000000000000000000000000000000000000000000000000000000000000000000000000000000000000000000000--------------------000000000000000
00000000000000000000000000000000000000000000000000000000000000000000000000000000000000000000000000000000000000000000000000000000--------------------000000000000000
00000000000000000000000000000000000000000000000000000000000000000000000000000000000000000000000000000000000000000000000000000000--------E-------E-XX000000000000000
0000000000000000000000000000000000000000000000000000000000000000000000000000000000000000000000000000000000000000----------------XXXXXXXXXXXXXXXXXXXX000000000000000
0000000000000000000000000000000000000000000000000000000000000000000000000000000000000000000000000000000000000000MMMMMMMMMMMMMMMM00000000000000000000000000000000000
0000000000000000000000000000000000000000000000000000000000000000000000000000000000000000000000000000000000000000-------E--------00000000000000000000000000000000000
0000000000000000000000000000000000000000000000000000000000000000000000000000000000000000000000000000000000000000----------------00000000000000000000000000000000000
00000000000000000000000000000000000000000000000000000000000000000000000000000000000000000000--------------------------XXXX------00000000000000000000000000000000000
00000000000000000000000000000000000000000000000000000000000000000000000000000000000000000000------------------------------------00000000000000000000000000000000000
00000000000000000000000000000000000000000000000000000000000000000000000000000000000000000000-----------------------------TTT----00000000000000000000000000000000000
00000000000000000000000000000000000000000000000000000000000000000000000000000000000000000000------------------------------------00000000000000000000000000000000000
00000000000000000000000000000000000000000000000000000000000000000000000000000000000000000000------------------------------------00000000000000000000000000000000000
00000000000000000000000000000000000000000000000000000000000000000000000000000000000000000000--------------------X-------------XX00000000000000000000000000000000000
00000000000000000000000000000000000000000000000000000000000000000000000000000000000000000000--------------------X-------------XX00000000000000000000000000000000000
00000000000000000000000000000000000000000000000000000000000000000000000000000000000000000000--------------------X----XXXXXXXXXXX00000000000000000000000000000000000
00000000000000000000000000000000000000000000000000000000000000000000000000000000000000000000--------------------X--------------X00000000000000000000000000000000000
00000000000000000000000000000000000000000000000000000000000000000000000000000000000000000000--------------------X--------------X00000000000000000000000000000000000
00000000000000000000000000000000000000000000000000000000000000000000000000000000000000000000--------------------XXXXXXXXX------X00000000000000000000000000000000000
00000000000000000000000000000000000000000000000000000000000000000000000000000000000000000000--------------------XX-------------X00000000000000000000000000000000000
00000000000000000000000000000000000000000000000000000000000000000000000000000000000000000000--------------------XX----------TTTT00000000000000000000000000000000000
00000000000000000000000000000000000000000000000000000000000000000000000000000000000000000000--------------------XD-------------X00000000000000000000000000000000000
00000000000000000000000000000000000000000000000000000000000000000000000000000000000000000000-------------E------XD-------------X00000000000000000000000000000000000
0000000000000000000000000000000000000000000000000000000000000000000000000000----------------XXXXXXXXXXXXXXXXXXXXXXXXXXXXXXX-----00000000000000000000000000000000000
0000000000000000000000000000000000000000000000000000000000000000000000000000---TTTTTTTTT----00000000000000000000000000000000000000000000000000000000000000000000000
0000000000000000000000000000000000000000000000000000000000000000000000000000----------------00000000000000000000000000000000000000000000000000000000000000000000000
0000000000000000000000000000000000000000000000000000000000000000000000000000----------------00000000000000000000000000000000000000000000000000000000000000000000000
000000000000000000000000000000000000---------------------------------------------T---TT-----00000000000000000000000000000000000000000000000000000000000000000000000
000000000000000000000000000000000000--------------------------------------------------------00000000000000000000000000000000000000000000000000000000000000000000000
000000000000000000000000000000000000--------------------------------------------------------00000000000000000000000000000000000000000000000000000000000000000000000
000000000000000000000000000000000000----------------------------------------------TTTT------00000000000000000000000000000000000000000000000000000000000000000000000
000000000000000000000000000000000000--------------------------------------------------------00000000000000000000000000000000000000000000000000000000000000000000000
000000000000000000000000000000000000-------------------------------------------------TTT----00000000000000000000000000000000000000000000000000000000000000000000000
000000000000000000000000000000000000--------------------------------------------------------00000000000000000000000000000000000000000000000000000000000000000000000
000000000000000000000000000000000000----------------------------------------X-----------TTTT00000000000000000000000000000000000000000000000000000000000000000000000
000000000000000000000000000000000000----------------------------------------X--------------X00000000000000000000000000000000000000000000000000000000000000000000000
000000000000000000000000000000000000-------------X--------------------------X--------------X00000000000000000000000000000000000000000000000000000000000000000000000
000000000000000000000000000000000000-------------XX-------------------------XXXXXXXXX------X00000000000000000000000000000000000000000000000000000000000000000000000
000000000000000000000000000000000000------------XXX-------------------------XX-------------X00000000000000000000000000000000000000000000000000000000000000000000000
000000000000000000000000000000000000--------XXXXXXX-------------------------XX----------TTTT00000000000000000000000000000000000000000000000000000000000000000000000
000000000000000000000000000000000000-------XXXXXXXX-------------------------XD-------------X00000000000000000000000000000000000000000000000000000000000000000000000
000000000000000000000000000000000000------------XXX-------------------------XD-------------X00000000000000000000000000000000000000000000000000000000000000000000000
00000000000000000000XXXX------------XXXXXXXXXXXXXXXXXXXXXXXXXXXXXXXXXXXXXXXXXXXXXXXXXXX-----00000000000000000000000000000000000000000000000000000000000000000000000
00000000000000000000XXXXXXXXXXXX----0000000000000000000000000000000000000000000000000000000000000000000000000000000000000000000000000000000000000000000000000000000
00000000000000000000XXXX------------0000000000000000000000000000000000000000000000000000000000000000000000000000000000000000000000000000000000000000000000000000000
00000000000000000000XXXX------------0000000000000000000000000000000000000000000000000000000000000000000000000000000000000000000000000000000000000000000000000000000
00000000000000000000XXXX------------0000000000000000000000000000000000000000000000000000000000000000000000000000000000000000000000000000000000000000000000000000000
00000000000000000000XXXXXXXXXXX-----0000000000000000000000000000000000000000000000000000000000000000000000000000000000000000000000000000000000000000000000000000000
00000000000000000000XXXX------------0000000000000000000000000000000000000000000000000000000000000000000000000000000000000000000000000000000000000000000000000000000
00000000000000000000XXXX------------0000000000000000000000000000000000000000000000000000000000000000000000000000000000000000000000000000000000000000000000000000000
00000000000000000000XXXX------------0000000000000000000000000000000000000000000000000000000000000000000000000000000000000000000000000000000000000000000000000000000
00000000000000000000XXXXXXXXXXXX----0000000000000000000000000000000000000000000000000000000000000000000000000000000000000000000000000000000000000000000000000000000
00000000000000000000XXXXXXXXXXXXXXXX0000000000000000000000000000000000000000000000000000000000000000000000000000000000000000000000000000000000000000000000000000000
00000000000000000000XXXX------------0000000000000000000000000000000000000000000000000000000000000000000000000000000000000000000000000000000000000000000000000000000
00000000000000000000XXXX------------0000000000000000000000000000000000000000000000000000000000000000000000000000000000000000000000000000000000000000000000000000000
00000000000000000000XXXX------------0000000000000000000000000000000000000000000000000000000000000000000000000000000000000000000000000000000000000000000000000000000
00000000000000000000XXXXXXXXX------X0000000000000000000000000000000000000000000000000000000000000000000000000000000000000000000000000000000000000000000000000000000
00000000000000000000XX-------------X0000000000000000000000000000000000000000000000000000000000000000000000000000000000000000000000000000000000000000000000000000000
00000000000000000000XX----------TTTT0000000000000000000000000000000000000000000000000000000000000000000000000000000000000000000000000000000000000000000000000000000
00000000000000000000XD-------------X0000000000000000000000000000000000000000000000000000000000000000000000000000000000000000000000000000000000000000000000000000000
00000000000000000000XD-------------X0000000000000000000000000000000000000000000000000000000000000000000000000000000000000000000000000000000000000000000000000000000
00000000000000000000XXXXXXXXXXX-----0000000000000000000000000000000000000000000000000000000000000000000000000000000000000000000000000000000000000000000000000000000
00000000000000000000----------------0000000000000000000000000000000000000000000000000000000000000000000000000000000000000000000000000000000000000000000000000000000
00000000000000000000-------XXXXXXXX-0000000000000000000000000000000000000000000000000000000000000000000000000000000000000000000000000000000000000000000000000000000
00000000000000000000----------------0000000000000000000000000000000000000000000000000000000000000000000000000000000000000000000000000000000000000000000000000000000
00000000000000000000---TTTTTTTT-----0000000000000000000000000000000000000000000000000000000000000000000000000000000000000000000000000000000000000000000000000000000
00000000000000000000----------------0000000000000000000000000000000000000000000000000000000000000000000000000000000000000000000000000000000000000000000000000000000
00000000000000000000----------------0000000000000000000000000000000000000000000000000000000000000000000000000000000000000000000000000000000000000000000000000000000
00000000000000000000------TTTT------0000000000000000000000000000000000000000000000000000000000000000000000000000000000000000000000000000000000000000000000000000000
00000000000000000000----------------0000000000000000000000000000000000000000000000000000000000000000000000000000000000000000000000000000000000000000000000000000000
00000000000000000000---------TTTT---0000000000000000000000000000000000000000000000000000000000000000000000000000000000000000000000000000000000000000000000000000000
00000000000000000000----------------0000000000000000000000000000000000000000000000000000000000000000000000000000000000000000000000000000000000000000000000000000000
00000000000000000000XX----------TTTT0000000000000000000000000000000000000000000000000000000000000000000000000000000000000000000000000000000000000000000000000000000
00000000000000000000XXE------------X0000000000000000000000000000000000000000000000000000000000000000000000000000000000000000000000000000000000000000000000000000000
00000000000000000000XX-------------X0000000000000000000000000000000000000000000000000000000000000000000000000000000000000000000000000000000000000000000000000000000
00000000000000000000XXXXXXXX-------X0000000000000000000000000000000000000000000000000000000000000000000000000000000000000000000000000000000000000000000000000000000
00000000000000000000XXXX------------0000000000000000000000000000000000000000000000000000000000000000000000000000000000000000000000000000000000000000000000000000000
00000000000000000000XX-------------X0000000000000000000000000000000000000000000000000000000000000000000000000000000000000000000000000000000000000000000000000000000
00000000000000000000XX----------TTTT0000000000000000000000000000000000000000000000000000000000000000000000000000000000000000000000000000000000000000000000000000000
00000000000000000000XD-------------X0000000000000000000000000000000000000000000000000000000000000000000000000000000000000000000000000000000000000000000000000000000
00000000000000000000XD-------------X0000000000000000000000000000000000000000000000000000000000000000000000000000000000000000000000000000000000000000000000000000000
00000000000000000000XXXXXXXXXXX-----0000000000000000000000000000000000000000000000000000000000000000000000000000000000000000000000000000000000000000000000000000000
00000000000000000000----XXXX-------X0000000000000000000000000000000000000000000000000000000000000000000000000000000000000000000000000000000000000000000000000000000
00000000000000000000---XXXX------XXX0000000000000000000000000000000000000000000000000000000000000000000000000000000000000000000000000000000000000000000000000000000
00000000000000000000XXXXXXXX----XXXX0000000000000000000000000000000000000000000000000000000000000000000000000000000000000000000000000000000000000000000000000000000
00000000000000000000----------------0000000000000000000000000000000000000000000000000000000000000000000000000000000000000000000000000000000000000000000000000000000
------------------------------------0000000000000000000000000000000000000000000000000000000000000000000000000000000000000000000000000000000000000000000000000000000
--------------------TTT-XXXXXXXX--XX0000000000000000000000000000000000000000000000000000000000000000000000000000000000000000000000000000000000000000000000000000000
----------------------------TTTT--XX0000000000000000000000000000000000000000000000000000000000000000000000000000000000000000000000000000000000000000000000000000000
--------------------X-------------XX0000000000000000000000000000000000000000000000000000000000000000000000000000000000000000000000000000000000000000000000000000000
--------------------XTT-----------XX0000000000000000000000000000000000000000000000000000000000000000000000000000000000000000000000000000000000000000000000000000000
--------------------X-------------XX0000000000000000000000000000000000000000000000000000000000000000000000000000000000000000000000000000000000000000000000000000000
--------------------X----------XXXXX0000000000000000000000000000000000000000000000000000000000000000000000000000000000000000000000000000000000000000000000000000000
--------------------X--XXXXXXXXX---X0000000000000000000000000000000000000000000000000000000000000000000000000000000000000000000000000000000000000000000000000000000
--------------------X--------------X0000000000000000000000000000000000000000000000000000000000000000000000000000000000000000000000000000000000000000000000000000000
--------------------XXXXXXXXX------X0000000000000000000000000000000000000000000000000000000000000000000000000000000000000000000000000000000000000000000000000000000
--------------------XXXXXXXXX------X0000000000000000000000000000000000000000000000000000000000000000000000000000000000000000000000000000000000000000000000000000000
--------------------XX-------------X0000000000000000000000000000000000000000000000000000000000000000000000000000000000000000000000000000000000000000000000000000000
--------------------XX----------TTTT0000000000000000000000000000000000000000000000000000000000000000000000000000000000000000000000000000000000000000000000000000000
--------------------XD-------------X0000000000000000000000000000000000000000000000000000000000000000000000000000000000000000000000000000000000000000000000000000000
--------------------XD-------------X0000000000000000000000000000000000000000000000000000000000000000000000000000000000000000000000000000000000000000000000000000000
XXXXXXXXXXXXXXXXXXXXXXXXXXXXXXX-----0000000000000000000000000000000000000000000000000000000000000000000000000000000000000000000000000000000000000000000000000000000
0000000000000000000000000000000000000000000000000000000000000000000000000000000000000000000000000000000000000000000000000000000000000000000000000000000000000000000