000000000000000000000000000000000000000000000000000000000000000000000000000000000000000000000000000000000000000000000000000000000000------------X---
000000000000000000000000000000000000000000000000000000000000000000000000000000000000000000000000000000000000000000000000000000000000------------X---
000000000000000000000000000000000000000000000000000000000000000000000000000000000000000000000000000000000000000000000000000000000000------------X---
000000000000000000000000000000000000000000000000000000000000000000000000000000000000000000000000000000000000000000000000000000000000------------X---
0000000000000000000000000000000000000000000000000000000000000000000000000000000000000000000000000000000000000000--------------------------------X---
0000000000000000000000000000000000000000000000000000000000000000000000000000000000000000000000000000000000000000--------------------------------X---
0000000000000000000000000000000000000000000000000000000000000000000000000000000000000000000000000000000000000000--------------------------------X---
0000000000000000000000000000000000000000000000000000000000000000000000000000000000000000000000000000000000000000--------------------------------X---
0000000000000000000000000000000000000000000000000000000000000000000000000000000000000000000000000000000000000000--------------------XX----------XXXX
0000000000000000000000000000000000000000000000000000000000000000000000000000000000000000000000000000000000000000--------------------XX-----------XXX
0000000000000000000000000000000000000000000000000000000000000000000000000000000000000000000000000000000000000000--------------------XXXXXXX-----XXXX
0000000000000000000000000000000000000000000000000000000000000000000000000000000000000000000000000000000000000000--------------------XXXX--------XXXX
0000000000000000000000000000000000000000000000000000000000000000000000000000000000000000000000000000000000000000-----------------------X------------
0000000000000000000000000000000000000000000000000000000000000000000000000000000000000000000000000000000000000000---------X-------------X------------
0000000000000000000000000000000000000000000000000000000000000000000000000000000000000000000000000000000000000000--------XX----------XXXXXXXX------XX
0000000000000000000000000000000000000000000000000000000000000000000000000000000000000000000000000000000000000000-------XXX-----S----XXXXXXXXXXX---XX
0000000000000000000000000000000000000000000000000000000000000000000000000000000000000000000000000000000000000000-----XXXXX----------XD------------XX
0000000000000000000000000000000000000000000000000000000000000000000000000000000000000000000000000000000000000000----XXXXXX----------XD------------XX
0000000000000000000000000000000000000000000000000000000000000000000000000000000000000000000000000000000000000000---XXXXXXX----------XXXXX-------XXXX
000000000000000000000000000000000000000000000000000000000000000000000000000000000000000000000000------XXXXXXXXXXXXXXXXXXXXXXXXXXXXXXXXXXXXXXXXXXXXXX
000000000000000000000000000000000000000000000000000000000000000000000000000000000000000000000000------DX--------000000000000000000000000000000000000
000000000000000000000000000000000000000000000000000000000000000000000000000000000000000000000000------DX--------000000000000000000000000000000000000
000000000000000000000000000000000000000000000000000000000000000000000000000000000000000000000000XXXXXXXX----XXXX000000000000000000000000000000000000
000000000000000000000000000000000000000000000000000000000000000000000000000000000000000000000000----------------000000000000000000000000000000000000
000000000000000000000000000000000000000000000000000000000000000000000000000000000000000000000000---------XXXX---000000000000000000000000000000000000
000000000000000000000000000000000000000000000000000000000000000000000000000000000000000000000000----------------000000000000000000000000000000000000
000000000000000000000000000000000000000000000000000000000000000000000000000000000000000000000000XXXX--------XXXX000000000000000000000000000000000000
000000000000000000000000000000000000000000000000000000000000000000000000000000000000000000000000----------------000000000000000000000000000000000000
000000000000000000000000000000000000000000000000000000000000000000000000000000000000000000000000---------TTTT---000000000000000000000000000000000000
000000000000000000000000000000000000000000000000000000000000000000000000000000000000000000000000----------------000000000000000000000000000000000000
000000000000000000000000000000000000000000000000000000000000000000000000000000000000000000000000------XXXX------000000000000000000000000000000000000
000000000000000000000000000000000000000000000000000000000000000000000000000000000000000000000000XX------TTTTTTXX000000000000000000000000000000000000
000000000000000000000000000000000000000000000000000000000000000000000000000000000000000000000000XX------------XX000000000000000000000000000000000000
000000000000000000000000000000000000000000000000000000000000000000000000000000000000000000000000XX------------XX000000000000000000000000000000000000
000000000000000000000000000000000000000000000000000000000000000000000000000000000000000000000000XX-----------XXX000000000000000000000000000000000000
000000000000000000000000000000000000000000000000000000000000000000000000000000000000000000000000XD-----------XXX000000000000000000000000000000000000
000000000000000000000000000000000000000000000000000000000000000000000000000000000000000000000000XD-----------XXX000000000000000000000000000000000000
000000000000000000000000000000000000000000000000000000000000000000000000000000000000000000000000XXXXX-------XXXX000000000000000000000000000000000000
000000000000000000000000000000000000000000000000000000000000000000000000000000000000000000000000XXXXXXXXXXXXXXXX000000000000000000000000000000000000
000000000000000000000000000000000000000000000000000000000000000000000000000000000000000000000000XXXX--------XXXX000000000000000000000000000000000000
000000000000000000000000000000000000000000000000000000000000000000000000000000000000000000000000XXXX--------XXXX000000000000000000000000000000000000
000000000000000000000000000000000000000000000000000000000000000000000000000000000000000000000000XXXX--------XXXX000000000000000000000000000000000000
000000000000000000000000000000000000000000000000000000000000000000000000000000000000000000000000XXXX--------XXXX000000000000000000000000000000000000
000000000000000000000000000000000000000000000000000000000000000000000000000000000000000000000000XXXX--------XXXX000000000000000000000000000000000000
000000000000000000000000000000000000000000000000000000000000000000000000000000000000000000000000XXXX--------XXXX000000000000000000000000000000000000
000000000000000000000000000000000000000000000000000000000000000000000000000000000000000000000000XXXX--------XXXX000000000000000000000000000000000000
000000000000000000000000000000000000000000000000000000000000000000000000000000000000000000000000XXXXXX------XXXX000000000000000000000000000000000000
000000000000000000000000000000000000000000000000000000000000000000000000000000000000000000000000XXXX--------XXXX000000000000000000000000000000000000
000000000000000000000000000000000000000000000000000000000000000000000000000000000000000000000000XXXX--------XXXX000000000000000000000000000000000000
000000000000000000000000000000000000000000000000000000000000000000000000000000000000000000000000XX----TTTTTTTTXX000000000000000000000000000000000000
000000000000000000000000000000000000000000000000000000000000000000000000000000000000000000000000XX------------XX000000000000000000000000000000000000
000000000000000000000000000000000000000000000000000000000000000000000000000000000000000000000000XX------------XX000000000000000000000000000000000000
000000000000000000000000000000000000000000000000000000000000000000000000000000000000000000000000XXXXXXXX------XX000000000000000000000000000000000000
000000000000000000000000000000000000000000000000000000000000000000000000000000000000000000000000XXXXXXXXXXXX--XX000000000000000000000000000000000000
000000000000000000000000000000000000000000000000000000000000000000000000000000000000000000000000XX------------XX000000000000000000000000000000000000
000000000000000000000000000000000000000000000000000000000000000000000000000000000000000000000000XX-----------XXX000000000000000000000000000000000000
000000000000000000000000000000000000000000000000000000000000000000000000000000000000000000000000XD-----------XXX000000000000000000000000000000000000
000000000000000000000000000000000000000000000000000000000000000000000000000000000000000000000000XXXXX-------XXXX000000000000000000000000000000000000
000000000000000000000000000000000000000000000000000000000000000000000000000000000000000000000000XXXXXXXXXXXXXXXX000000000000000000000000000000000000
000000000000000000000000000000000000000000000000000000000000000000000000000000000000000000000000----------------000000000000000000000000000000000000
000000000000000000000000000000000000000000000000000000000000000000000000000000000000000000000000----------------000000000000000000000000000000000000
000000000000000000000000000000000000000000000000000000000000000000000000000000000000000000000000XX----------XXXX000000000000000000000000000000000000
000000000000000000000000000000000000000000000000000000000000000000000000000000000000000000000000XX----------XXXX000000000000000000000000000000000000
0000000000000000--------------------------------------------------------------------------------XXXXXXXXXXXXXXXX000000000000000000000000000000000000
0000000000000000--------------------------------------------------------------------------------XXXX----------XX000000000000000000000000000000000000
0000000000000000--------------------------------------------------------------------------------XXXX----------XX000000000000000000000000000000000000
0000000000000000--------------------------------------------------------------------------------XXXX----------DX000000000000000000000000000000000000
0000000000000000--------------------------------------------------------------------------------XXXX----------DX000000000000000000000000000000000000
0000000000000000--------------------------------------------------------------------------------XXXX----XXXXXXXX000000000000000000000000000000000000
0000000000000000-----------------------------------------------------------------------------------X-X----------000000000000000000000000000000000000
0000000000000000-----------------------------------------------------------------------------------X------------000000000000000000000000000000000000
0000000000000000--------------------------------------------------------------------------------XXX-----------XX000000000000000000000000000000000000
0000000000000000--------------------------------------------------------------------------------XXXXXXXXXX----XX000000000000000000000000000000000000
0000000000000000-------------------------------------X-----------------------------o------------XX------------XX000000000000000000000000000000000000
0000000000000000---------------------------E--------XX------------------------------------------XX------------XX000000000000000000000000000000000000
0000000000000000--------------------------<>-------XXX------------------------------------------XX-----XXXXXXXXX000000000000000000000000000000000000
0000000000000000--------------------------[]------XXXX------------------------------------------XD------------XX000000000000000000000000000000000000
0000000000000000-------E------------------[]----XXXXXX----------------E-------------------------XXXXX-------XXXX000000000000000000000000000000000000
-----E----------XXXXXXXXXXXXXXXXXXXXXXXXXXXXXXXXXXXXXXXXXXXXXXXXXXXXXXXXXXXXXXXXXXXXXXXXXXXXXXXXXXXXXXXXXXXXXXXX000000000000000000000000000000000000
----TTT---------000000000000000000000000000000000000000000000000000000000000000000000000000000000000000000000000000000000000000000000000000000000000
----------------000000000000000000000000000000000000000000000000000000000000000000000000000000000000000000000000000000000000000000000000000000000000
------XXXX------000000000000000000000000000000000000000000000000000000000000000000000000000000000000000000000000000000000000000000000000000000000000
----------------000000000000000000000000000000000000000000000000000000000000000000000000000000000000000000000000000000000000000000000000000000000000
---TTTT---------000000000000000000000000000000000000000000000000000000000000000000000000000000000000000000000000000000000000000000000000000000000000
----------------000000000000000000000000000000000000000000000000000000000000000000000000000000000000000000000000000000000000000000000000000000000000
--------TTTT----000000000000000000000000000000000000000000000000000000000000000000000000000000000000000000000000000000000000000000000000000000000000
----------------000000000000000000000000000000000000000000000000000000000000000000000000000000000000000000000000000000000000000000000000000000000000
--TTTTTTTT------000000000000000000000000000000000000000000000000000000000000000000000000000000000000000000000000000000000000000000000000000000000000
----------------000000000000000000000000000000000000000000000000000000000000000000000000000000000000000000000000000000000000000000000000000000000000
----------------000000000000000000000000000000000000000000000000000000000000000000000000000000000000000000000000000000000000000000000000000000000000
----------------000000000000000000000000000000000000000000000000000000000000000000000000000000000000000000000000000000000000000000000000000000000000
XX------TTTTTTXX000000000000000000000000000000000000000000000000000000000000000000000000000000000000000000000000000000000000000000000000000000000000
XX------------XX000000000000000000000000000000000000000000000000000000000000000000000000000000000000000000000000000000000000000000000000000000000000
XX------------XX000000000000000000000000000000000000000000000000000000000000000000000000000000000000000000000000000000000000000000000000000000000000
XX-----XXXXXXXXX000000000000000000000000000000000000000000000000000000000000000000000000000000000000000000000000000000000000000000000000000000000000
XD------------XX000000000000000000000000000000000000000000000000000000000000000000000000000000000000000000000000000000000000000000000000000000000000
XXXXX-------XXXX000000000000000000000000000000000000000000000000000000000000000000000000000000000000000000000000000000000000000000000000000000000000
XXXXXXXXXXXXXXXX000000000000000000000000000000000000000000000000000000000000000000000000000000000000000000000000000000000000000000000000000000000000