000000000000000000000000000000000000000000000000000000000000000000000000----------------------------------------000000000000000
000000000000000000000000000000000000000000000000000000000000000000000000----------------------------------------000000000000000
000000000000000000000000000000000000000000000000000000000000000000000000----------------------------------------000000000000000
000000000000000000000000000000000000000000000000000000000000000000000000----------------------------------------000000000000000
000000000000000000000000000000000000000000000000000000000000000000000000----------------------------------------000000000000000
000000000000000000000000000000000000000000000000000000000000000000000000----------------------------------------000000000000000
000000000000000000000000000000000000000000000000000000000000000000000000----------------------------------------000000000000000
000000000000000000000000000000000000000000000000000000000000000000000000----------------------------------------000000000000000
000000000000000000000000000000000000000000000000000000000000000000000000----------------------------------------000000000000000
000000000000000000000000000000000000000000000000000000000000000000000000----------------------------------------000000000000000
000000000000000000000000000000000000000000000000000000000000000000000000-------------------------------E--------000000000000000
000000000000000000000000000000000000000000000000000000000000000000000000------------------------------<>--------000000000000000
000000000000000000000000000000000000000000000000000000000000000000000000------------------------------[]--------000000000000000
000000000000000000000000000000000000000000000000000000000000000000000000------------------------------[]--------000000000000000
000000000000000000000000000000000000000000000000000000000000000000000000----------E-------------------[]--------000000000000000
00000000000000000000000000000000000000000000000000000000X-------TTTT-TTTXXXXXXXXXXXXXXXXXXXXXXXXXXXXXXXXXXXXXXXX000000000000000
00000000000000000000000000000000000000000000000000000000X---------------0000000000000000000000000000000000000000000000000000000
00000000000000000000000000000000000000000000000000000000XX--------------0000000000000000000000000000000000000000000000000000000
00000000000000000000000000000000000000000000000000000000XD--TTTT--------0000000000000000000000000000000000000000000000000000000
00000000000000000000000000000000000000000000000000000000XD--------------0000000000000000000000000000000000000000000000000000000
00000000000000000000000000000000000000000000000000000000X--TTTTTT-------0000000000000000000000000000000000000000000000000000000
00000000000000000000000000000000000000000000000000000000----------------0000000000000000000000000000000000000000000000000000000
00000000000000000000000000000000000000000000000000000000----------------0000000000000000000000000000000000000000000000000000000
00000000000000000000000000000000000000000000000000000000----------------0000000000000000000000000000000000000000000000000000000
00000000000000000000000000000000000000000000000000000000--------XXXX----0000000000000000000000000000000000000000000000000000000
00000000000000000000000000000000000000000000000000000000----------------0000000000000000000000000000000000000000000000000000000
00000000000000000000000000000000000000000000000000000000----------------0000000000000000000000000000000000000000000000000000000
00000000000000000000000000000000000000000000000000000000XMMMMMMMMMMMMMMX0000000000000000000000000000000000000000000000000000000
00000000000000000000000000000000000000000000000000000000X-----------T--X0000000000000000000000000000000000000000000000000000000
00000000000000000000000000000000000000000000000000000000X--------------X0000000000000000000000000000000000000000000000000000000
00000000000000000000000000000000000000000000000000000000X--X-----------X0000000000000000000000000000000000000000000000000000000
00000000000000000000000000000000000000000000000000000000X-----DX-------X0000000000000000000000000000000000000000000000000000000
00000000000000000000000000000000000000000000000000000000TTTTXXXXXXXX--DX0000000000000000000000000000000000000000000000000000000
00000000000000000000000000000000000000000000000000000000--TTTTTTTT----DX0000000000000000000000000000000000000000000000000000000
00000000000000000000000000000000000000000000000000000000---------TTTTTTT0000000000000000000000000000000000000000000000000000000
00000000000000000000000000000000000000000000000000000000----------------0000000000000000000000000000000000000000000000000000000
00000000000000000000000000000000000000000000000000000000-----TTTT-------0000000000000000000000000000000000000000000000000000000
00000000000000000000000000000000000000000000000000000000----------------0000000000000000000000000000000000000000000000000000000
00000000000000000000000000000000000000000000000000000000----------------0000000000000000000000000000000000000000000000000000000
00000000000000000000000000000000000000000000000000000000--------TTTT----0000000000000000000000000000000000000000000000000000000
00000000000000000000000000000000000000000000000000000000----------------0000000000000000000000000000000000000000000000000000000
00000000000000000000000000000000000000000000000000000000--TTTTTTTT------0000000000000000000000000000000000000000000000000000000
00000000000000000000000000000000000000000000000000000000----------------0000000000000000000000000000000000000000000000000000000
00000000000000000000000000000000000000000000000000000000----------------0000000000000000000000000000000000000000000000000000000
00000000000000000000000000000000000000000000000000000000XXXXXXX---------0000000000000000000000000000000000000000000000000000000
00000000000000000000000000000000000000000000000000000000----------------0000000000000000000000000000000000000000000000000000000
00000000000000000000000000000000000000000000000000000000-------TTTT-----0000000000000000000000000000000000000000000000000000000
00000000000000000000000000000000000000000000000000000000----------------0000000000000000000000000000000000000000000000000000000
00000000000000000000000000000000000000000000000000000000X-----------XXXX0000000000000000000000000000000000000000000000000000000
00000000000000000000000000000000000000000000000000000000X-------------XX0000000000000000000000000000000000000000000000000000000
00000000000000000000000000000000000000000000000000000000X-----TTTT----XX0000000000000000000000000000000000000000000000000000000
00000000000000000000000000000000000000000000000000000000XXXX----------XX0000000000000000000000000000000000000000000000000000000
00000000000000000000000000000000000000000000000000000000TTTTXXXXXXXX--XX0000000000000000000000000000000000000000000000000000000
00000000000000000000000000000000000000000000000000000000--TTTTTTTT----DX0000000000000000000000000000000000000000000000000000000
00000000000000000000000000000000000000000000000000000000---------TTTTTTT0000000000000000000000000000000000000000000000000000000
00000000000000000000000000000000000000000000000000000000XXXX------XXXX--0000000000000000000000000000000000000000000000000000000
00000000000000000000000000000000000000000000000000000000XXXXXXXE--XXXX--0000000000000000000000000000000000000000000000000000000
00000000000000000000000000000000000000000000000000000000XXXXXXX---XXXX--0000000000000000000000000000000000000000000000000000000
00000000000000000000000000000000000000000000000000000000XXXX------XXXX--0000000000000000000000000000000000000000000000000000000
00000000000000000000000000000000000000000000000000000000XX-TTTTTTTTTTTTT0000000000000000000000000000000000000000000000000000000
00000000000000000000000000000000000000000000000000000000XX----------XXXX0000000000000000000000000000000000000000000000000000000
00000000000000000000000000000000000000000000000000000000XX----------XXXX0000000000000000000000000000000000000000000000000000000
00000000000000000000000000000000000000000000000000000000TTTTXXXX---XXXX-0000000000000000000000000000000000000000000000000000000
000000000000000000000000000000000000--------------------TTTTTTTT-----XXX0000000000000000000000000000000000000000000000000000000
000000000000000000000000000000000000--------------------------TTTTTTTTTT0000000000000000000000000000000000000000000000000000000
000000000000000000000000000000000000------------------------XX---------X0000000000000000000000000000000000000000000000000000000
000000000000000000000000000000000000---------------------TTTTTTTT------X0000000000000000000000000000000000000000000000000000000
000000000000000000000000000000000000--------------------X-----------XXXX0000000000000000000000000000000000000000000000000000000
000000000000000000000000000000000000--------------------X-----------XXXX0000000000000000000000000000000000000000000000000000000
000000000000000000000000000000000000--------------------X-------------XX0000000000000000000000000000000000000000000000000000000
000000000000000000000000000000000000--------------------X-------------XX0000000000000000000000000000000000000000000000000000000
000000000000000000000000000000000000--------------------XXXX----------XX0000000000000000000000000000000000000000000000000000000
000000000000000000000000000000000000--------------------TTTTXXXXXXXX--XX0000000000000000000000000000000000000000000000000000000
000000000000000000000000000000000000----E-----------------TTTTTTTT----DX0000000000000000000000000000000000000000000000000000000
000000000000000000000000000000000000---<>------S-------E---------TTTTTTT0000000000000000000000000000000000000000000000000000000
000000000000000000000000000000000000---[]-------------<>00000000000000000000000000000000000000000000000000000000000000000000000
000000000000000000000000000000000000---[]-------------[]00000000000000000000000000000000000000000000000000000000000000000000000
000000000000000000000000000000000000---[]-------E-----[]00000000000000000000000000000000000000000000000000000000000000000000000
00000000000000000000XXXX---------XXXXXXXXXXXXXXXXXXXXXXX00000000000000000000000000000000000000000000000000000000000000000000000
00000000000000000000XXXX---------XXX0000000000000000000000000000000000000000000000000000000000000000000000000000000000000000000
00000000000000000000XXXX---------XXX0000000000000000000000000000000000000000000000000000000000000000000000000000000000000000000
00000000000000000000XXXX---------XXX0000000000000000000000000000000000000000000000000000000000000000000000000000000000000000000
00000000000000000000XXXX---------XXX0000000000000000000000000000000000000000000000000000000000000000000000000000000000000000000
00000000000000000000XXXX---------XXX0000000000000000000000000000000000000000000000000000000000000000000000000000000000000000000
00000000000000000000XXXX---------XXX0000000000000000000000000000000000000000000000000000000000000000000000000000000000000000000
00000000000000000000XXXX---------XXX0000000000000000000000000000000000000000000000000000000000000000000000000000000000000000000
00000000000000000000XXXX---------XXX0000000000000000000000000000000000000000000000000000000000000000000000000000000000000000000
00000000000000000000X------------DXX0000000000000000000000000000000000000000000000000000000000000000000000000000000000000000000
00000000000000000000X------------DXX0000000000000000000000000000000000000000000000000000000000000000000000000000000000000000000
00000000000000000000X--XXXXXXXXXXXXX0000000000000000000000000000000000000000000000000000000000000000000000000000000000000000000
00000000000000000000X----------XXXXX0000000000000000000000000000000000000000000000000000000000000000000000000000000000000000000
00000000000000000000X-----------XXXX0000000000000000000000000000000000000000000000000000000000000000000000000000000000000000000
00000000000000000000X-------------XX0000000000000000000000000000000000000000000000000000000000000000000000000000000000000000000
00000000000000000000X-------------XX0000000000000000000000000000000000000000000000000000000000000000000000000000000000000000000
00000000000000000000XXXX----------XX0000000000000000000000000000000000000000000000000000000000000000000000000000000000000000000
00000000000000000000TTTTXXXXXXXX--XX0000000000000000000000000000000000000000000000000000000000000000000000000000000000000000000
00000000000000000000--TTTTTTTT----DX0000000000000000000000000000000000000000000000000000000000000000000000000000000000000000000
00000000000000000000---------TTTTTTT0000000000000000000000000000000000000000000000000000000000000000000000000000000000000000000
00000000000000000000XX-----XXXX--XXX0000000000000000000000000000000000000000000000000000000000000000000000000000000000000000000
00000000000000000000XXXX--------XXXX0000000000000000000000000000000000000000000000000000000000000000000000000000000000000000000
00000000000000000000XXXX--------XXXX0000000000000000000000000000000000000000000000000000000000000000000000000000000000000000000
00000000000000000000XXXX--------XXXX0000000000000000000000000000000000000000000000000000000000000000000000000000000000000000000
00000000000000000000XXXX--------XXXX0000000000000000000000000000000000000000000000000000000000000000000000000000000000000000000
00000000000000000000XXXX-------EXXXX0000000000000000000000000000000000000000000000000000000000000000000000000000000000000000000
00000000000000000000XXXX---------XXX0000000000000000000000000000000000000000000000000000000000000000000000000000000000000000000
00000000000000000000XMMMMMMMMMMMMMMM0000000000000000000000000000000000000000000000000000000000000000000000000000000000000000000
00000000000000000000----------------0000000000000000000000000000000000000000000000000000000000000000000000000000000000000000000
00000000000000000000----E--------E--0000000000000000000000000000000000000000000000000000000000000000000000000000000000000000000
00000000000000000000MMMMMMMMXMMMMMMM0000000000000000000000000000000000000000000000000000000000000000000000000000000000000000000
00000000000000000000----------------0000000000000000000000000000000000000000000000000000000000000000000000000000000000000000000
00000000000000000000----------------0000000000000000000000000000000000000000000000000000000000000000000000000000000000000000000
00000000000000000000XMMMMMMMMMMMMMMX0000000000000000000000000000000000000000000000000000000000000000000000000000000000000000000
00000000000000000000X--------------X0000000000000000000000000000000000000000000000000000000000000000000000000000000000000000000
00000000000000000000X--------------X0000000000000000000000000000000000000000000000000000000000000000000000000000000000000000000
00000000000000000000XXXXXXXXXXXX---X0000000000000000000000000000000000000000000000000000000000000000000000000000000000000000000
00000000000000000000TTTTXXXXXXXX--DX0000000000000000000000000000000000000000000000000000000000000000000000000000000000000000000
00000000000000000000--TTTTTTTT----DX0000000000000000000000000000000000000000000000000000000000000000000000000000000000000000000
00000000000000000000---------TTTTTTT0000000000000000000000000000000000000000000000000000000000000000000000000000000000000000000
00000000000000000000-XXXX--------XXX0000000000000000000000000000000000000000000000000000000000000000000000000000000000000000000
00000000000000000000XXXX--------XXXX0000000000000000000000000000000000000000000000000000000000000000000000000000000000000000000
00000000000000000000XXXX----TTTTXXXX0000000000000000000000000000000000000000000000000000000000000000000000000000000000000000000
00000000000000000000XXXX--------XXXX0000000000000000000000000000000000000000000000000000000000000000000000000000000000000000000
--------------------XXXX--------XXXX0000000000000000000000000000000000000000000000000000000000000000000000000000000000000000000
--------------------XXXX--------XXXX0000000000000000000000000000000000000000000000000000000000000000000000000000000000000000000
--------------------XX--TTTTTT--XXXX0000000000000000000000000000000000000000000000000000000000000000000000000000000000000000000
--------------------XX------XXXXXXXX0000000000000000000000000000000000000000000000000000000000000000000000000000000000000000000
--------------------XX----------XXXX0000000000000000000000000000000000000000000000000000000000000000000000000000000000000000000
--------------------XXXXXXXXE--XXXX-0000000000000000000000000000000000000000000000000000000000000000000000000000000000000000000
--------------------XXXX-------XXXXX0000000000000000000000000000000000000000000000000000000000000000000000000000000000000000000
--------------------XXXX--------XXXX0000000000000000000000000000000000000000000000000000000000000000000000000000000000000000000
--------------------XXXX--------XXXX0000000000000000000000000000000000000000000000000000000000000000000000000000000000000000000
--------------------XTTTT-------DXXX0000000000000000000000000000000000000000000000000000000000000000000000000000000000000000000
--------------------XXXX--------XXXX0000000000000000000000000000000000000000000000000000000000000000000000000000000000000000000
--------------------XXXX--------XXXX0000000000000000000000000000000000000000000000000000000000000000000000000000000000000000000
----------------E---XXXXXXXXXXXX----0000000000000000000000000000000000000000000000000000000000000000000000000000000000000000000
---------------<>---TTTTXXXXXXXX--DX0000000000000000000000000000000000000000000000000000000000000000000000000000000000000000000
---------------[]-----TTTTTTTT----DX0000000000000000000000000000000000000000000000000000000000000000000000000000000000000000000
XXXXXXXXXXXXXXXXXXXX---------TTTTTTT0000000000000000000000000000000000000000000000000000000000000000000000000000000000000000000
0000000000000000000000000000000000000000000000000000000000000000000000000000000000000000000000000000000000000000000000000000000