0000000000000000000000000000000000000000----------------
0000000000000000000000000000000000000000---------TTT----
0000000000000000000000000000000000000000----------------
0000000000000000000000000000000000000000XX----------TTTT
0000000000000000000000000000000000000000XX-------------X
0000000000000000000000000000000000000000XXXX--TT-------X
0000000000000000000000000000000000000000XXXX-----------X
0000000000000000000000000000000000000000XXXX-----------X
0000000000000000000000000000000000000000XX----TTTTTTTTTT
0000000000000000000000000000000000000000XXE------------X
0000000000000000000000000000000000000000XX-------------X
0000000000000000000000000000000000000000XXXXXXXX-------X
0000000000000000000000000000000000000000XXXX------------
0000000000000000000000000000000000000000XX-------------X
0000000000000000000000000000000000000000XX-------TTTTTTT
0000000000000000000000000000000000000000XD-------------X
0000000000000000000000000000000000000000XD-------------X
0000000000000000000000000000000000000000TTTTXXXXXXXX---X
0000000000000000000000000000000000000000--TTTTTTTT-----X
0000000000000000000000000000000000000000---------TTTTTTT
0000000000000000000000000000000000000000XX-----------XXX
0000000000000000000000000000000000000000-XXXXXXXE--XXXX-
0000000000000000000000000000000000000000-XXXX------XXXX-
0000000000000000000000000000000000000000-XXXX------XXXX-
0000000000000000000000000000000000000000-XXXX----EXXXXX-
0000000000000000000000000000000000000000XX----------XXXX
0000000000000000000000000000000000000000XX----------XXXX
0000000000000000000000000000000000000000XXXXXXXXX---XXXX
0000000000000000000000000000000000000000XXXX-----------X
0000000000000000000000000000000000000000XXXX-----------X
0000000000000000000000000000000000000000XXXX------------
0000000000000000000000000000000000000000XXXX--TTTT------
0000000000000000000000000000000000000000XXXX------------
0000000000000000000000000000000000000000XX-------------X
0000000000000000000000000000000000000000XX--------TTTTTT
0000000000000000000000000000000000000000XD-------------X
0000000000000000000000000000000000000000XD-------------X
0000000000000000000000000000000000000000TTTTXXXXXXXX--DX
0000000000000000000000000000000000000000--TTTTTTTT-----X
0000000000000000000000000000000000000000---------TTTTTTT
0000000000000000000000000000000000000000XXXX--------XXXX
0000000000000000000000000000000000000000XXTTTT------XXXX
0000000000000000000000000000000000000000XXXX--------XXXX
0000000000000000000000000000000000000000XXXX--------XXXX
0000000000000000000000000000000000000000XXXX--------XXXX
0000000000000000000000000000000000000000XXXX--------XXXX
0000000000000000000000000000000000000000XX-------XXXXXXX
0000000000000000000000000000000000000000XXXXXXXXXXXX--X-
0000000000000000000000000000000000000000XXXXXXXXXXX----X
0000000000000000000000000000000000000000X-----------TTTT
0000000000000000000000000000000000000000X--------------X
0000000000000000000000000000000000000000X--------------X
0000000000000000000000000000000000000000XXXXXXXXX------X
0000000000000000000000000000000000000000XX-------------X
0000000000000000000000000000000000000000XX--------TTTTTT
0000000000000000000000000000000000000000XD-------------X
0000000000000000000000000000000000000000XD-------------X
0000000000000000000000000000000000000000TTTTXXXXXXXX--DX
0000000000000000000000000000000000000000--TTTTTTTT-----X
0000000000000000000000000000000000000000---------TTTTTTT
0000000000000000000000000000000000000000----------------
0000000000000000000000000000000000000000----------------
0000000000000000000000000000000000000000TTTT------------
0000000000000000000000000000000000000000----------------
0000000000000000000000000000000000000000----------------
0000000000000000000000000000000000000000------TTT-------
0000000000000000000000000000000000000000----------------
0000000000000000000000000000000000000000----------TT----
0000000000000000000000000000000000000000----------------
0000000000000000000000000000000000000000X-----------TTTT
0000000000000000000000000000000000000000X--------------X
0000000000000000000000000000000000000000X--------------X
0000000000000000000000000000000000000000XXXXXXXXX------X
0000000000000000000000000000000000000000XX-------------X
0000000000000000000000000000000000000000XX--------TTTTTT
0000000000000000000000000000000000000000XD-------------X
0000000000000000000000000000000000000000XD-------------X
0000000000000000000000000000000000000000TTTTXXXXXXXX--DX
0000000000000000000000000000000000000000--TTTTTTTT-----X
0000000000000000000000000000000000000000---------TTTTTTT
0000000000000000000000000000000000000000----XXXXXXXX----
0000000000000000000000000000000000000000----------------
0000000000000000000000000000000000000000-----TTTT-------
0000000000000000000000000000000000000000----------------
0000000000000000000000000000000000000000----------------
0000000000000000000000000000000000000000TTTTTTTT----TTTT
0000000000000000000000000000000000000000----------------
0000000000000000000000000000000000000000----------------
0000000000000000000000000000000000000000------TTTT------
0000000000000000000000000000000000000000----------------
0000000000000000000000000000000000000000---XXXX--TTT----
0000000000000000000000000000000000000000---XXXX---XXXX--
0000000000000000000000000000000000000000---XXXX---XXXX--
0000000000000000000000000000000000000000---XXTTTT--XXXX-
0000000000000000000000000000000000000000XXXXXXXXXXX---XX
0000000000000000000000000000000000000000XD------------XX
0000000000000000000000000000000000000000XD------------XX
0000000000000000000000000000000000000000TTTTXXXXXXXX--XX
0000000000000000000000000000000000000000--TTTTTTTT-----X
0000000000000000000000000000000000000000---------TTTTTTT
0000000000000000000000000000000000000000XXXX--------XXXX
0000000000000000000000000000000000000000XX------------XX
0000000000000000000000000000000000000000XX-----XXXX---XX
0000000000000000000000000000000000000000XX------------XX
0000000000000000000000000000000000000000XXXX--------XXXX
0000000000000000000000000000000000000000XXXXXX------XXXX
0000000000000000000000000000000000000000XXXX--------XXXX
0000000000000000000000000000000000000000XXXX--------XXXX
0000000000000000000000000000000000000000XX----TTTTTTTTXX
0000000000000000000000000000000000000000XX------------XX
0000000000000000000000000000000000000000XX------------XX
0000000000000000000000000000000000000000XXXX--------XXXX
0000000000000000000000000000000000000000XXXX------------
0000000000000000000000000000000000000000XX-------------X
0000000000000000000000000000000000000000XX-------TTTTTTT
0000000000000000000000000000000000000000XD-------------X
0000000000000000000000000000000000000000XD-------------X
0000000000000000000000000000000000000000TTTTXXXXXXXX---X
0000000000000000000000000000000000000000--TTTTTTTT-----X
0000000000000000000000000000000000000000---------TTTTTTT
0000000000000000000000000000000000000000MMMMMMMMXMMMMMMM
0000000000000000000000000000000000000000----------------
0000000000000000000000000000000000000000----------------
0000000000000000000000000000000000000000XMMMMMMMMMMMMMMX
0000000000000000000000000000000000000000X--------------X
0000000000000000000000000000000000000000X----X---------X
0000000000000000000000000000000000000000X--------------X
0000000000000000000000000000000000000000----------------
0000000000000000000000000000000000000000----------------
0000000000000000000000000000000000000000XXXX------------
0000000000000000000000000000000000000000XXXX------------
0000000000000000000000000000000000000000XXXX--TTTT------
0000000000000000000000000000000000000000XXXX------------
0000000000000000000000000000000000000000XX-------------X
0000000000000000000000000000000000000000XX--------TTTTTT
0000000000000000000000000000000000000000XD-------------X
0000000000000000000000000000000000000000XD-------------X
0000000000000000000000000000000000000000TTTTXXXXXXXX--DX
0000000000000000000000000000000000000000--TTTTTTTT-----X
0000000000000000000000000000000000000000---------TTTTTTT
0000000000000000000000000000000000000000----------------
0000000000000000000000000000000000000000----TTTT--------
0000000000000000000000000000000000000000----------------
0000000000000000000000000000000000000000----------------
0000000000000000000000000000000000000000----------------
0000000000000000000000000000000000000000------TTTT------
0000000000000000000000000000000000000000----------------
0000000000000000000000000000000000000000---------TTT----
0000000000000000000000000000000000000000----------------
0000000000000000000000000000000000000000X-----------TTTT
0000000000000000000000000000000000000000X--------------X
0000000000000000000000000000000000000000X--------------X
0000000000000000000000000000000000000000XXXXXXXXXXXX---X
0000000000000000000000000000000000000000XX-------------X
0000000000000000000000000000000000000000XX--------TTTTTT
----------------------------------------XD-------------X
----------------------------------------XD-------------X
----------------------------------------TTTTXXXXXXXX--DX
------------------------------------------TTTTTTTT-----X
S-------------------S---------------SSSS---------TTTTTTT
S-------------------S-------------------0000000000000000
S-------------------S-------------------0000000000000000
S-----S-------------S-------------------0000000000000000
S-------------------S-------------------0000000000000000
S-------------------S-------------------0000000000000000
S-------------------S-------------------0000000000000000
S-------------------S-------------------0000000000000000
S-------------------S-------------------0000000000000000
S-------------------S-------------------0000000000000000
S---E---------------S-E-------------E---0000000000000000
XXXXXXXXXXXXXXXXXXXXXXXXXXXXXXXXXXXXXXXX0000000000000000
00000000000000000000000000000000000000000000000000000000