000000000000000000000000000000000000000000000000000000000000000000000000----------------------------------------000000000000000
000000000000000000000000000000000000000000000000000000000000000000000000----------------------------------------000000000000000
000000000000000000000000000000000000000000000000000000000000000000000000----------------------------------------000000000000000
000000000000000000000000000000000000000000000000000000000000000000000000----------------------------------------000000000000000
00000000000000000000000000000000000000000000000000000000X--------TTTTTTTS-------------------S-------------------000000000000000
00000000000000000000000000000000000000000000000000000000X---------------S-------------------S-------------------000000000000000
00000000000000000000000000000000000000000000000000000000X---------------S-------------------S-------------------000000000000000
00000000000000000000000000000000000000000000000000000000X--TT-----------S-------------------S-------------------000000000000000
00000000000000000000000000000000000000000000000000000000----------------S-------------------S-------------------000000000000000
00000000000000000000000000000000000000000000000000000000-TTTT-----------S-------------------S-------------------000000000000000
00000000000000000000000000000000000000000000000000000000----------------S-------------------S-------------------000000000000000
00000000000000000000000000000000000000000000000000000000----------------S-------------------S-------------------000000000000000
00000000000000000000000000000000000000000000000000000000-------TTT------S-------------------S-------------E---E-000000000000000
00000000000000000000000000000000000000000000000000000000----------------S-------------------S------------<>--<>-000000000000000
00000000000000000000000000000000000000000000000000000000----------------S-------------------S------------[]--[]-000000000000000
00000000000000000000000000000000000000000000000000000000------------TT--XXXXXXXXXXXXXXXXXXXXXXXXXXXXXXXXXXXXXXXX000000000000000
00000000000000000000000000000000000000000000000000000000-------------X--0000000000000000000000000000000000000000000000000000000
00000000000000000000000000000000000000000000000000000000----------------0000000000000000000000000000000000000000000000000000000
00000000000000000000000000000000000000000000000000000000----------------0000000000000000000000000000000000000000000000000000000
00000000000000000000000000000000000000000000000000000000XD-----------TXX0000000000000000000000000000000000000000000000000000000
00000000000000000000000000000000000000000000000000000000XD------------XX0000000000000000000000000000000000000000000000000000000
00000000000000000000000000000000000000000000000000000000TTTTXXXXXXXX--XX0000000000000000000000000000000000000000000000000000000
00000000000000000000000000000000000000000000000000000000--TTTTTTTT-----X0000000000000000000000000000000000000000000000000000000
00000000000000000000000000000000000000000000000000000000---------TTTTTTT0000000000000000000000000000000000000000000000000000000
00000000000000000000000000000000000000000000000000000000----------------0000000000000000000000000000000000000000000000000000000
00000000000000000000000000000000000000000000000000000000---TTTT---------0000000000000000000000000000000000000000000000000000000
00000000000000000000000000000000000000000000000000000000----------------0000000000000000000000000000000000000000000000000000000
00000000000000000000000000000000000000000000000000000000----------------0000000000000000000000000000000000000000000000000000000
000000000000000000000000000000000000--------------------X--TTTTTTTT---XX0000000000000000000000000000000000000000000000000000000
000000000000000000000000000000000000--------------------X-----------XXXX0000000000000000000000000000000000000000000000000000000
000000000000000000000000000000000000--------------------X------------XXX0000000000000000000000000000000000000000000000000000000
000000000000000000000000000000000000--------------------X-------------XX0000000000000000000000000000000000000000000000000000000
00000000000000000000----------------S-------------------X----XX-------XX0000000000000000000000000000000000000000000000000000000
00000000000000000000-----TTTTTTT----S-------------------X--TT--XXXXXX--X0000000000000000000000000000000000000000000000000000000
00000000000000000000----------------S-------------------X--------------X0000000000000000000000000000000000000000000000000000000
00000000000000000000----------------S-------------------X--------------X0000000000000000000000000000000000000000000000000000000
00000000000000000000---TTTT--TTTT---S-------------------XXXXXXXXX------X0000000000000000000000000000000000000000000000000000000
00000000000000000000----------------S-------------------XX-------------X0000000000000000000000000000000000000000000000000000000
00000000000000000000----------------S-------------------XX--------TTTTTT0000000000000000000000000000000000000000000000000000000
00000000000000000000-------X-TTT----S-------------------XD-------------X0000000000000000000000000000000000000000000000000000000
00000000000000000000-------X--------S-------------------XD-------------X0000000000000000000000000000000000000000000000000000000
00000000000000000000X-----------TTTTS-------------------TTTTXXXXXXXX--DX0000000000000000000000000000000000000000000000000000000
00000000000000000000X--------------XS---------E--E--------TTTTTTTT-----X0000000000000000000000000000000000000000000000000000000
00000000000000000000X--------------XXXXXXXXXXXXXXXXXXXXX---------TTTTTTT0000000000000000000000000000000000000000000000000000000
00000000000000000000XXXXXXXXX------X0000000000000000000000000000000000000000000000000000000000000000000000000000000000000000000
00000000000000000000XX-------------X0000000000000000000000000000000000000000000000000000000000000000000000000000000000000000000
00000000000000000000XX--------TTTTTT0000000000000000000000000000000000000000000000000000000000000000000000000000000000000000000
00000000000000000000XD-------------X0000000000000000000000000000000000000000000000000000000000000000000000000000000000000000000
00000000000000000000XD-------------X0000000000000000000000000000000000000000000000000000000000000000000000000000000000000000000
00000000000000000000TTTTXXXXXXXX--DX0000000000000000000000000000000000000000000000000000000000000000000000000000000000000000000
00000000000000000000--TTTTTTTT-----X0000000000000000000000000000000000000000000000000000000000000000000000000000000000000000000
00000000000000000000---------TTTTTTT0000000000000000000000000000000000000000000000000000000000000000000000000000000000000000000
00000000000000000000XXXX--------XXXX0000000000000000000000000000000000000000000000000000000000000000000000000000000000000000000
00000000000000000000XXXXXX------XXXX0000000000000000000000000000000000000000000000000000000000000000000000000000000000000000000
00000000000000000000XXXX--------XXXX0000000000000000000000000000000000000000000000000000000000000000000000000000000000000000000
00000000000000000000XXXX--------XXXX0000000000000000000000000000000000000000000000000000000000000000000000000000000000000000000
00000000000000000000XX----TTTTTTTTXX0000000000000000000000000000000000000000000000000000000000000000000000000000000000000000000
00000000000000000000XX------------XX0000000000000000000000000000000000000000000000000000000000000000000000000000000000000000000
00000000000000000000XXXX---------XXX0000000000000000000000000000000000000000000000000000000000000000000000000000000000000000000
00000000000000000000XX------------XX0000000000000000000000000000000000000000000000000000000000000000000000000000000000000000000
00000000000000000000XXE------------X0000000000000000000000000000000000000000000000000000000000000000000000000000000000000000000
00000000000000000000XXXXXXXXXXX----X0000000000000000000000000000000000000000000000000000000000000000000000000000000000000000000
00000000000000000000XXXX-----------X0000000000000000000000000000000000000000000000000000000000000000000000000000000000000000000
00000000000000000000X--------------X0000000000000000000000000000000000000000000000000000000000000000000000000000000000000000000
00000000000000000000XXXXXXXXX------X0000000000000000000000000000000000000000000000000000000000000000000000000000000000000000000
00000000000000000000XX-------------X0000000000000000000000000000000000000000000000000000000000000000000000000000000000000000000
00000000000000000000XX--------TTTTTT0000000000000000000000000000000000000000000000000000000000000000000000000000000000000000000
00000000000000000000XD-------------X0000000000000000000000000000000000000000000000000000000000000000000000000000000000000000000
00000000000000000000XD-------------X0000000000000000000000000000000000000000000000000000000000000000000000000000000000000000000
00000000000000000000TTTTXXXXXXXX--DX0000000000000000000000000000000000000000000000000000000000000000000000000000000000000000000
00000000000000000000--TTTTTTTT-----X0000000000000000000000000000000000000000000000000000000000000000000000000000000000000000000
00000000000000000000---------TTTTTTT0000000000000000000000000000000000000000000000000000000000000000000000000000000000000000000
00000000000000000000XXXX---------XXX0000000000000000000000000000000000000000000000000000000000000000000000000000000000000000000
00000000000000000000XXXXXXXXXXXX----0000000000000000000000000000000000000000000000000000000000000000000000000000000000000000000
00000000000000000000XXXX------XXXXXX0000000000000000000000000000000000000000000000000000000000000000000000000000000000000000000
00000000000000000000----------------0000000000000000000000000000000000000000000000000000000000000000000000000000000000000000000
00000000000000000000----------------0000000000000000000000000000000000000000000000000000000000000000000000000000000000000000000
00000000000000000000MMMMMMMMMMMMMMMM0000000000000000000000000000000000000000000000000000000000000000000000000000000000000000000
00000000000000000000----------------0000000000000000000000000000000000000000000000000000000000000000000000000000000000000000000
00000000000000000000----------------0000000000000000000000000000000000000000000000000000000000000000000000000000000000000000000
00000000000000000000MMMMMMMMMMMMMMMM0000000000000000000000000000000000000000000000000000000000000000000000000000000000000000000
00000000000000000000----------------0000000000000000000000000000000000000000000000000000000000000000000000000000000000000000000
00000000000000000000----------------0000000000000000000000000000000000000000000000000000000000000000000000000000000000000000000
00000000000000000000MMMMMMMMMMMMMMMM0000000000000000000000000000000000000000000000000000000000000000000000000000000000000000000
00000000000000000000----------------0000000000000000000000000000000000000000000000000000000000000000000000000000000000000000000
00000000000000000000----------------0000000000000000000000000000000000000000000000000000000000000000000000000000000000000000000
00000000000000000000XXXX----------XX0000000000000000000000000000000000000000000000000000000000000000000000000000000000000000000
00000000000000000000XD-------------X0000000000000000000000000000000000000000000000000000000000000000000000000000000000000000000
00000000000000000000XD-------------X0000000000000000000000000000000000000000000000000000000000000000000000000000000000000000000
00000000000000000000TTTTXXXXXXXX---X0000000000000000000000000000000000000000000000000000000000000000000000000000000000000000000
00000000000000000000--TTTTTTTT-----X0000000000000000000000000000000000000000000000000000000000000000000000000000000000000000000
00000000000000000000---------TTTTTTT0000000000000000000000000000000000000000000000000000000000000000000000000000000000000000000
00000000000000000000----------------0000000000000000000000000000000000000000000000000000000000000000000000000000000000000000000
00000000000000000000------------X---0000000000000000000000000000000000000000000000000000000000000000000000000000000000000000000
00000000000000000000------------X---0000000000000000000000000000000000000000000000000000000000000000000000000000000000000000000
00000000000000000000------------X---0000000000000000000000000000000000000000000000000000000000000000000000000000000000000000000
--------------------------------X---0000000000000000000000000000000000000000000000000000000000000000000000000000000000000000000
--------------------------------X---0000000000000000000000000000000000000000000000000000000000000000000000000000000000000000000
------------------------------------0000000000000000000000000000000000000000000000000000000000000000000000000000000000000000000
------------------------------------0000000000000000000000000000000000000000000000000000000000000000000000000000000000000000000
S-------------------X-----TTTT-TTTTT0000000000000000000000000000000000000000000000000000000000000000000000000000000000000000000
S-------------------X---------------0000000000000000000000000000000000000000000000000000000000000000000000000000000000000000000
S-------------------X---------------0000000000000000000000000000000000000000000000000000000000000000000000000000000000000000000
S-------------------X--------XXXX---0000000000000000000000000000000000000000000000000000000000000000000000000000000000000000000
S-------------------XXXXXXXXXXXX----0000000000000000000000000000000000000000000000000000000000000000000000000000000000000000000
S-------------------XXXX-------XXXXX0000000000000000000000000000000000000000000000000000000000000000000000000000000000000000000
S-------------------XX-------TTTT-TT0000000000000000000000000000000000000000000000000000000000000000000000000000000000000000000
S-------------------XD-------------X0000000000000000000000000000000000000000000000000000000000000000000000000000000000000000000
S-------------------XD-------------X0000000000000000000000000000000000000000000000000000000000000000000000000000000000000000000
S-------------------TTTTXXXXXXXX---X0000000000000000000000000000000000000000000000000000000000000000000000000000000000000000000
S---------------------TTTTTTTT-----X0000000000000000000000000000000000000000000000000000000000000000000000000000000000000000000
XXXXXXXXXXXXXXXXXXXX---------TTTTTTT0000000000000000000000000000000000000000000000000000000000000000000000000000000000000000000
0000000000000000000000000000000000000000000000000000000000000000000000000000000000000000000000000000000000000000000000000000000