00000000000000000000000000000000000000000000000000000000000000000000000000000000000000000000000000000000000000000000000000000000XXXX------XXXX--
00000000000000000000000000000000000000000000000000000000000000000000000000000000000000000000000000000000000000000000000000000000XXXX------XXXX--
00000000000000000000000000000000000000000000000000000000000000000000000000000000000000000000000000000000000000000000000000000000XXXX------XXXX--
00000000000000000000000000000000000000000000000000000000000000000000000000000000000000000000000000000000000000000000000000000000XXXX------XXXX--
00000000000000000000000000000000000000000000000000000000000000000000000000000000000000000000000000000000000000000000000000000000XXXX------XXXX--
00000000000000000000000000000000000000000000000000000000000000000000000000000000000000000000000000000000000000000000000000000000XXXX------XXXX--
00000000000000000000000000000000000000000000000000000000000000000000000000000000000000000000000000000000000000000000000000000000XXXX------XXXX--
00000000000000000000000000000000000000000000000000000000000000000000000000000000000000000000000000000000000000000000000000000000XXXX------XXXX--
000000000000000000000000000000000000000000000000000000000000000000000000000000000000000000000000000000000000--------------------XXXXXXXE--XXXX--
000000000000000000000000000000000000000000000000000000000000000000000000000000000000000000000000000000000000--------------------XXXX------XXXX--
000000000000000000000000000000000000000000000000000000000000000000000000000000000000000000000000000000000000--------------------XXXX-------XXXX-
000000000000000000000000000000000000000000000000000000000000000000000000000000000000000000000000000000000000--------------------XX----TTTTTTTTXX
000000000000000000000000000000000000000000000000000000000000000000000000000000000000000000000000000000000000--------------------XX------------XX
000000000000000000000000000000000000000000000000000000000000000000000000000000000000000000000000000000000000--------------------XX------------XX
000000000000000000000000000000000000000000000000000000000000000000000000000000000000000000000000000000000000--------------------XXXXXXXX------XX
000000000000000000000000000000000000000000000000000000000000000000000000000000000000000000000000000000000000--------------------XX----XXXXX---XX
000000000000000000000000000000000000000000000000000000000000000000000000000000000000000000000000000000000000--------------------XD------------XX
000000000000000000000000000000000000000000000000000000000000000000000000000000000000000000000000000000000000--------------------XD------------XX
000000000000000000000000000000000000000000000000000000000000000000000000000000000000000000000000000000000000--------------------XXXXX-------XXXX
000000000000000000000000000000000000000000000000000000000000000000000000000000000000000000000000000000000000-----------Q-------SXXXXXXXXXXXXXXXX
00000000000000000000000000000000000000000000000000000000000000000000000000000000000000000000--------XTTTT-----------------------0000000000000000
00000000000000000000000000000000000000000000000000000000000000000000000000000000000000000000------------------------------------0000000000000000
00000000000000000000000000000000000000000000000000000000000000000000000000000000000000000000----------------------E-----E-------0000000000000000
00000000000000000000000000000000000000000000000000000000000000000000000000000000000000000000----------------XXXXXXXXXXXXXXXXXXXX0000000000000000
0000000000000000000000000000000000000000000000000000----------------------------------------XX------TTTTTTXX000000000000000000000000000000000000
0000000000000000000000000000000000000000000000000000----------------------------------------XX------------XX000000000000000000000000000000000000
0000000000000000000000000000000000000000000000000000----------------------------------------XX------------XX000000000000000000000000000000000000
0000000000000000000000000000000000000000000000000000----------------------------------------XXXX--------XXXX000000000000000000000000000000000000
0000000000000000000000000000000000000000000000000000----------------------------------------XXXXXX------XXXX000000000000000000000000000000000000
0000000000000000000000000000000000000000000000000000----------------------------------------XXXX--------XXXX000000000000000000000000000000000000
0000000000000000000000000000000000000000000000000000----------------------------------------XXXX--------XXXX000000000000000000000000000000000000
0000000000000000000000000000000000000000000000000000----------------------------------------XX----TTTTTTTTXX000000000000000000000000000000000000
0000000000000000000000000000000000000000000000000000----------------------------------------XX------------XX000000000000000000000000000000000000
0000000000000000000000000000000000000000000000000000----------------------------------------XX------------XX000000000000000000000000000000000000
0000000000000000000000000000000000000000000000000000---E------------------------------------XXXXXXXX------XX000000000000000000000000000000000000
0000000000000000000000000000000000000000000000000000--<>------------------------------------XX----XXXXX---XX000000000000000000000000000000000000
0000000000000000000000000000000000000000000000000000--[]----------------------------E-------XD------------XX000000000000000000000000000000000000
0000000000000000000000000000000000000000000000000000--[]------------------------------------XD------------XX000000000000000000000000000000000000
0000000000000000000000000000000000000000000000000000--[]---E------------------X--E----------XXXXX-------XXXX000000000000000000000000000000000000
000000000000000000000000000000000000---------XXXXX--XXXXXXXXXXXXXXXXXXXXXXXXXXXXXXXXXXXXXXXXXXXXXXXXXXXXXXXX000000000000000000000000000000000000
000000000000000000000000000000000000---------XX-----00000000000000000000000000000000000000000000000000000000000000000000000000000000000000000000
000000000000000000000000000000000000------XXXXX-----00000000000000000000000000000000000000000000000000000000000000000000000000000000000000000000
000000000000000000000000000000000000------XX--------00000000000000000000000000000000000000000000000000000000000000000000000000000000000000000000
000000000000000000000000000000000000---XXXXX--------00000000000000000000000000000000000000000000000000000000000000000000000000000000000000000000
000000000000000000000000000000000000---XX-----------00000000000000000000000000000000000000000000000000000000000000000000000000000000000000000000
000000000000000000000000000000000000---XX-----------00000000000000000000000000000000000000000000000000000000000000000000000000000000000000000000
000000000000000000000000000000000000XXXX----------XX00000000000000000000000000000000000000000000000000000000000000000000000000000000000000000000
000000000000000000000000000000000000XXXX----------DX00000000000000000000000000000000000000000000000000000000000000000000000000000000000000000000
000000000000000000000000000000000000XXXX----------DX00000000000000000000000000000000000000000000000000000000000000000000000000000000000000000000
000000000000000000000000000000000000XXXX----XXXXXXXX00000000000000000000000000000000000000000000000000000000000000000000000000000000000000000000
000000000000000000000000000000000000---X-X----------00000000000000000000000000000000000000000000000000000000000000000000000000000000000000000000
000000000000000000000000000000000000---X------------00000000000000000000000000000000000000000000000000000000000000000000000000000000000000000000
000000000000000000000000000000000000XXX-----------XX00000000000000000000000000000000000000000000000000000000000000000000000000000000000000000000
000000000000000000000000000000000000XXXXXXXXXXXX--XX00000000000000000000000000000000000000000000000000000000000000000000000000000000000000000000
000000000000000000000000000000000000XX------------XX00000000000000000000000000000000000000000000000000000000000000000000000000000000000000000000
000000000000000000000000000000000000XX-----------XXX00000000000000000000000000000000000000000000000000000000000000000000000000000000000000000000
000000000000000000000000000000000000XD-----------XXX00000000000000000000000000000000000000000000000000000000000000000000000000000000000000000000
000000000000000000000000000000000000XXXXX-------XXXX00000000000000000000000000000000000000000000000000000000000000000000000000000000000000000000
000000000000000000000000000000000000XXXXXXXXXXXXXXXX00000000000000000000000000000000000000000000000000000000000000000000000000000000000000000000
000000000000000000000000000000000000---------TTT----00000000000000000000000000000000000000000000000000000000000000000000000000000000000000000000
000000000000000000000000000000000000----------------00000000000000000000000000000000000000000000000000000000000000000000000000000000000000000000
000000000000000000000000000000000000X-----------TTTT00000000000000000000000000000000000000000000000000000000000000000000000000000000000000000000
000000000000000000000000000000000000X--------------X00000000000000000000000000000000000000000000000000000000000000000000000000000000000000000000
0000000000000000--------------------X--------------X00000000000000000000000000000000000000000000000000000000000000000000000000000000000000000000
0000000000000000--------------------XXXXXXXXX------X00000000000000000000000000000000000000000000000000000000000000000000000000000000000000000000
0000000000000000--------------------XXXX------------00000000000000000000000000000000000000000000000000000000000000000000000000000000000000000000
0000000000000000--------------------XXXX------------00000000000000000000000000000000000000000000000000000000000000000000000000000000000000000000
0000000000000000--------------------XXXX------------00000000000000000000000000000000000000000000000000000000000000000000000000000000000000000000
0000000000000000--------------------XXXXXXXXXXX-----00000000000000000000000000000000000000000000000000000000000000000000000000000000000000000000
0000000000000000--------------------XXXX------XXXXXX00000000000000000000000000000000000000000000000000000000000000000000000000000000000000000000
0000000000000000----------------------XX------------00000000000000000000000000000000000000000000000000000000000000000000000000000000000000000000
0000000000000000-----------------------X------------00000000000000000000000000000000000000000000000000000000000000000000000000000000000000000000
0000000000000000--------------------XXXX----------XX00000000000000000000000000000000000000000000000000000000000000000000000000000000000000000000
0000000000000000--------------------XXXXXXXX------XX00000000000000000000000000000000000000000000000000000000000000000000000000000000000000000000
0000000000000000--------------------XX----XXXXX---XX00000000000000000000000000000000000000000000000000000000000000000000000000000000000000000000
0000000000000000--------------------XD------------XX00000000000000000000000000000000000000000000000000000000000000000000000000000000000000000000
0000000000000000--------------------XD------------XX00000000000000000000000000000000000000000000000000000000000000000000000000000000000000000000
0000000000000000--------------------XXXXX-------XXXX00000000000000000000000000000000000000000000000000000000000000000000000000000000000000000000
--XXXXEEEX------XXXXXXXXXXXXXXXXXXXXXXXXXXXXXXXXXXXX00000000000000000000000000000000000000000000000000000000000000000000000000000000000000000000
XXXXXX-XX-------00000000000000000000000000000000000000000000000000000000000000000000000000000000000000000000000000000000000000000000000000000000
----------------00000000000000000000000000000000000000000000000000000000000000000000000000000000000000000000000000000000000000000000000000000000
----------------00000000000000000000000000000000000000000000000000000000000000000000000000000000000000000000000000000000000000000000000000000000
-------XTTTT----00000000000000000000000000000000000000000000000000000000000000000000000000000000000000000000000000000000000000000000000000000000
----------------00000000000000000000000000000000000000000000000000000000000000000000000000000000000000000000000000000000000000000000000000000000
--------T-------00000000000000000000000000000000000000000000000000000000000000000000000000000000000000000000000000000000000000000000000000000000
----------------00000000000000000000000000000000000000000000000000000000000000000000000000000000000000000000000000000000000000000000000000000000
----------------00000000000000000000000000000000000000000000000000000000000000000000000000000000000000000000000000000000000000000000000000000000
----------------00000000000000000000000000000000000000000000000000000000000000000000000000000000000000000000000000000000000000000000000000000000
TTTTTTTT------XX00000000000000000000000000000000000000000000000000000000000000000000000000000000000000000000000000000000000000000000000000000000
---------TTTTTTT00000000000000000000000000000000000000000000000000000000000000000000000000000000000000000000000000000000000000000000000000000000
XXXXXXXXXXXX----00000000000000000000000000000000000000000000000000000000000000000000000000000000000000000000000000000000000000000000000000000000
XXXXXXXXXXXXXXXX00000000000000000000000000000000000000000000000000000000000000000000000000000000000000000000000000000000000000000000000000000000
XXXX----------XX00000000000000000000000000000000000000000000000000000000000000000000000000000000000000000000000000000000000000000000000000000000
XX--------TTTTXX00000000000000000000000000000000000000000000000000000000000000000000000000000000000000000000000000000000000000000000000000000000
XD------------XX00000000000000000000000000000000000000000000000000000000000000000000000000000000000000000000000000000000000000000000000000000000
XD------------XX00000000000000000000000000000000000000000000000000000000000000000000000000000000000000000000000000000000000000000000000000000000
XXXXX-------XXXX00000000000000000000000000000000000000000000000000000000000000000000000000000000000000000000000000000000000000000000000000000000
XXXXXXXXXXXXXXXX00000000000000000000000000000000000000000000000000000000000000000000000000000000000000000000000000000000000000000000000000000000
XXTTTT------XXXX00000000000000000000000000000000000000000000000000000000000000000000000000000000000000000000000000000000000000000000000000000000
XXXX--------XXXX00000000000000000000000000000000000000000000000000000000000000000000000000000000000000000000000000000000000000000000000000000000
XXXX--------XXXX00000000000000000000000000000000000000000000000000000000000000000000000000000000000000000000000000000000000000000000000000000000
XXXX--------XXXX00000000000000000000000000000000000000000000000000000000000000000000000000000000000000000000000000000000000000000000000000000000
XXXX--------XXXX00000000000000000000000000000000000000000000000000000000000000000000000000000000000000000000000000000000000000000000000000000000
XXXX--------XXXX00000000000000000000000000000000000000000000000000000000000000000000000000000000000000000000000000000000000000000000000000000000
XXTTTT------XXXX00000000000000000000000000000000000000000000000000000000000000000000000000000000000000000000000000000000000000000000000000000000
XXXX--------XXXX00000000000000000000000000000000000000000000000000000000000000000000000000000000000000000000000000000000000000000000000000000000
XXXX--------XXXX00000000000000000000000000000000000000000000000000000000000000000000000000000000000000000000000000000000000000000000000000000000
XXXX--------XXXX00000000000000000000000000000000000000000000000000000000000000000000000000000000000000000000000000000000000000000000000000000000
XXXX--------XXXX00000000000000000000000000000000000000000000000000000000000000000000000000000000000000000000000000000000000000000000000000000000
XXXX--------XXXX00000000000000000000000000000000000000000000000000000000000000000000000000000000000000000000000000000000000000000000000000000000
XXXX--------XXXX00000000000000000000000000000000000000000000000000000000000000000000000000000000000000000000000000000000000000000000000000000000
XXXX--------XXXX00000000000000000000000000000000000000000000000000000000000000000000000000000000000000000000000000000000000000000000000000000000
XXXX--------XXXX00000000000000000000000000000000000000000000000000000000000000000000000000000000000000000000000000000000000000000000000000000000
XX-----XXXX-XXXX00000000000000000000000000000000000000000000000000000000000000000000000000000000000000000000000000000000000000000000000000000000
XX----------XXXX00000000000000000000000000000000000000000000000000000000000000000000000000000000000000000000000000000000000000000000000000000000
XD-----------XXX00000000000000000000000000000000000000000000000000000000000000000000000000000000000000000000000000000000000000000000000000000000
XXXXX-------XXXX00000000000000000000000000000000000000000000000000000000000000000000000000000000000000000000000000000000000000000000000000000000
XXXXXXXXXXXXXXXX00000000000000000000000000000000000000000000000000000000000000000000000000000000000000000000000000000000000000000000000000000000