0000000000000000000000000000000000000000000000000000000000000000000000000000000000000000000000000000000000000000000000000000000000000000000000000000--------------------000000000000000
0000000000000000000000000000000000000000000000000000000000000000000000000000000000000000000000000000000000000000000000000000000000000000000000000000--------------------000000000000000
0000000000000000000000000000000000000000000000000000000000000000000000000000000000000000000000000000000000000000000000000000000000000000000000000000--------------------000000000000000
0000000000000000000000000000000000000000000000000000000000000000000000000000000000000000000000000000000000000000000000000000000000000000000000000000--------------------000000000000000
000000000000000000000000000000000000000000000000000000000000000000000000000000000000000000000000000000000000000000000000000000000000XXXX--------XXXXS-------------------000000000000000
000000000000000000000000000000000000000000000000000000000000000000000000000000000000000000000000000000000000000000000000000000000000XXTTTT------XXXXS-------------------000000000000000
000000000000000000000000000000000000000000000000000000000000000000000000000000000000000000000000000000000000000000000000000000000000XXXX--------XXXXS-------------------000000000000000
000000000000000000000000000000000000000000000000000000000000000000000000000000000000000000000000000000000000000000000000000000000000XXXX--------XXXXS-------------------000000000000000
000000000000000000000000000000000000000000000000000000000000000000000000000000000000000000000000000000000000000000000000000000000000XXXXXXXXXXXXXXXXS-------------------000000000000000
000000000000000000000000000000000000000000000000000000000000000000000000000000000000000000000000000000000000000000000000000000000000XXXX-------XXXXXS------------------X000000000000000
000000000000000000000000000000000000000000000000000000000000000000000000000000000000000000000000000000000000000000000000000000000000XXXX--X---XXXXXXS-----------------EX000000000000000
000000000000000000000000000000000000000000000000000000000000000000000000000000000000000000000000000000000000000000000000000000000000XXXX--------XXXXS--------------XXXXX000000000000000
000000000000000000000000000000000000000000000000000000000000000000000000000000000000000000000000000000000000000000000000000000000000XXXX--------XXXXS-------------XXXXXX000000000000000
000000000000000000000000000000000000000000000000000000000000000000000000000000000000000000000000000000000000000000000000000000000000XXXX--------XXXXS------------XXXXXXX000000000000000
000000000000000000000000000000000000000000000000000000000000000000000000000000000000000000000000000000000000000000000000000000000000XXXX--------XXXXS--E--------XXXXXXXX000000000000000
000000000000000000000000000000000000000000000000000000000000000000000000000000000000000000000000000000000000000000000000000000000000XXXXXXX-----XXXXXXXXXXXXXXXXXXXXXXXX000000000000000
000000000000000000000000000000000000000000000000000000000000000000000000000000000000000000000000000000000000000000000000000000000000X-------XXXXXXXX00000000000000000000000000000000000
000000000000000000000000000000000000000000000000000000000000000000000000000000000000000000000000000000000000000000000000000000000000X-----------XXXX00000000000000000000000000000000000
000000000000000000000000000000000000000000000000000000000000000000000000000000000000000000000000000000000000000000000000000000000000X-------------XX00000000000000000000000000000000000
000000000000000000000000000000000000000000000000000000000000000000000000000000000000000000000000000000000000000000000000000000000000X-------------XX00000000000000000000000000000000000
000000000000000000000000000000000000000000000000000000000000000000000000000000000000000000000000000000000000000000000000000000000000XXXX----------XX00000000000000000000000000000000000
000000000000000000000000000000000000000000000000000000000000000000000000000000000000000000000000000000000000000000000000000000000000TTTTXXXXXXXX--XX00000000000000000000000000000000000
000000000000000000000000000000000000000000000000000000000000000000000000000000000000000000000000000000000000000000000000000000000000--TTTTTTTT----DX00000000000000000000000000000000000
000000000000000000000000000000000000000000000000000000000000000000000000000000000000000000000000000000000000000000000000000000000000---------TTTTTTT00000000000000000000000000000000000
000000000000000000000000000000000000000000000000000000000000000000000000000000000000000000000000000000000000000000000000000000000000XXXX--------XXXX00000000000000000000000000000000000
000000000000000000000000000000000000000000000000000000000000000000000000000000000000000000000000000000000000000000000000000000000000XXXX---------XXX00000000000000000000000000000000000
000000000000000000000000000000000000000000000000000000000000000000000000000000000000000000000000000000000000000000000000000000000000------TTTT------00000000000000000000000000000000000
000000000000000000000000000000000000000000000000000000000000000000000000000000000000000000000000000000000000000000000000000000000000TTTTTTTTTTTT-TTT00000000000000000000000000000000000
0000000000000000000000000000000000000000000000000000------------------------------------------------------------------------------------------------00000000000000000000000000000000000
0000000000000000000000000000000000000000000000000000--------------------------------------------------------------------------------------------XXX-00000000000000000000000000000000000
0000000000000000000000000000000000000000000000000000--------------------------------------------------------------------------------TTTTTTTT--------00000000000000000000000000000000000
000000000000000000000000000000000000--------------------------------------------------------------------------------------------------------TTTT----00000000000000000000000000000000000
000000000000000000000000000000000000----------------S-------------------S-------------------S-------------------S-----------------------------------00000000000000000000000000000000000
000000000000000000000000000000000000-T----------XXXXS-------------------S-------------------S-------------------S-------------------X-------------XX00000000000000000000000000000000000
000000000000000000000000000000000000----------------S-------------------S-------------------S-------------------S-------------------X-------------DX00000000000000000000000000000000000
0000000000000000--------------------------XXXX------S-------------------S-------------------S-------------------S-------------------X-------------DX00000000000000000000000000000000000
0000000000000000--------------------------XX--------S-------------------S-------------------S-------------------S-------------------X-----XXXXXXXXXX00000000000000000000000000000000000
0000000000000000-----------------------XXXXX--------S-------------------S-------------------S-------------------S-------------------X------------XXX00000000000000000000000000000000000
0000000000000000-----------------------XX-----------S-------------------S-------------------S-------------------S-----------------E-X-------------XX00000000000000000000000000000000000
X-------------XXS-------------------XXXX----------XXS--------------ESS--S-------------------S-------------------S------E---------<>-X-------------XX00000000000000000000000000000000000
X-------------DXS-------------------X-------------XXS-------------------S-------------------S-------------------S----------------[]-XXXX----------XX00000000000000000000000000000000000
X-------------DXS-------------------X-------------DXS-------------------S-------------------S-------------------S---E------------[]-TTTTXXXXXXXX--XX00000000000000000000000000000000000
X--XXXXXXXXXXXXXS-------------------X----XXXXXXXX--XS---EE--------------S--E------------E---S-EE----------------S------------EE--[]---TTTTTTTT----DX00000000000000000000000000000000000
X--X----XXXXXXXXS-------------------X-------XXXXXXXXXXXXXXXXXXXXXXXXXXXXXXXXXXXXXXXXXXXXXXXXXXXXXXXXXXXXXXXXXXXXXXXXXXXXXXXXXXXXXXXX---------TTTTTTT00000000000000000000000000000000000
X--D----------XXS-------------------X-----------XXXX00000000000000000000000000000000000000000000000000000000000000000000000000000000000000000000000000000000000000000000000000000000000
X-TX-----------XS-------------------X-------------XX00000000000000000000000000000000000000000000000000000000000000000000000000000000000000000000000000000000000000000000000000000000000
X--X----XXXX---XS---E---------------X-------------XX00000000000000000000000000000000000000000000000000000000000000000000000000000000000000000000000000000000000000000000000000000000000
X--X-----------XS-------------------XXXX----------XX00000000000000000000000000000000000000000000000000000000000000000000000000000000000000000000000000000000000000000000000000000000000
X--X-----------XS-------------------TTTTXXXXXXXX--XX00000000000000000000000000000000000000000000000000000000000000000000000000000000000000000000000000000000000000000000000000000000000
X-TX-----XXXX--XS-----E---------------TTTTTTTT----DX00000000000000000000000000000000000000000000000000000000000000000000000000000000000000000000000000000000000000000000000000000000000
X--X-----------XXXXXXXXXXXXXXXXXXXXX---------TTTTTTT00000000000000000000000000000000000000000000000000000000000000000000000000000000000000000000000000000000000000000000000000000000000
X--X----------XX00000000000000000000000000000000000000000000000000000000000000000000000000000000000000000000000000000000000000000000000000000000000000000000000000000000000000000000000
X--X-XXXX----XXX00000000000000000000000000000000000000000000000000000000000000000000000000000000000000000000000000000000000000000000000000000000000000000000000000000000000000000000000
X--X----------XX00000000000000000000000000000000000000000000000000000000000000000000000000000000000000000000000000000000000000000000000000000000000000000000000000000000000000000000000
X------DX-----XX00000000000000000000000000000000000000000000000000000000000000000000000000000000000000000000000000000000000000000000000000000000000000000000000000000000000000000000000
XXXXXXXXXXXX--DX00000000000000000000000000000000000000000000000000000000000000000000000000000000000000000000000000000000000000000000000000000000000000000000000000000000000000000000000
TTTTXXXXXXXX--DX00000000000000000000000000000000000000000000000000000000000000000000000000000000000000000000000000000000000000000000000000000000000000000000000000000000000000000000000
--TTTTTTTT----DX00000000000000000000000000000000000000000000000000000000000000000000000000000000000000000000000000000000000000000000000000000000000000000000000000000000000000000000000
---------TTTTTTT00000000000000000000000000000000000000000000000000000000000000000000000000000000000000000000000000000000000000000000000000000000000000000000000000000000000000000000000