00000000000000000000000000000000000000000000000000000000000000000000000000000000000000000000000000000000000000000000000000000000--------------------000000000000000
00000000000000000000000000000000000000000000000000000000000000000000000000000000000000000000000000000000000000000000000000000000--------------------000000000000000
00000000000000000000000000000000000000000000000000000000000000000000000000000000000000000000000000000000000000000000000000000000--------------------000000000000000
00000000000000000000000000000000000000000000000000000000000000000000000000000000000000000000000000000000000000000000000000000000--------------------000000000000000
00000000000000000000000000000000000000000000000000000000000000000000000000000000000000000000000000000000000000000000000000000000--------------------000000000000000
00000000000000000000000000000000000000000000000000000000000000000000000000000000000000000000000000000000000000000000000000000000--------------------000000000000000
00000000000000000000000000000000000000000000000000000000000000000000000000000000000000000000000000000000000000000000000000000000--------------------000000000000000
00000000000000000000000000000000000000000000000000000000000000000000000000000000000000000000000000000000000000000000000000000000--------------------000000000000000
00000000000000000000000000000000000000000000000000000000000000000000000000000000000000000000000000000000000000000000000000000000--------------------000000000000000
00000000000000000000000000000000000000000000000000000000000000000000000000000000000000000000000000000000000000000000000000000000--------------------000000000000000
00000000000000000000000000000000000000000000000000000000000000000000000000000000000000000000000000000000000000000000000000000000--------------------000000000000000
00000000000000000000000000000000000000000000000000000000000000000000000000000000000000000000000000000000000000000000000000000000-------------X------000000000000000
00000000000000000000000000000000000000000000000000000000000000000000000000000000000000000000000000000000000000000000000000000000------------XXX-----000000000000000
00000000000000000000000000000000000000000000000000000000000000000000000000000000000000000000000000000000000000000000000000000000-----------XXXX-----000000000000000
00000000000000000000000000000000000000000000000000000000000000000000000000000000000000000000000000000000000000000000000000000000-------XXXXXXXX-----000000000000000
0000000000000000000000000000000000000000000000000000000000000000000000000000000000000000000000000000000000000000XXXX--------XXXXXXXXXXXXXXXXXXXXXXXX000000000000000
0000000000000000000000000000000000000000000000000000000000000000000000000000000000000000000000000000000000000000XXXX--------XXXX00000000000000000000000000000000000
0000000000000000000000000000000000000000000000000000000000000000000000000000000000000000000000000000000000000000XXXX--------XXXX00000000000000000000000000000000000
0000000000000000000000000000000000000000000000000000000000000000000000000000000000000000000000000000000000000000XXXX--------XXXX00000000000000000000000000000000000
0000000000000000000000000000000000000000000000000000000000000000000000000000000000000000000000000000000000000000XXXX--------XXXX00000000000000000000000000000000000
0000000000000000000000000000000000000000000000000000000000000000000000000000000000000000000000000000000000000000XXXX--------XXXX00000000000000000000000000000000000
0000000000000000000000000000000000000000000000000000000000000000000000000000000000000000000000000000000000000000XXXX--------XXXX00000000000000000000000000000000000
0000000000000000000000000000000000000000000000000000000000000000000000000000000000000000000000000000000000000000XXXX--------XXXX00000000000000000000000000000000000
0000000000000000000000000000000000000000000000000000000000000000000000000000000000000000000000000000000000000000XXXXXX------XXXX00000000000000000000000000000000000
0000000000000000000000000000000000000000000000000000000000000000000000000000000000000000000000000000000000000000XXXX--------XXXX00000000000000000000000000000000000
0000000000000000000000000000000000000000000000000000000000000000000000000000000000000000000000000000000000000000XXXX--------XXXX00000000000000000000000000000000000
0000000000000000000000000000000000000000000000000000000000000000000000000000000000000000000000000000000000000000XX----TTTTTTTTXX00000000000000000000000000000000000
0000000000000000000000000000000000000000000000000000000000000000000000000000000000000000000000000000000000000000XX------------XX00000000000000000000000000000000000
0000000000000000000000000000000000000000000000000000000000000000000000000000000000000000000000000000000000000000XX------------XX00000000000000000000000000000000000
0000000000000000000000000000000000000000000000000000000000000000000000000000000000000000000000000000000000000000XXXXXXXX------XX00000000000000000000000000000000000
0000000000000000000000000000000000000000000000000000000000000000000000000000000000000000000000000000000000000000XX----XXXXX---XX00000000000000000000000000000000000
0000000000000000000000000000000000000000000000000000000000000000000000000000000000000000000000000000000000000000XD------------XX00000000000000000000000000000000000
0000000000000000000000000000000000000000000000000000000000000000000000000000000000000000000000000000000000000000XD------------XX00000000000000000000000000000000000
0000000000000000000000000000000000000000000000000000000000000000000000000000000000000000000000000000000000000000XXXXX-------XXXX00000000000000000000000000000000000
0000000000000000000000000000000000000000000000000000000000000000000000000000000000000000000000000000000000000000XXXXXXXXXXXXXXXX00000000000000000000000000000000000
0000000000000000000000000000000000000000000000000000000000000000000000000000000000000000000000000000000000000000XXXX--------XXXX00000000000000000000000000000000000
0000000000000000000000000000000000000000000000000000000000000000000000000000000000000000000000000000000000000000XXXXXXX-----XXXX00000000000000000000000000000000000
0000000000000000000000000000000000000000000000000000000000000000000000000000000000000000000000000000000000000000X-----------XXXX00000000000000000000000000000000000
0000000000000000000000000000000000000000000000000000000000000000000000000000000000000000000000000000000000000000XX----------XXXX00000000000000000000000000000000000
0000000000000000000000000000000000000000000000000000000000000000000000000000000000000000000000000000000000000000XD-TTTT-----XXXX00000000000000000000000000000000000
0000000000000000000000000000000000000000000000000000000000000000000000000000000000000000000000000000000000000000XD-----------XXX00000000000000000000000000000000000
0000000000000000000000000000000000000000000000000000000000000000000000000000000000000000000000000000000000000000XX-------XXXXXXX00000000000000000000000000000000000
0000000000000000000000000000000000000000000000000000000000000000000000000000000000000000000000000000000000000000TTTTXXXXXXXX--X-00000000000000000000000000000000000
0000000000000000000000000000000000000000000000000000000000000000000000000000000000000000000000000000000000000000TTTTTTTT-----XXX00000000000000000000000000000000000
0000000000000000000000000000000000000000000000000000000000000000000000000000000000000000000000000000000000000000X----XTTTT--XXXX00000000000000000000000000000000000
0000000000000000000000000000000000000000000000000000000000000000000000000000000000000000000000000000000000000000X--XXTTTT--XXXX-00000000000000000000000000000000000
0000000000000000000000000000000000000000000000000000000000000000000000000000000000000000000000000000000000000000XXXXXXXX------XX00000000000000000000000000000000000
0000000000000000000000000000000000000000000000000000000000000000000000000000000000000000000000000000000000000000XXXXXXXXXX----XX00000000000000000000000000000000000
0000000000000000000000000000000000000000000000000000000000000000000000000000000000000000000000000000000000000000XX-----TTTT---XX00000000000000000000000000000000000
0000000000000000000000000000000000000000000000000000000000000000000000000000000000000000000000000000000000000000XX------------XX00000000000000000000000000000000000
0000000000000000000000000000000000000000000000000000000000000000000000000000000000000000000000000000000000000000XX-----------XXX00000000000000000000000000000000000
0000000000000000000000000000000000000000000000000000000000000000000000000000000000000000000000000000000000000000XD-----------XXX00000000000000000000000000000000000
0000000000000000000000000000000000000000000000000000000000000000000000000000000000000000000000000000000000000000XD-----------XXX00000000000000000000000000000000000
0000000000000000000000000000000000000000000000000000000000000000000000000000000000000000000000000000000000000000XXXXX-------XXXX00000000000000000000000000000000000
0000000000000000000000000000000000000000000000000000000000000000000000000000000000000000000000000000000000000000XXXXXXXXXXXXXXXX00000000000000000000000000000000000
0000000000000000000000000000000000000000000000000000000000000000000000000000000000000000000000000000000000000000XXXX--------XXXX00000000000000000000000000000000000
0000000000000000000000000000000000000000000000000000000000000000000000000000000000000000000000000000000000000000XXXX--------XXXX00000000000000000000000000000000000
0000000000000000000000000000000000000000000000000000000000000000000000000000000000000000000000000000000000000000XXXX--------XXXX00000000000000000000000000000000000
0000000000000000000000000000000000000000000000000000000000000000000000000000000000000000000000000000000000000000XX------XXXXXXXX00000000000000000000000000000000000
000000000000000000000000000000000000000000000000000000000000000000000000----------------------------------------XX----------XXXX00000000000000000000000000000000000
000000000000000000000000000000000000000000000000000000000000000000000000----------------------------------------XXXX--------XXXX00000000000000000000000000000000000
000000000000000000000000000000000000000000000000000000000000000000000000----------------------------------------XXXX--------XXXX00000000000000000000000000000000000
000000000000000000000000000000000000000000000000000000000000000000000000----------------------------------------XXXX--------XXXX00000000000000000000000000000000000
000000000000000000000000000000000000000000000000000000000000000000000000----------------------------------------XXXXXX------XXXX00000000000000000000000000000000000
000000000000000000000000000000000000000000000000000000000000000000000000----------------------------------------XXXX--------XXXX00000000000000000000000000000000000
000000000000000000000000000000000000000000000000000000000000000000000000----------------------------------------XXXX--------XXXX00000000000000000000000000000000000
000000000000000000000000000000000000000000000000000000000000000000000000----------------------------------------XX----TTTTTTTTXX00000000000000000000000000000000000
000000000000000000000000000000000000000000000000000000000000000000000000----------------------------------------XX------------XX00000000000000000000000000000000000
000000000000000000000000000000000000000000000000000000000000000000000000-------------------------------------X--XX------------XX00000000000000000000000000000000000
000000000000000000000000000000000000000000000000000000000000000000000000------------------------------------XX--XXXXXXXX------XX00000000000000000000000000000000000
000000000000000000000000000000000000000000000000000000000000000000000000-------E---------------------------XXX--XX----XXXXX---XX00000000000000000000000000000000000
000000000000000000000000000000000000000000000000000000000000000000000000------<>--------------------------XXXX--XD------------XX00000000000000000000000000000000000
000000000000000000000000000000000000000000000000000000000000000000000000------[]-------------------------XXXXX--XD------------XX00000000000000000000000000000000000
00000000000000000000000000000000000000000000000000000000----------------------[]---------------------E--XXXXXX--XXXXX-------XXXX00000000000000000000000000000000000
00000000000000000000000000000000000000000000000000000000----------------XXXXXXXXXXXXXXXXXXX-XXXXXXXXXXXXXXXXXXXXXXXXXXXXXXXXXXXX00000000000000000000000000000000000
00000000000000000000000000000000000000000000000000000000-TTTT-----------0000000000000000000000000000000000000000000000000000000000000000000000000000000000000000000
00000000000000000000000000000000000000000000000000000000----------------0000000000000000000000000000000000000000000000000000000000000000000000000000000000000000000
0000000000000000--------------------------------------------------------0000000000000000000000000000000000000000000000000000000000000000000000000000000000000000000
0000000000000000-----------------------------------------------TTT------0000000000000000000000000000000000000000000000000000000000000000000000000000000000000000000
0000000000000000--------------------------------------------------------0000000000000000000000000000000000000000000000000000000000000000000000000000000000000000000
0000000000000000--------------------------------------------------------0000000000000000000000000000000000000000000000000000000000000000000000000000000000000000000
0000000000000000------------------------------------------------TTTT----0000000000000000000000000000000000000000000000000000000000000000000000000000000000000000000
0000000000000000--------------------------------------------------------0000000000000000000000000000000000000000000000000000000000000000000000000000000000000000000
0000000000000000------------------------------------------TTTTTTTT------0000000000000000000000000000000000000000000000000000000000000000000000000000000000000000000
0000000000000000--------------------------------------------------------0000000000000000000000000000000000000000000000000000000000000000000000000000000000000000000
0000000000000000--------------------------------------------------------0000000000000000000000000000000000000000000000000000000000000000000000000000000000000000000
0000000000000000-------------------------------------------XXXXXXXX-----0000000000000000000000000000000000000000000000000000000000000000000000000000000000000000000
0000000000000000-------------------------------------------XX-----------0000000000000000000000000000000000000000000000000000000000000000000000000000000000000000000
0000000000000000----------------------------------E--------XX-----------0000000000000000000000000000000000000000000000000000000000000000000000000000000000000000000
0000000000000000---------------------------------<>-----XD------------XX0000000000000000000000000000000000000000000000000000000000000000000000000000000000000000000
0000000000000000---------------------------------[]-----XD------------XX0000000000000000000000000000000000000000000000000000000000000000000000000000000000000000000
-------------------------------------------------[]-----XXXXX-------XXXX0000000000000000000000000000000000000000000000000000000000000000000000000000000000000000000
----------------XXXXXXXXXXXXXXXXXXXXXXXXXXXXXXXXXXXXXXXXXXXXXXXXXXXXXXXX0000000000000000000000000000000000000000000000000000000000000000000000000000000000000000000
X-----TTTT-TTTTT000000000000000000000000000000000000000000000000000000000000000000000000000000000000000000000000000000000000000000000000000000000000000000000000000
X---------------000000000000000000000000000000000000000000000000000000000000000000000000000000000000000000000000000000000000000000000000000000000000000000000000000
X---------------000000000000000000000000000000000000000000000000000000000000000000000000000000000000000000000000000000000000000000000000000000000000000000000000000
XXXXXXXX--------000000000000000000000000000000000000000000000000000000000000000000000000000000000000000000000000000000000000000000000000000000000000000000000000000
XXXX------------000000000000000000000000000000000000000000000000000000000000000000000000000000000000000000000000000000000000000000000000000000000000000000000000000
XXXX------------000000000000000000000000000000000000000000000000000000000000000000000000000000000000000000000000000000000000000000000000000000000000000000000000000
XXXX------------000000000000000000000000000000000000000000000000000000000000000000000000000000000000000000000000000000000000000000000000000000000000000000000000000
XXXX----X-------000000000000000000000000000000000000000000000000000000000000000000000000000000000000000000000000000000000000000000000000000000000000000000000000000
---X-X----------000000000000000000000000000000000000000000000000000000000000000000000000000000000000000000000000000000000000000000000000000000000000000000000000000
---X------------000000000000000000000000000000000000000000000000000000000000000000000000000000000000000000000000000000000000000000000000000000000000000000000000000
XXX-----------XX000000000000000000000000000000000000000000000000000000000000000000000000000000000000000000000000000000000000000000000000000000000000000000000000000
XXXXXXXXXX----XX000000000000000000000000000000000000000000000000000000000000000000000000000000000000000000000000000000000000000000000000000000000000000000000000000
XX------------XX000000000000000000000000000000000000000000000000000000000000000000000000000000000000000000000000000000000000000000000000000000000000000000000000000
XX------------XX000000000000000000000000000000000000000000000000000000000000000000000000000000000000000000000000000000000000000000000000000000000000000000000000000
XX-----XXXXXXXXX000000000000000000000000000000000000000000000000000000000000000000000000000000000000000000000000000000000000000000000000000000000000000000000000000
XD------------XX000000000000000000000000000000000000000000000000000000000000000000000000000000000000000000000000000000000000000000000000000000000000000000000000000
XXXXX-------XXXX000000000000000000000000000000000000000000000000000000000000000000000000000000000000000000000000000000000000000000000000000000000000000000000000000
XXXXXXXXXXXXXXXX000000000000000000000000000000000000000000000000000000000000000000000000000000000000000000000000000000000000000000000000000000000000000000000000000