0000000000000000000000000000000000000000000000000000--------------------000000000000000
0000000000000000000000000000000000000000000000000000--------------------000000000000000
0000000000000000000000000000000000000000000000000000--------------------000000000000000
0000000000000000000000000000000000000000000000000000--------------------000000000000000
000000000000000000000000000000000000----------------S-------------------000000000000000
000000000000000000000000000000000000XX----------XXXXS-------------------000000000000000
000000000000000000000000000000000000----------------S-------------------000000000000000
000000000000000000000000000000000000---------TTTT---S--------------SSSSS000000000000000
000000000000000000000000000000000000----------------S-------------------000000000000000
000000000000000000000000000000000000------XXXX------S-------------------000000000000000
000000000000000000000000000000000000----------------S-------------------000000000000000
000000000000000000000000000000000000---------TTT----S-------------------000000000000000
000000000000000000000000000000000000----------------S------E------------000000000000000
000000000000000000000000000000000000X-----------TTTTS-----<>-E----------000000000000000
000000000000000000000000000000000000X--------------XS-----[]<>--E-------000000000000000
000000000000000000000000000000000000X--------------XXXXXXXXXXXXXXXXXXXXX000000000000000
000000000000000000000000000000000000XXXXXXXXX------X00000000000000000000000000000000000
000000000000000000000000000000000000XX-------------X00000000000000000000000000000000000
000000000000000000000000000000000000XX--------TTTTTT00000000000000000000000000000000000
000000000000000000000000000000000000XD-------------X00000000000000000000000000000000000
000000000000000000000000000000000000XD-------------X00000000000000000000000000000000000
000000000000000000000000000000000000TTTTXXXXXXXX--DX00000000000000000000000000000000000
000000000000000000000000000000000000--TTTTTTTT-----X00000000000000000000000000000000000
000000000000000000000000000000000000---------TTTTTTT00000000000000000000000000000000000
000000000000000000000000000000000000----------------00000000000000000000000000000000000
000000000000000000000000000000000000MMMMMMMMMMMMMMMM00000000000000000000000000000000000
000000000000000000000000000000000000----------------00000000000000000000000000000000000
000000000000000000000000000000000000----------------00000000000000000000000000000000000
000000000000000000000000000000000000---------T------00000000000000000000000000000000000
000000000000000000000000000000000000----------------00000000000000000000000000000000000
000000000000000000000000000000000000----------------00000000000000000000000000000000000
000000000000000000000000000000000000XX------TTTTTTXX00000000000000000000000000000000000
000000000000000000000000000000000000XX------------XX00000000000000000000000000000000000
000000000000000000000000000000000000XX------------XX00000000000000000000000000000000000
000000000000000000000000000000000000XX------------XX00000000000000000000000000000000000
000000000000000000000000000000000000XXXX--------XXXX00000000000000000000000000000000000
000000000000000000000000000000000000XXXX------------00000000000000000000000000000000000
000000000000000000000000000000000000XX-------------X00000000000000000000000000000000000
000000000000000000000000000000000000XX-------TTTTTTT00000000000000000000000000000000000
000000000000000000000000000000000000XD-------------X00000000000000000000000000000000000
000000000000000000000000000000000000XD-------------X00000000000000000000000000000000000
000000000000000000000000000000000000TTTTXXXXXXXX---X00000000000000000000000000000000000
000000000000000000000000000000000000--TTTTTTTT-----X00000000000000000000000000000000000
000000000000000000000000000000000000---------TTTTTTT00000000000000000000000000000000000
000000000000000000000000000000000000XXXX-------XXXXX00000000000000000000000000000000000
000000000000000000000000000000000000--XX----------XX00000000000000000000000000000000000
000000000000000000000000000000000000---X----------XX00000000000000000000000000000000000
000000000000000000000000000000000000---XXXX-------XX00000000000000000000000000000000000
000000000000000000000000000000000000----X---------XX00000000000000000000000000000000000
000000000000000000000000000000000000---XXXX------XXX00000000000000000000000000000000000
000000000000000000000000000000000000-XXXX-------XXXX00000000000000000000000000000000000
000000000000000000000000000000000000XX----------XXXX00000000000000000000000000000000000
000000000000000000000000000000000000XX----------XXXX00000000000000000000000000000000000
000000000000000000000000000000000000XXXXXXXXXXXXXXXX00000000000000000000000000000000000
000000000000000000000000000000000000XXXX-----------X00000000000000000000000000000000000
000000000000000000000000000000000000X--------------X00000000000000000000000000000000000
000000000000000000000000000000000000XXXXXXXXX------X00000000000000000000000000000000000
000000000000000000000000000000000000XX-------------X00000000000000000000000000000000000
000000000000000000000000000000000000XX-------TTTT-TT00000000000000000000000000000000000
000000000000000000000000000000000000XD-------------X00000000000000000000000000000000000
000000000000000000000000000000000000XD-------------X00000000000000000000000000000000000
000000000000000000000000000000000000TTTTXXXXXXXX---X00000000000000000000000000000000000
000000000000000000000000000000000000--TTTTTTTT-----X00000000000000000000000000000000000
000000000000000000000000000000000000---------TTTTTTT00000000000000000000000000000000000
000000000000000000000000000000000000XXXX------XXXX--00000000000000000000000000000000000
000000000000000000000000000000000000XXXX------XXXX--00000000000000000000000000000000000
000000000000000000000000000000000000XXXX------XXXX--00000000000000000000000000000000000
000000000000000000000000000000000000XXXX------XXXX--00000000000000000000000000000000000
000000000000000000000000000000000000XXXX------XXXX--00000000000000000000000000000000000
000000000000000000000000000000000000XXXX------XXXX--00000000000000000000000000000000000
000000000000000000000000000000000000XXXX------XXXX--00000000000000000000000000000000000
000000000000000000000000000000000000XXXX-------XXXX-00000000000000000000000000000000000
000000000000000000000000000000000000XXXX-----TTTTXXX00000000000000000000000000000000000
000000000000000000000000000000000000XXXX--------XXXX00000000000000000000000000000000000
000000000000000000000000000000000000XXXX--------XXXX00000000000000000000000000000000000
000000000000000000000000000000000000XXXX---------XXX00000000000000000000000000000000000
000000000000000000000000000000000000XXXX------------00000000000000000000000000000000000
000000000000000000000000000000000000XX-------------X00000000000000000000000000000000000
000000000000000000000000000000000000XX-------TTTT-TT00000000000000000000000000000000000
000000000000000000000000000000000000XD-------------X00000000000000000000000000000000000
000000000000000000000000000000000000XD-------------X00000000000000000000000000000000000
000000000000000000000000000000000000TTTTXXXXXXXX---X00000000000000000000000000000000000
000000000000000000000000000000000000--TTTTTTTT-----X00000000000000000000000000000000000
000000000000000000000000000000000000---------TTTTTTT00000000000000000000000000000000000
000000000000000000000000000000000000----------------00000000000000000000000000000000000
000000000000000000000000000000000000----------------00000000000000000000000000000000000
000000000000000000000000000000000000------TTTT------00000000000000000000000000000000000
000000000000000000000000000000000000----------------00000000000000000000000000000000000
000000000000000000000000000000000000---TTTT---------00000000000000000000000000000000000
000000000000000000000000000000000000----------------00000000000000000000000000000000000
000000000000000000000000000000000000----------------00000000000000000000000000000000000
000000000000000000000000000000000000XX-----TTTT---XX00000000000000000000000000000000000
000000000000000000000000000000000000XX------------XX00000000000000000000000000000000000
000000000000000000000000000000000000XX------------XX00000000000000000000000000000000000
000000000000000000000000000000000000XX------------TX00000000000000000000000000000000000
000000000000000000000000000000000000XXXX-----------X00000000000000000000000000000000000
000000000000000000000000000000000000XXXX-----------X00000000000000000000000000000000000
000000000000000000000000000000000000XX-------------X00000000000000000000000000000000000
000000000000000000000000000000000000XX-------TTTTTTT00000000000000000000000000000000000
000000000000000000000000000000000000XD-------------X00000000000000000000000000000000000
000000000000000000000000000000000000XD-------------X00000000000000000000000000000000000
000000000000000000000000000000000000TTTTXXXXXXXX---X00000000000000000000000000000000000
000000000000000000000000000000000000--TTTTTTTT-----X00000000000000000000000000000000000
000000000000000000000000000000000000---------TTTTTTT00000000000000000000000000000000000
000000000000000000000000000000000000------TTTT------00000000000000000000000000000000000
000000000000000000000000000000000000----------------00000000000000000000000000000000000
000000000000000000000000000000000000----------------00000000000000000000000000000000000
000000000000000000000000000000000000----TTTT--------00000000000000000000000000000000000
000000000000000000000000000000000000X-------TT--TTTT00000000000000000000000000000000000
000000000000000000000000000000000000X--------------X00000000000000000000000000000000000
000000000000000000000000000000000000X--------------X00000000000000000000000000000000000
000000000000000000000000000000000000--------TTTTTTTT00000000000000000000000000000000000
000000000000000000000000000000000000----------------00000000000000000000000000000000000
000000000000000000000000000000000000X-----------TTTT00000000000000000000000000000000000
000000000000000000000000000000000000X--------------X00000000000000000000000000000000000
000000000000000000000000000000000000X--------------X00000000000000000000000000000000000
000000000000000000000000000000000000XXXXXXXXX------X00000000000000000000000000000000000
000000000000000000000000000000000000XX-------------X00000000000000000000000000000000000
000000000000000000000000000000000000XX--------TTTTTT00000000000000000000000000000000000
000000000000000000000000000000000000XD-------------X00000000000000000000000000000000000
000000000000000000000000000000000000XD-------------X00000000000000000000000000000000000
000000000000000000000000000000000000TTTTXXXXXXXX--DX00000000000000000000000000000000000
000000000000000000000000000000000000--TTTTTTTT-----X00000000000000000000000000000000000
000000000000000000000000000000000000---------TTTTTTT00000000000000000000000000000000000
000000000000000000000000000000000000--TTTTTTTT------00000000000000000000000000000000000
000000000000000000000000000000000000----------------00000000000000000000000000000000000
000000000000000000000000000000000000----------------00000000000000000000000000000000000
000000000000000000000000000000000000TTT-------------00000000000000000000000000000000000
0000000000000000------------------------------------00000000000000000000000000000000000
0000000000000000------------------------------------00000000000000000000000000000000000
0000000000000000-------------------------TT---------00000000000000000000000000000000000
0000000000000000------------------------------------00000000000000000000000000000000000
----------------S----------------------E-----E------00000000000000000000000000000000000
----TT---TT-----S-------------------XMMMMMMMMMMMMMMX00000000000000000000000000000000000
----------------S-------------------X--------------X00000000000000000000000000000000000
----------------S-------------------X--------------X00000000000000000000000000000000000
--------TTTT----S-------------------XXXXXXXXXXXX---X00000000000000000000000000000000000
----------------S-------------------XX-------------X00000000000000000000000000000000000
-TTTTTTTT-------S-------------------XX-------TTTT-TT00000000000000000000000000000000000
----------------S-------------------XD-------------X00000000000000000000000000000000000
----------------S-------------------XD-------------X00000000000000000000000000000000000
XXXXX-----------S-------------------TTTTXXXXXXXX---X00000000000000000000000000000000000
------XX--------S--------E------------TTTTTTTT-----X00000000000000000000000000000000000
---XXXXX--------XXXXXXXXXXXXXXXXXXXX---------TTTTTTT00000000000000000000000000000000000
---XXXXX--------00000000000000000000000000000000000000000000000000000000000000000000000
---XX-----------00000000000000000000000000000000000000000000000000000000000000000000000
XXXXXXXXXXX---XX00000000000000000000000000000000000000000000000000000000000000000000000
XD------------XX00000000000000000000000000000000000000000000000000000000000000000000000
XD------------XX00000000000000000000000000000000000000000000000000000000000000000000000
TTTTXXXXXXXX--XX00000000000000000000000000000000000000000000000000000000000000000000000
--TTTTTTTT-----X00000000000000000000000000000000000000000000000000000000000000000000000
---------TTTTTTT00000000000000000000000000000000000000000000000000000000000000000000000