0000000000000000000000000000000000000000000000000000000000000000000000000000000000000000000000000000000000000000XXXX--------XXXX
0000000000000000000000000000000000000000000000000000000000000000000000000000000000000000000000000000000000000000XXXX--------XXXX
0000000000000000000000000000000000000000000000000000000000000000000000000000000000000000000000000000000000000000X--TTTT--TTTT---
0000000000000000000000000000000000000000000000000000000000000000000000000000000000000000000000000000000000000000----------------
000000000000000000000000000000000000000000000000000000000000000000000000--------------------------------------------------------
000000000000000000000000000000000000000000000000000000000000000000000000-----------------------------------------TTTT-----------
000000000000000000000000000000000000000000000000000000000000000000000000--------------------------------------------------------
000000000000000000000000000000000000000000000000000000000000000000000000--------------------------------------------------------
000000000000000000000000000000000000000000000000000000000000000000000000----------------------------------------TTXT------------
000000000000000000000000000000000000000000000000000000000000000000000000--------------------------------------------------------
000000000000000000000000000000000000000000000000000000000000000000000000--------------------------------------------------------
000000000000000000000000000000000000000000000000000000000000000000000000-------------------------------------------XXXXX--------
000000000000000000000000000000000000000000000000000000000000000000000000-------------------------------------------X------------
000000000000000000000000000000000000000000000000000000000000000000000000-------------------------------X--------XXXX----------XX
000000000000000000000000000000000000000000000000000000000000000000000000------------------------------XX--------XXXXXXXX------XX
000000000000000000000000000000000000000000000000000000000000000000000000-----------------------------XXX--------XX----XXXXX---XX
000000000000000000000000000000000000000000000000000000000000000000000000----------------------------XXXX-E------XD------------XX
000000000000000000000000000000000000000000000000000000000000000000000000---------------------------XXXXX--------XD------------XX
000000000000000000000000000000000000000000000000000000000000000000000000-------------------------XXXXXXX--------XXXXX-------XXXX
00000000000000000000000000000000000000000000000000000000XXXX------XXXX--XXXXXXXXXXXXXXXXXXXXXXXXXXXXXXXXXXXXXXXXXXXXXXXXXXXXXXXX
00000000000000000000000000000000000000000000000000000000XXXXE-----XXXX--00000000000000000000000000000000000000000000000000000000
00000000000000000000000000000000000000000000000000000000XXXX------XXXX-X00000000000000000000000000000000000000000000000000000000
00000000000000000000000000000000000000000000000000000000XX-----------XXX00000000000000000000000000000000000000000000000000000000
000000000000000000000000000000000000--------------------XX--TT-------XXX00000000000000000000000000000000000000000000000000000000
000000000000000000000000000000000000--------------------XX-----------XXX00000000000000000000000000000000000000000000000000000000
000000000000000000000000000000000000--------------------XX-----------XXX00000000000000000000000000000000000000000000000000000000
000000000000000000000000000000000000--------------------XX-----------XXX00000000000000000000000000000000000000000000000000000000
000000000000000000000000000000000000--------------------XX-----------XXX00000000000000000000000000000000000000000000000000000000
000000000000000000000000000000000000--------------------XX-----------XXX00000000000000000000000000000000000000000000000000000000
000000000000000000000000000000000000--------------------XX-----------XXX00000000000000000000000000000000000000000000000000000000
000000000000000000000000000000000000--------------------XX-----------XXX00000000000000000000000000000000000000000000000000000000
000000000000000000000000000000000000--------------------XX-----------XXX00000000000000000000000000000000000000000000000000000000
000000000000000000000000000000000000--------------------XX-----------XXX00000000000000000000000000000000000000000000000000000000
000000000000000000000000000000000000--------------------XX-----------XXX00000000000000000000000000000000000000000000000000000000
000000000000000000000000000000000000--------------------XX-----------XXX00000000000000000000000000000000000000000000000000000000
000000000000000000000000000000000000--------------------XD-----------XXX00000000000000000000000000000000000000000000000000000000
000000000000000000000000000000000000--------------------XD-----------XXX00000000000000000000000000000000000000000000000000000000
000000000000000000000000000000000000-----------------E--XXXXX-------XXXX00000000000000000000000000000000000000000000000000000000
00000000000000000000XXXX--------XXXXXXXXXXXXXXXXXXXXXXXXXXXXXXXXXXXXXXXX00000000000000000000000000000000000000000000000000000000
00000000000000000000XXXX--------XXXX00000000000000000000000000000000000000000000000000000000000000000000000000000000000000000000
00000000000000000000XXXXXXX-----XXXX00000000000000000000000000000000000000000000000000000000000000000000000000000000000000000000
00000000000000000000XXXX--------XXXX00000000000000000000000000000000000000000000000000000000000000000000000000000000000000000000
00000000000000000000XX------------XX00000000000000000000000000000000000000000000000000000000000000000000000000000000000000000000
00000000000000000000XX-----XXXX---DX00000000000000000000000000000000000000000000000000000000000000000000000000000000000000000000
00000000000000000000XX------------DX00000000000000000000000000000000000000000000000000000000000000000000000000000000000000000000
00000000000000000000XXXX--------XXXX00000000000000000000000000000000000000000000000000000000000000000000000000000000000000000000
00000000000000000000XXXXXX------XXXX00000000000000000000000000000000000000000000000000000000000000000000000000000000000000000000
00000000000000000000XXXX--------XXXX00000000000000000000000000000000000000000000000000000000000000000000000000000000000000000000
00000000000000000000XXXX--------XXXX00000000000000000000000000000000000000000000000000000000000000000000000000000000000000000000
00000000000000000000XX----TTTTTTTTXX00000000000000000000000000000000000000000000000000000000000000000000000000000000000000000000
00000000000000000000XX------------XX00000000000000000000000000000000000000000000000000000000000000000000000000000000000000000000
00000000000000000000XX------------XX00000000000000000000000000000000000000000000000000000000000000000000000000000000000000000000
00000000000000000000XXXXXXXX------XX00000000000000000000000000000000000000000000000000000000000000000000000000000000000000000000
00000000000000000000XX----XXXXX---XX00000000000000000000000000000000000000000000000000000000000000000000000000000000000000000000
00000000000000000000XD------------XX00000000000000000000000000000000000000000000000000000000000000000000000000000000000000000000
00000000000000000000XD------------XX00000000000000000000000000000000000000000000000000000000000000000000000000000000000000000000
00000000000000000000XXXXX-------XXXX00000000000000000000000000000000000000000000000000000000000000000000000000000000000000000000
00000000000000000000XXXXXXXXXXXXXXXX00000000000000000000000000000000000000000000000000000000000000000000000000000000000000000000
00000000000000000000XXXX--------XXXX00000000000000000000000000000000000000000000000000000000000000000000000000000000000000000000
00000000000000000000XXXXXXX-----XXXX00000000000000000000000000000000000000000000000000000000000000000000000000000000000000000000
00000000000000000000XXXX--------XXXX00000000000000000000000000000000000000000000000000000000000000000000000000000000000000000000
00000000000000000000XX------------XX00000000000000000000000000000000000000000000000000000000000000000000000000000000000000000000
00000000000000000000XX-----XXXX---DX00000000000000000000000000000000000000000000000000000000000000000000000000000000000000000000
00000000000000000000XX------------DX00000000000000000000000000000000000000000000000000000000000000000000000000000000000000000000
00000000000000000000XXXX--------XXXX00000000000000000000000000000000000000000000000000000000000000000000000000000000000000000000
00000000000000000000XXXX--------XXXX00000000000000000000000000000000000000000000000000000000000000000000000000000000000000000000
00000000000000000000XXXXXX------XXXX00000000000000000000000000000000000000000000000000000000000000000000000000000000000000000000
00000000000000000000XXXX--------XXXX00000000000000000000000000000000000000000000000000000000000000000000000000000000000000000000
00000000000000000000XXXX--------XXXX00000000000000000000000000000000000000000000000000000000000000000000000000000000000000000000
00000000000000000000XX----TTTTTTTTXX00000000000000000000000000000000000000000000000000000000000000000000000000000000000000000000
00000000000000000000XX------------XX00000000000000000000000000000000000000000000000000000000000000000000000000000000000000000000
00000000000000000000XX------------XX00000000000000000000000000000000000000000000000000000000000000000000000000000000000000000000
00000000000000000000XXXXXXXX------XX00000000000000000000000000000000000000000000000000000000000000000000000000000000000000000000
00000000000000000000XX-----XXXX---XX00000000000000000000000000000000000000000000000000000000000000000000000000000000000000000000
00000000000000000000XD------------XX00000000000000000000000000000000000000000000000000000000000000000000000000000000000000000000
00000000000000000000XD------------XX00000000000000000000000000000000000000000000000000000000000000000000000000000000000000000000
00000000000000000000XXXXX-------XXXX00000000000000000000000000000000000000000000000000000000000000000000000000000000000000000000
00000000000000000000XXXXXXXXXXXXXXXX00000000000000000000000000000000000000000000000000000000000000000000000000000000000000000000
00000000000000000000XXXX------XXXX--00000000000000000000000000000000000000000000000000000000000000000000000000000000000000000000
00000000000000000000XXXX------XXXX--00000000000000000000000000000000000000000000000000000000000000000000000000000000000000000000
00000000000000000000XXXX------XXXX--00000000000000000000000000000000000000000000000000000000000000000000000000000000000000000000
00000000000000000000XXXX------XXXX--00000000000000000000000000000000000000000000000000000000000000000000000000000000000000000000
00000000000000000000XXXX------XXXX--00000000000000000000000000000000000000000000000000000000000000000000000000000000000000000000
00000000000000000000XXXX------XXXX--00000000000000000000000000000000000000000000000000000000000000000000000000000000000000000000
00000000000000000000XXXX------XXXX--00000000000000000000000000000000000000000000000000000000000000000000000000000000000000000000
00000000000000000000XXXX------XXXX--00000000000000000000000000000000000000000000000000000000000000000000000000000000000000000000
00000000000000000000XXXX------XXXX--00000000000000000000000000000000000000000000000000000000000000000000000000000000000000000000
00000000000000000000XXXX------XXXX--00000000000000000000000000000000000000000000000000000000000000000000000000000000000000000000
00000000000000000000XXXX------XXXX--00000000000000000000000000000000000000000000000000000000000000000000000000000000000000000000
00000000000000000000XXXXE-EXXXXXXX--00000000000000000000000000000000000000000000000000000000000000000000000000000000000000000000
00000000000000000000XXXX------XXXX--00000000000000000000000000000000000000000000000000000000000000000000000000000000000000000000
00000000000000000000XX-----------XXX00000000000000000000000000000000000000000000000000000000000000000000000000000000000000000000
00000000000000000000XX-----------XXX00000000000000000000000000000000000000000000000000000000000000000000000000000000000000000000
00000000000000000000XX-----------XXX00000000000000000000000000000000000000000000000000000000000000000000000000000000000000000000
00000000000000000000XD-----------XXX00000000000000000000000000000000000000000000000000000000000000000000000000000000000000000000
00000000000000000000XD-----------XXX00000000000000000000000000000000000000000000000000000000000000000000000000000000000000000000
00000000000000000000XXXXX-------XXXX00000000000000000000000000000000000000000000000000000000000000000000000000000000000000000000
00000000000000000000XXXXXXXXXXXXXXXX00000000000000000000000000000000000000000000000000000000000000000000000000000000000000000000
00000000000000000000XXXX--------XXXX00000000000000000000000000000000000000000000000000000000000000000000000000000000000000000000
00000000000000000000XXXX--------XXXX00000000000000000000000000000000000000000000000000000000000000000000000000000000000000000000
00000000000000000000XXXX--------XXXX00000000000000000000000000000000000000000000000000000000000000000000000000000000000000000000
00000000000000000000XXXX--------XXXX00000000000000000000000000000000000000000000000000000000000000000000000000000000000000000000
--------------------XXXX--------XXXX00000000000000000000000000000000000000000000000000000000000000000000000000000000000000000000
--------------------XXXX--------XXXX00000000000000000000000000000000000000000000000000000000000000000000000000000000000000000000
--------------------XXXX--------XXXX00000000000000000000000000000000000000000000000000000000000000000000000000000000000000000000
--------------------XXXX--------XXXX00000000000000000000000000000000000000000000000000000000000000000000000000000000000000000000
--------------------XXXXXXX-----XXXX00000000000000000000000000000000000000000000000000000000000000000000000000000000000000000000
--------------------XXXXXXX-----XXXX00000000000000000000000000000000000000000000000000000000000000000000000000000000000000000000
--------------------XXXX--------XXXX00000000000000000000000000000000000000000000000000000000000000000000000000000000000000000000
--------------------XX----TTTTTTTTXX00000000000000000000000000000000000000000000000000000000000000000000000000000000000000000000
--------------------XX------------XX00000000000000000000000000000000000000000000000000000000000000000000000000000000000000000000
--------------------XX------------XX00000000000000000000000000000000000000000000000000000000000000000000000000000000000000000000
--------------------XXXXXXXX------XX00000000000000000000000000000000000000000000000000000000000000000000000000000000000000000000
--------------------XX----XXXXX---XX00000000000000000000000000000000000000000000000000000000000000000000000000000000000000000000
--------------------XD------------XX00000000000000000000000000000000000000000000000000000000000000000000000000000000000000000000
--------------------XD------------XX00000000000000000000000000000000000000000000000000000000000000000000000000000000000000000000
--------------------XXXXX-------XXXX00000000000000000000000000000000000000000000000000000000000000000000000000000000000000000000
XXXXXXXXXXXXXXXXXXXXXXXXXXXXXXXXXXXX00000000000000000000000000000000000000000000000000000000000000000000000000000000000000000000
00000000000000000000000000000000000000000000000000000000000000000000000000000000000000000000000000000000000000000000000000000000