00000000000000000000000000000000000000000000000000000000000000000000000000000000000000000000XXXX--------XXXX
00000000000000000000000000000000000000000000000000000000000000000000000000000000000000000000XX----TTTTTTTTXX
00000000000000000000000000000000000000000000000000000000000000000000000000000000000000000000XX------------XX
00000000000000000000000000000000000000000000000000000000000000000000000000000000000000000000XX------------XX
00000000000000000000000000000000000000000000000000000000000000000000000000000000000000000000XXXX--------XXXX
00000000000000000000000000000000000000000000000000000000000000000000000000000000000000000000XXXX--------XXXX
00000000000000000000000000000000000000000000000000000000000000000000000000000000000000000000XXXX--------XXXX
00000000000000000000000000000000000000000000000000000000000000000000000000000000000000000000XXXX--------XXXX
000000000000000000000000000000000000000000000000000000000000000000000000--------------------XXXX--------XXXX
000000000000000000000000000000000000000000000000000000000000000000000000--------------------XXXXXXXXXXXXXXXX
000000000000000000000000000000000000000000000000000000000000000000000000--------------------XXXX---X--XXXXXX
000000000000000000000000000000000000000000000000000000000000000000000000--------------------XX-----------XXX
000000000000000000000000000000000000000000000000000000000000000000000000--------------------XX--TT-------XXX
000000000000000000000000000000000000000000000000000000000000000000000000--------------------XX-----------XXX
000000000000000000000000000000000000000000000000000000000000000000000000--------------------XX-----------XXX
000000000000000000000000000000000000000000000000000000000000000000000000--------------------XX-----------XXX
000000000000000000000000000000000000000000000000000000000000000000000000--------------------XD-----------XXX
000000000000000000000000000000000000000000000000000000000000000000000000--------------------XD-----------XXX
000000000000000000000000000000000000000000000000000000000000000000000000--------------------XXXXX-------XXXX
000000000000000000000000000000000000000000000000000000000000000000000000----------------SQQQXXXXXXXXXXXXXXXX
000000000000000000000000000000000000000000000000000000000000000000000000--------------------0000000000000000
000000000000000000000000000000000000000000000000000000000000000000000000--------------------0000000000000000
000000000000000000000000000000000000000000000000000000000000000000000000----------E---------0000000000000000
00000000000000000000000000000000000000000000000000000000----------------XXXXXXXXXXXXXXXXXXXX0000000000000000
00000000000000000000000000000000000000000000000000000000------XXXX------000000000000000000000000000000000000
00000000000000000000000000000000000000000000000000000000----------------000000000000000000000000000000000000
00000000000000000000000000000000000000000000000000000000---------XXXX---000000000000000000000000000000000000
00000000000000000000000000000000000000000000000000000000----------------000000000000000000000000000000000000
00000000000000000000000000000000000000000000000000000000X-----------XXXX000000000000000000000000000000000000
00000000000000000000000000000000000000000000000000000000X------------XXX000000000000000000000000000000000000
00000000000000000000000000000000000000000000000000000000X-------------DX000000000000000000000000000000000000
00000000000000000000000000000000000000000000000000000000X----XXXXXX--DXX000000000000000000000000000000000000
00000000000000000000000000000000000000000000000000000000XX-----XXXXXXXXX000000000000000000000000000000000000
00000000000000000000000000000000000000000000000000000000---X-X----------000000000000000000000000000000000000
00000000000000000000000000000000000000000000000000000000---X------------000000000000000000000000000000000000
00000000000000000000000000000000000000000000000000000000XXX-----------XX000000000000000000000000000000000000
00000000000000000000000000000000000000000000000000000000XXXXXXXXXXXX--XX000000000000000000000000000000000000
00000000000000000000000000000000000000000000000000000000XX------------XX000000000000000000000000000000000000
00000000000000000000000000000000000000000000000000000000XX-----------XXX000000000000000000000000000000000000
00000000000000000000000000000000000000000000000000000000XD-----------XXX000000000000000000000000000000000000
00000000000000000000000000000000000000000000000000000000XD-----------XXX000000000000000000000000000000000000
00000000000000000000000000000000000000000000000000000000XXXXX-------XXXX000000000000000000000000000000000000
00000000000000000000000000000000000000000000000000000000XXXXXXXXXXXXXXXX000000000000000000000000000000000000
00000000000000000000000000000000000000000000000000000000----------------000000000000000000000000000000000000
00000000000000000000000000000000000000000000000000000000------TTTT------000000000000000000000000000000000000
00000000000000000000000000000000000000000000000000000000----------------000000000000000000000000000000000000
00000000000000000000000000000000000000000000000000000000---TTTT---------000000000000000000000000000000000000
00000000000000000000000000000000000000000000000000000000----------------000000000000000000000000000000000000
00000000000000000000000000000000000000000000000000000000----------------000000000000000000000000000000000000
00000000000000000000000000000000000000000000000000000000------TTTT------000000000000000000000000000000000000
00000000000000000000000000000000000000000000000000000000----------------000000000000000000000000000000000000
00000000000000000000000000000000000000000000000000000000---------TTTT---000000000000000000000000000000000000
00000000000000000000000000000000000000000000000000000000----------------000000000000000000000000000000000000
00000000000000000000000000000000000000000000000000000000------XXXX------000000000000000000000000000000000000
00000000000000000000000000000000000000000000000000000000----------------000000000000000000000000000000000000
00000000000000000000000000000000000000000000000000000000---TTTT---------000000000000000000000000000000000000
00000000000000000000000000000000000000000000000000000000----------------000000000000000000000000000000000000
00000000000000000000000000000000000000000000000000000000----------------000000000000000000000000000000000000
00000000000000000000000000000000000000000000000000000000XX------TTTT-TXX000000000000000000000000000000000000
00000000000000000000000000000000000000000000000000000000XD------------XX000000000000000000000000000000000000
00000000000000000000000000000000000000000000000000000000XD------------XX000000000000000000000000000000000000
00000000000000000000000000000000000000000000000000000000XXXXX-------XXXX000000000000000000000000000000000000
00000000000000000000000000000000000000000000000000000000XXXXXXXXXXXXXXXX000000000000000000000000000000000000
00000000000000000000000000000000000000000000000000000000----------------000000000000000000000000000000000000
00000000000000000000000000000000000000000000000000000000---XXXX---------000000000000000000000000000000000000
00000000000000000000000000000000000000000000000000000000----------------000000000000000000000000000000000000
00000000000000000000000000000000000000000000000000000000----------------000000000000000000000000000000000000
0000000000000000----------------------------------------XXXXXXX---------000000000000000000000000000000000000
0000000000000000--------------------------------------------------------000000000000000000000000000000000000
0000000000000000-----------------------------------------------TTTT-----000000000000000000000000000000000000
0000000000000000--------------------------------------------------------000000000000000000000000000000000000
0000000000000000--------------------------------------------------------000000000000000000000000000000000000
0000000000000000----------------------------------------------------X---000000000000000000000000000000000000
0000000000000000----------------------------------------------------X---000000000000000000000000000000000000
0000000000000000----------------------------------------------------X---000000000000000000000000000000000000
0000000000000000----------------------------------------------X-----XX--000000000000000000000000000000000000
0000000000000000----------------------------------------------------XX--000000000000000000000000000000000000
0000000000000000------------------E---------------------------------XX--000000000000000000000000000000000000
0000000000000000--------------X--<>---o-------E---------XXXXXXXXXXXXXXXX000000000000000000000000000000000000
0000000000000000-----------------[]----------<>---------XD------------XX000000000000000000000000000000000000
0000000000000000-----------------[]----------[]---------XD------------XX000000000000000000000000000000000000
0000000000000000-----------------[]----------[]---------XXXXX-------XXXX000000000000000000000000000000000000
XX------------XXXXXXXXXXXXXXXXXXXXXXXXXXXXXXXXXXXXXXXXXXXXXXXXXXXXXXXXXX000000000000000000000000000000000000
XX-----XXXX---DX00000000000000000000000000000000000000000000000000000000000000000000000000000000000000000000
XX------------DX00000000000000000000000000000000000000000000000000000000000000000000000000000000000000000000
XXXX--------XXXX00000000000000000000000000000000000000000000000000000000000000000000000000000000000000000000
XXXX--------XXXX00000000000000000000000000000000000000000000000000000000000000000000000000000000000000000000
XXXX--------XXXX00000000000000000000000000000000000000000000000000000000000000000000000000000000000000000000
XXXX--------XXXX00000000000000000000000000000000000000000000000000000000000000000000000000000000000000000000
XXXX----XXXXXXXX00000000000000000000000000000000000000000000000000000000000000000000000000000000000000000000
XXXX--------XXXX00000000000000000000000000000000000000000000000000000000000000000000000000000000000000000000
XXXX--------XXXX00000000000000000000000000000000000000000000000000000000000000000000000000000000000000000000
XXXX--------XXXX00000000000000000000000000000000000000000000000000000000000000000000000000000000000000000000
XXXX--------XXXX00000000000000000000000000000000000000000000000000000000000000000000000000000000000000000000
XX------------XX00000000000000000000000000000000000000000000000000000000000000000000000000000000000000000000
XX-----XXXX---XX00000000000000000000000000000000000000000000000000000000000000000000000000000000000000000000
XX------------XX00000000000000000000000000000000000000000000000000000000000000000000000000000000000000000000
XX-----------XXX00000000000000000000000000000000000000000000000000000000000000000000000000000000000000000000
XD-----------XXX00000000000000000000000000000000000000000000000000000000000000000000000000000000000000000000
XD-----------XXX00000000000000000000000000000000000000000000000000000000000000000000000000000000000000000000
XXXXX-------XXXX00000000000000000000000000000000000000000000000000000000000000000000000000000000000000000000
XXXXXXXXXXXXXXXX00000000000000000000000000000000000000000000000000000000000000000000000000000000000000000000
X-------------XX00000000000000000000000000000000000000000000000000000000000000000000000000000000000000000000
X-------------DX00000000000000000000000000000000000000000000000000000000000000000000000000000000000000000000
X-------------DX00000000000000000000000000000000000000000000000000000000000000000000000000000000000000000000
X-----XXXXXXXXXX00000000000000000000000000000000000000000000000000000000000000000000000000000000000000000000
X--XXXX---------00000000000000000000000000000000000000000000000000000000000000000000000000000000000000000000
X---------------00000000000000000000000000000000000000000000000000000000000000000000000000000000000000000000
X---------------00000000000000000000000000000000000000000000000000000000000000000000000000000000000000000000
XXXXXXXX--------00000000000000000000000000000000000000000000000000000000000000000000000000000000000000000000
XXXX------------00000000000000000000000000000000000000000000000000000000000000000000000000000000000000000000
XXXXXXXE--------00000000000000000000000000000000000000000000000000000000000000000000000000000000000000000000
XXXX------------00000000000000000000000000000000000000000000000000000000000000000000000000000000000000000000
X-----TTTT------00000000000000000000000000000000000000000000000000000000000000000000000000000000000000000000
----------------00000000000000000000000000000000000000000000000000000000000000000000000000000000000000000000
---TTTT---------00000000000000000000000000000000000000000000000000000000000000000000000000000000000000000000
----------------00000000000000000000000000000000000000000000000000000000000000000000000000000000000000000000
----------------00000000000000000000000000000000000000000000000000000000000000000000000000000000000000000000
XD----TTTT----XX00000000000000000000000000000000000000000000000000000000000000000000000000000000000000000000
XD------------XX00000000000000000000000000000000000000000000000000000000000000000000000000000000000000000000
XXXXX-------XXXX00000000000000000000000000000000000000000000000000000000000000000000000000000000000000000000
XXXXXXXXXXXXXXXX00000000000000000000000000000000000000000000000000000000000000000000000000000000000000000000
XXXX------XXXX--00000000000000000000000000000000000000000000000000000000000000000000000000000000000000000000
XXXX------XXXX--00000000000000000000000000000000000000000000000000000000000000000000000000000000000000000000
XXXX------XXXX--00000000000000000000000000000000000000000000000000000000000000000000000000000000000000000000
XXXX------XXXX--00000000000000000000000000000000000000000000000000000000000000000000000000000000000000000000
XXXX------XXXX--00000000000000000000000000000000000000000000000000000000000000000000000000000000000000000000
XXXX------XXXX--00000000000000000000000000000000000000000000000000000000000000000000000000000000000000000000
XXXX------XXXX--00000000000000000000000000000000000000000000000000000000000000000000000000000000000000000000
XXXX------XXXX--00000000000000000000000000000000000000000000000000000000000000000000000000000000000000000000
XXXX------XXXX--00000000000000000000000000000000000000000000000000000000000000000000000000000000000000000000
XXXX------XXXX--00000000000000000000000000000000000000000000000000000000000000000000000000000000000000000000
XXXX------XXXX--00000000000000000000000000000000000000000000000000000000000000000000000000000000000000000000
XXXX------XXXX--00000000000000000000000000000000000000000000000000000000000000000000000000000000000000000000
XXXX------XXXX--00000000000000000000000000000000000000000000000000000000000000000000000000000000000000000000
XXXXE-EXXXXXXX--00000000000000000000000000000000000000000000000000000000000000000000000000000000000000000000
XXXX------XXXX--00000000000000000000000000000000000000000000000000000000000000000000000000000000000000000000
XX-----------XXX00000000000000000000000000000000000000000000000000000000000000000000000000000000000000000000
XX-----------XXX00000000000000000000000000000000000000000000000000000000000000000000000000000000000000000000
XD-----------XXX00000000000000000000000000000000000000000000000000000000000000000000000000000000000000000000
XXXXX-------XXXX00000000000000000000000000000000000000000000000000000000000000000000000000000000000000000000
XXXXXXXXXXXXXXXX00000000000000000000000000000000000000000000000000000000000000000000000000000000000000000000