0000000000000000000000000000000000000000000000000000000000000000000000000000000000000000000000000000000000000000000000000000000000000000000000000000000000000000000000000000XXXX------------
0000000000000000000000000000000000000000000000000000000000000000000000000000000000000000000000000000000000000000000000000000000000000000000000000000000000000000000000000000X-----TTTT------
0000000000000000000000000000000000000000000000000000000000000000000000000000000000000000000000000000000000000000000000000000000000000000000000000000000000000000000000000000----------------
0000000000000000000000000000000000000000000000000000000000000000000000000000000000000000000000000000000000000000000000000000000000000000000000000000000000000000000000000000---TTTT---------
0000000000000000000000000000000000000000000000000000000000000000000000000000000000000000000000000000000000000000000000000000000000000000000000000000000000000000000000000000XXXX------------
0000000000000000000000000000000000000000000000000000000000000000000000000000000000000000000000000000000000000000000000000000000000000000000000000000000000000000000000000000XXXX------------
0000000000000000000000000000000000000000000000000000000000000000000000000000000000000000000000000000000000000000000000000000000000000000000000000000000000000000000000000000X-----TTTT------
0000000000000000000000000000000000000000000000000000000000000000000000000000000000000000000000000000000000000000000000000000000000000000000000000000000000000000000000000000----------------
0000000000000000000000000000000000000000000000000000000000000000000000000000000000000000000000000000000000000000000000000000000000000000000000000000000000000000000000000000---TTTT---------
0000000000000000000000000000000000000000000000000000000000000000000000000000000000000000000000000000000000000000----------------------------------------------------------------------------
0000000000000000000000000000000000000000000000000000000000000000000000000000000000000000000000000000000000000000----------------------------------------------------------------------------
0000000000000000000000000000000000000000000000000000000000000000000000000000000000000000000000000000000000000000------------------------------------------------------------XX-----TTTT---XX
0000000000000000000000000000000000000000000000000000000000000000000000000000000000000000000000000000000000000000------------------------------------------------------------XX------------XX
0000000000000000000000000000000000000000000000000000000000000000000000000000000000000000000000000000000000000000------------------------------------------------------------XX------------XX
0000000000000000000000000000000000000000000000000000000000000000000000000000000000000000000000000000000000000000------------------------------------------------------------XXXXXXXX------XX
0000000000000000000000000000000000000000000000000000000000000000000000000000000000000000000000000000000000000000------------------------------------------------------------XX-----XXXX---XX
0000000000000000000000000000000000000000000000000000000000000000000000000000000000000000000000000000000000000000------------------------------------------------------------XD------------XX
0000000000000000000000000000000000000000000000000000000000000000000000000000000000000000000000000000000000000000------------------------------------------------------------XD------------XX
0000000000000000000000000000000000000000000000000000000000000000000000000000000000000000000000000000000000000000----------------------------------------------------X-------XXXXX-------XXXX
0000000000000000000000000000000000000000000000000000000000000000000000000000000000000000000000000000000000000000---------------------------------------------------XX------XXXXXXXXXXXXXXXXX
0000000000000000000000000000000000000000000000000000000000000000000000000000000000000000000000000000000000000000--------------------------------------X-----------XXX-----XX0000000000000000
0000000000000000000000000000000000000000000000000000000000000000000000000000000000000000000000000000000000000000-------------------------------------XXX---------XXXX---XXXX0000000000000000
0000000000000000000000000000000000000000000000000000000000000000000000000000000000000000000000000000000000000000------------------------------------XXXX--------XXXXX--XXXXX0000000000000000
0000000000000000000000000000000000000000000000000000000000000000000000000000000000000000000000000000000000000000-----------------XXX---------------XXXXX-------XXXXXXXXXXXXX0000000000000000
000000000000000000000000000000000000000000000000000000000000000000000000000000000000000000000000XXXX--------XXXXXXXXXXXXXXXXXXXXXXXXXXXXXXXXXXXXXXXXXXXXXXXXXXXXXXXXXXXXXXXX0000000000000000
000000000000000000000000000000000000000000000000000000000000000000000000000000000000000000000000XXXX--TTTTTTTTXX0000000000000000000000000000000000000000000000000000000000000000000000000000
000000000000000000000000000000000000000000000000000000000000000000000000000000000000000000000000XXXX--------XXXX0000000000000000000000000000000000000000000000000000000000000000000000000000
000000000000000000000000000000000000000000000000000000000000000000000000000000000000000000000000XXXX--------XXXX0000000000000000000000000000000000000000000000000000000000000000000000000000
000000000000000000000000000000000000000000000000000000000000000000000000000000000000000000000000XXXX--------XXXX0000000000000000000000000000000000000000000000000000000000000000000000000000
000000000000000000000000000000000000000000000000000000000000000000000000000000000000000000000000XXXX--------XXXX0000000000000000000000000000000000000000000000000000000000000000000000000000
000000000000000000000000000000000000------------------------------------------------------------XXXX--------XXXX0000000000000000000000000000000000000000000000000000000000000000000000000000
000000000000000000000000000000000000------------------------------------------------------------XXXX--------XXXX0000000000000000000000000000000000000000000000000000000000000000000000000000
000000000000000000000000000000000000------------------------------------------------------------XXXX--------XXXX0000000000000000000000000000000000000000000000000000000000000000000000000000
000000000000000000000000000000000000------------------------------------------------------------XXXXXX------XXXX0000000000000000000000000000000000000000000000000000000000000000000000000000
000000000000000000000000000000000000------------------------------------------------------------XXXX--------XXXX0000000000000000000000000000000000000000000000000000000000000000000000000000
000000000000000000000000000000000000------------------------------------------------------------XXXX--------XXXX0000000000000000000000000000000000000000000000000000000000000000000000000000
000000000000000000000000000000000000------------------------------------------------------------XX----TTTTTTTTXX0000000000000000000000000000000000000000000000000000000000000000000000000000
000000000000000000000000000000000000----------------------------?SS?S---------------------------XX------------XX0000000000000000000000000000000000000000000000000000000000000000000000000000
000000000000000000000000000000000000------------------------------------------------------------XX------------XX0000000000000000000000000000000000000000000000000000000000000000000000000000
000000000000000000000000000000000000------------------------------------------------------------XXXXXXXX------XX0000000000000000000000000000000000000000000000000000000000000000000000000000
000000000000000000000000000000000000-------------------------------------------E----------------XX-----XXXX---XX0000000000000000000000000000000000000000000000000000000000000000000000000000
000000000000000000000000000000000000-------------E----S----------SSSS---------<>----------------XD------------XX0000000000000000000000000000000000000000000000000000000000000000000000000000
000000000000000000000000000000000000------------------------------------------[]----------------XXXXX-------XXXX0000000000000000000000000000000000000000000000000000000000000000000000000000
000000000000000000000000000000000000------------------------------------------[]---------------EXXXXXXXXXXXXXXXX0000000000000000000000000000000000000000000000000000000000000000000000000000
000000000000000000000000000000000000-------E----------E-------E---------------[]--E------------E00000000000000000000000000000000000000000000000000000000000000000000000000000000000000000000
00000000000000000000XXXX--------XXXXXXXXXXXXXXXXX-XXXXXXXXXXXXXXXXXXXXXXXXXXXXXXXXXXXXXXXXXXXXXX00000000000000000000000000000000000000000000000000000000000000000000000000000000000000000000
00000000000000000000XXXX--------XXXX00000000000000000000000000000000000000000000000000000000000000000000000000000000000000000000000000000000000000000000000000000000000000000000000000000000
00000000000000000000XXXX--------XXXX00000000000000000000000000000000000000000000000000000000000000000000000000000000000000000000000000000000000000000000000000000000000000000000000000000000
00000000000000000000XXXX--XXXXXXXXXX00000000000000000000000000000000000000000000000000000000000000000000000000000000000000000000000000000000000000000000000000000000000000000000000000000000
--------------------XXXX--------XXXX00000000000000000000000000000000000000000000000000000000000000000000000000000000000000000000000000000000000000000000000000000000000000000000000000000000
--------------------XXXX--------XXXX00000000000000000000000000000000000000000000000000000000000000000000000000000000000000000000000000000000000000000000000000000000000000000000000000000000
--------------------XXXX--------XXXX00000000000000000000000000000000000000000000000000000000000000000000000000000000000000000000000000000000000000000000000000000000000000000000000000000000
--------------------XXXX--------XXXX00000000000000000000000000000000000000000000000000000000000000000000000000000000000000000000000000000000000000000000000000000000000000000000000000000000
--------------------XXXX--------XXXX00000000000000000000000000000000000000000000000000000000000000000000000000000000000000000000000000000000000000000000000000000000000000000000000000000000
--------------------XXXX--------XXXX00000000000000000000000000000000000000000000000000000000000000000000000000000000000000000000000000000000000000000000000000000000000000000000000000000000
--------------------XXXX--------XXXX00000000000000000000000000000000000000000000000000000000000000000000000000000000000000000000000000000000000000000000000000000000000000000000000000000000
--------------------XXXX--------XXXX00000000000000000000000000000000000000000000000000000000000000000000000000000000000000000000000000000000000000000000000000000000000000000000000000000000
--------------------XXXX--------XXXX00000000000000000000000000000000000000000000000000000000000000000000000000000000000000000000000000000000000000000000000000000000000000000000000000000000
--------------------XXXX--------XXXX00000000000000000000000000000000000000000000000000000000000000000000000000000000000000000000000000000000000000000000000000000000000000000000000000000000
--------------------XXXX--------XXXX00000000000000000000000000000000000000000000000000000000000000000000000000000000000000000000000000000000000000000000000000000000000000000000000000000000
----E---------------XX--TT--XXXXXXXX00000000000000000000000000000000000000000000000000000000000000000000000000000000000000000000000000000000000000000000000000000000000000000000000000000000
---<>---------------XD------------XX00000000000000000000000000000000000000000000000000000000000000000000000000000000000000000000000000000000000000000000000000000000000000000000000000000000
---[]---------------XD------------XX00000000000000000000000000000000000000000000000000000000000000000000000000000000000000000000000000000000000000000000000000000000000000000000000000000000
---[]E---------E-E--XXXXX-------XXXX00000000000000000000000000000000000000000000000000000000000000000000000000000000000000000000000000000000000000000000000000000000000000000000000000000000
XXXXXXXXXXXXXXXXXXXXXXXXXXXXXXXXXXXX00000000000000000000000000000000000000000000000000000000000000000000000000000000000000000000000000000000000000000000000000000000000000000000000000000000
00000000000000000000000000000000000000000000000000000000000000000000000000000000000000000000000000000000000000000000000000000000000000000000000000000000000000000000000000000000000000000000