00000000000000000000000000000000000000000000000000000000000000000000000000000000000000000000----------------
00000000000000000000000000000000000000000000000000000000000000000000000000000000000000000000------------T---
00000000000000000000000000000000000000000000000000000000000000000000000000000000000000000000-----TT--TT-----
00000000000000000000000000000000000000000000000000000000000000000000000000000000000000000000----------------
000000000000000000000000000000000000000000000000000000000000000000000000------------------------------------
000000000000000000000000000000000000000000000000000000000000000000000000----------------------------TTTT----
000000000000000000000000000000000000000000000000000000000000000000000000------------------------------------
000000000000000000000000000000000000000000000000000000000000000000000000----------------------TTTTTTTT------
00000000000000000000000000000000000000000000000000000000----------XXXX--S-----------------------------------
00000000000000000000000000000000000000000000000000000000----------XXXX--S-----------------------------------
00000000000000000000000000000000000000000000000000000000----------XXXX--S---------------------------TT------
00000000000000000000000000000000000000000000000000000000----------XXXX--S-----------------------------------
00000000000000000000000000000000000000000000000000000000----------XXXX--S-----------------------------------
00000000000000000000000000000000000000000000000000000000----------XXXX--S-------------------X------------XXX
00000000000000000000000000000000000000000000000000000000----------XXXX--S-------------------X------------XXX
00000000000000000000000000000000000000000000000000000000----------XXXX--S----E--------------X---EXXXXXXXXXXX
00000000000000000000000000000000000000000000000000000000----------XXXX--S---<>--------------XXXXXXXXXXXX--XX
00000000000000000000000000000000000000000000000000000000----------XXXX--S---[]--------------TTTTXXXXXXXX--DX
00000000000000000000000000000000000000000000000000000000----------XXXX--S---[]----------------TTTTTTTT----DX
00000000000000000000000000000000000000000000000000000000------------XX--XXXXXXXXXXXXXXXXXXXX---------TTTTTTT
00000000000000000000000000000000000000000000000000000000X---TTTT----XXXX000000000000000000000000000000000000
00000000000000000000000000000000000000000000000000000000X-----------XXXX000000000000000000000000000000000000
00000000000000000000000000000000000000000000000000000000X-------------XX000000000000000000000000000000000000
00000000000000000000000000000000000000000000000000000000X-------------XX000000000000000000000000000000000000
00000000000000000000000000000000000000000000000000000000XXXX----------XX000000000000000000000000000000000000
00000000000000000000000000000000000000000000000000000000TTTTXXXXXXXX--XX000000000000000000000000000000000000
00000000000000000000000000000000000000000000000000000000--TTTTTTTT----DX000000000000000000000000000000000000
00000000000000000000000000000000000000000000000000000000---------TTTTTTT000000000000000000000000000000000000
00000000000000000000000000000000000000000000000000000000XXXX--------XXXX000000000000000000000000000000000000
00000000000000000000000000000000000000000000000000000000XXTTTT------XXXX000000000000000000000000000000000000
00000000000000000000000000000000000000000000000000000000XXXX--------XXXX000000000000000000000000000000000000
00000000000000000000000000000000000000000000000000000000XXXX--------XXXX000000000000000000000000000000000000
00000000000000000000000000000000000000000000000000000000XXXX--------XXXX000000000000000000000000000000000000
00000000000000000000000000000000000000000000000000000000XXXX--------XXXX000000000000000000000000000000000000
00000000000000000000000000000000000000000000000000000000XXXX--------XXXX000000000000000000000000000000000000
00000000000000000000000000000000000000000000000000000000XXXX--------XXXX000000000000000000000000000000000000
00000000000000000000000000000000000000000000000000000000XXXX--------XXXX000000000000000000000000000000000000
00000000000000000000000000000000000000000000000000000000XXXX--------XXXX000000000000000000000000000000000000
00000000000000000000000000000000000000000000000000000000XXXX--------XXXX000000000000000000000000000000000000
00000000000000000000000000000000000000000000000000000000XXXX--------XXXX000000000000000000000000000000000000
00000000000000000000000000000000000000000000000000000000XXXX--------XXXX000000000000000000000000000000000000
00000000000000000000000000000000000000000000000000000000XXXX--------XXXX000000000000000000000000000000000000
00000000000000000000000000000000000000000000000000000000XXXX--------XXXX000000000000000000000000000000000000
00000000000000000000000000000000000000000000000000000000XXXX--------XXXX000000000000000000000000000000000000
00000000000000000000000000000000000000000000000000000000XXXXXXXXXXXX----000000000000000000000000000000000000
00000000000000000000000000000000000000000000000000000000TTTTXXXXXXXX--DX000000000000000000000000000000000000
00000000000000000000000000000000000000000000000000000000--TTTTTTTT----DX000000000000000000000000000000000000
00000000000000000000000000000000000000000000000000000000---------TTTTTTT000000000000000000000000000000000000
00000000000000000000000000000000000000000000000000000000XXXX------XXXX--000000000000000000000000000000000000
00000000000000000000000000000000000000000000000000000000XXXX------XXXX--000000000000000000000000000000000000
00000000000000000000000000000000000000000000000000000000XXXX------XXXX--000000000000000000000000000000000000
00000000000000000000000000000000000000000000000000000000XXXX------XXXX--000000000000000000000000000000000000
00000000000000000000000000000000000000000000000000000000XXXX------XXXX--000000000000000000000000000000000000
00000000000000000000000000000000000000000000000000000000XXXXE-EXXXXXXX--000000000000000000000000000000000000
00000000000000000000000000000000000000000000000000000000XXXX------XXXX--000000000000000000000000000000000000
00000000000000000000000000000000000000000000000000000000XX----------XXXX000000000000000000000000000000000000
00000000000000000000000000000000000000000000000000000000XX--TT------XXXX000000000000000000000000000000000000
00000000000000000000000000000000000000000000000000000000XX-----------XXX000000000000000000000000000000000000
00000000000000000000000000000000000000000000000000000000XX----------XXXX000000000000000000000000000000000000
00000000000000000000000000000000000000000000000000000000XTTTT------XXXX-000000000000000000000000000000000000
00000000000000000000000000000000000000000000000000000000X--T----XXXXXXXX000000000000000000000000000000000000
00000000000000000000000000000000000000000000000000000000X-----------XXXX000000000000000000000000000000000000
00000000000000000000000000000000000000000000000000000000X-------------XX000000000000000000000000000000000000
00000000000000000000000000000000000000000000000000000000X-------------XX000000000000000000000000000000000000
00000000000000000000000000000000000000000000000000000000XXXX----------XX000000000000000000000000000000000000
00000000000000000000000000000000000000000000000000000000TTTTXXXXXXXX--XX000000000000000000000000000000000000
00000000000000000000000000000000000000000000000000000000--TTTTTTTT----DX000000000000000000000000000000000000
00000000000000000000000000000000000000000000000000000000---------TTTTTTT000000000000000000000000000000000000
00000000000000000000000000000000000000000000000000000000XX------------XX000000000000000000000000000000000000
00000000000000000000000000000000000000000000000000000000XXXX--------XXXX000000000000000000000000000000000000
00000000000000000000000000000000000000000000000000000000XXXX--------XXXX000000000000000000000000000000000000
00000000000000000000000000000000000000000000000000000000XXXX--------XXXX000000000000000000000000000000000000
00000000000000000000000000000000000000000000000000000000XXXX--------XXXX000000000000000000000000000000000000
00000000000000000000000000000000000000000000000000000000X-----------XXXX000000000000000000000000000000000000
00000000000000000000000000000000000000000000000000000000X-----------XX-X000000000000000000000000000000000000
00000000000000000000000000000000000000000000000000000000X-----------XX-X000000000000000000000000000000000000
00000000000000000000000000000000000000000000000000000000X-----------XX-X000000000000000000000000000000000000
00000000000000000000000000000000000000000000000000000000X-----XXXXXXXX-X000000000000000000000000000000000000
00000000000000000000000000000000000000000000000000000000X-----XX-------X000000000000000000000000000000000000
00000000000000000000000000000000000000000000000000000000X----XXXXXXXX--X000000000000000000000000000000000000
00000000000000000000000000000000000000000000000000000000X-------XXXXXXXX000000000000000000000000000000000000
00000000000000000000000000000000000000000000000000000000X-----------XXXX000000000000000000000000000000000000
00000000000000000000000000000000000000000000000000000000X-------------XX000000000000000000000000000000000000
00000000000000000000000000000000000000000000000000000000X-------------XX000000000000000000000000000000000000
00000000000000000000000000000000000000000000000000000000XXXX----------XX000000000000000000000000000000000000
00000000000000000000000000000000000000000000000000000000TTTTXXXXXXXX--XX000000000000000000000000000000000000
00000000000000000000000000000000000000000000000000000000--TTTTTTTT----DX000000000000000000000000000000000000
0000000000000000-------------------------------------------------TTTTTTT000000000000000000000000000000000000
0000000000000000----------------------------------------0000000000000000000000000000000000000000000000000000
0000000000000000----------------------------------------0000000000000000000000000000000000000000000000000000
0000000000000000----------------------------------------0000000000000000000000000000000000000000000000000000
XXXX--------XXXXS-------------------S-------------------0000000000000000000000000000000000000000000000000000
XXXX--------XXXXS-------------------S-------------------0000000000000000000000000000000000000000000000000000
XXXX--------XXXXS-------------------S-------------------0000000000000000000000000000000000000000000000000000
XXXX--------XXXXS-------------------S-------------------0000000000000000000000000000000000000000000000000000
XXXX---------XXXS-------------------S----------------XX-0000000000000000000000000000000000000000000000000000
XXXX----------XXS-------------------S-------------------0000000000000000000000000000000000000000000000000000
XXXXTTTXXXX---XXS---E---------------S-------------------0000000000000000000000000000000000000000000000000000
X-----------DXXXS--<>---------------S-----------XXXXX---0000000000000000000000000000000000000000000000000000
X-----------DXXXS--[]---------------S-------------------0000000000000000000000000000000000000000000000000000
XTTTT------XXXXXS--[]---------------S-------------------0000000000000000000000000000000000000000000000000000
X---XXXXXXXX--XXS--[]--E-E----------S-------------------0000000000000000000000000000000000000000000000000000
X----------XXXXXXXXXXXXXXXXXXXXXXXXXXXXXXXXXXXXXX-------0000000000000000000000000000000000000000000000000000
X-----------XXXX00000000000000000000000000000000000000000000000000000000000000000000000000000000000000000000
X-------------XX00000000000000000000000000000000000000000000000000000000000000000000000000000000000000000000
X-------------XX00000000000000000000000000000000000000000000000000000000000000000000000000000000000000000000
X-------XXXXXXXX00000000000000000000000000000000000000000000000000000000000000000000000000000000000000000000
XXXXXXXXXXXX----00000000000000000000000000000000000000000000000000000000000000000000000000000000000000000000
TTTTXXXXXXXX--DX00000000000000000000000000000000000000000000000000000000000000000000000000000000000000000000
--TTTTTTTT----DX00000000000000000000000000000000000000000000000000000000000000000000000000000000000000000000
---------TTTTTTT00000000000000000000000000000000000000000000000000000000000000000000000000000000000000000000
XXXX------XXXX--00000000000000000000000000000000000000000000000000000000000000000000000000000000000000000000
XXXX------XXXX--00000000000000000000000000000000000000000000000000000000000000000000000000000000000000000000
-XXXX------XXXX-00000000000000000000000000000000000000000000000000000000000000000000000000000000000000000000
XXXX-------XXXX-00000000000000000000000000000000000000000000000000000000000000000000000000000000000000000000
XXXX-----XXXX---00000000000000000000000000000000000000000000000000000000000000000000000000000000000000000000
XXXX--------XXXX00000000000000000000000000000000000000000000000000000000000000000000000000000000000000000000
XXXX--------XXXX00000000000000000000000000000000000000000000000000000000000000000000000000000000000000000000
XXXX--------XXXX00000000000000000000000000000000000000000000000000000000000000000000000000000000000000000000
XXXX--------XXXX00000000000000000000000000000000000000000000000000000000000000000000000000000000000000000000
XXXX--------XXXX00000000000000000000000000000000000000000000000000000000000000000000000000000000000000000000
XXXX--------XXXX00000000000000000000000000000000000000000000000000000000000000000000000000000000000000000000
XXXX--------XXXX00000000000000000000000000000000000000000000000000000000000000000000000000000000000000000000
X-------XXXXXXXX00000000000000000000000000000000000000000000000000000000000000000000000000000000000000000000
X-----------XXXX00000000000000000000000000000000000000000000000000000000000000000000000000000000000000000000
X-------------XX00000000000000000000000000000000000000000000000000000000000000000000000000000000000000000000
X-------------XX00000000000000000000000000000000000000000000000000000000000000000000000000000000000000000000
XXXX----------XX00000000000000000000000000000000000000000000000000000000000000000000000000000000000000000000
TTTTXXXXXXXX--XX00000000000000000000000000000000000000000000000000000000000000000000000000000000000000000000
--TTTTTTTT----DX00000000000000000000000000000000000000000000000000000000000000000000000000000000000000000000
---------TTTTTTT00000000000000000000000000000000000000000000000000000000000000000000000000000000000000000000