000000000000000000000000000000000000000000000000000000000000000000000000----------------------------------------000000000000000
000000000000000000000000000000000000000000000000000000000000000000000000----------------------------------------000000000000000
00000000000000000000000000000000000000000000000000000000-----TTTTT----------------------------------------------000000000000000
00000000000000000000000000000000000000000000000000000000--------------------------------------------------------000000000000000
00000000000000000000000000000000000000000000000000000000----------------S-------------------S-------------------000000000000000
00000000000000000000000000000000000000000000000000000000-----TTTT-------S-------------------S-------------------000000000000000
00000000000000000000000000000000000000000000000000000000----------------S-------------------S-------------------000000000000000
00000000000000000000000000000000000000000000000000000000----------------S-------------------S-------------------000000000000000
00000000000000000000000000000000000000000000000000000000TTTTTTTT--------S-------------------S-------------------000000000000000
00000000000000000000000000000000000000000000000000000000----------------S-------------------S-------------------000000000000000
00000000000000000000000000000000000000000000000000000000---TTTT---------S-------------------S--------E----------000000000000000
00000000000000000000000000000000000000000000000000000000----------------S-------------------S-------<>----------000000000000000
00000000000000000000000000000000000000000000000000000000---TTTT---------S-------------------S-------[]----------000000000000000
00000000000000000000000000000000000000000000000000000000----------------S-------------------S-------[]----------000000000000000
00000000000000000000000000000000000000000000000000000000----------------S---EE--------------S--E----[]----------000000000000000
00000000000000000000000000000000000000000000000000000000XX-----TTTT--XXXXXXXXXXXXXXXXXXXXXXXXXXXXXXXXXXXXXXXXXXX000000000000000
00000000000000000000000000000000000000000000000000000000XX----------XXXX0000000000000000000000000000000000000000000000000000000
00000000000000000000000000000000000000000000000000000000XD-----------XXX0000000000000000000000000000000000000000000000000000000
00000000000000000000000000000000000000000000000000000000XXXXXXXXXXXX----0000000000000000000000000000000000000000000000000000000
00000000000000000000000000000000000000000000000000000000TTTTXXXXXXXX--DX0000000000000000000000000000000000000000000000000000000
00000000000000000000000000000000000000000000000000000000--TTTTTTTT----DX0000000000000000000000000000000000000000000000000000000
00000000000000000000000000000000000000000000000000000000---------TTTTTTT0000000000000000000000000000000000000000000000000000000
00000000000000000000000000000000000000000000000000000000XX-----XXXXXXXXX0000000000000000000000000000000000000000000000000000000
00000000000000000000000000000000000000000000000000000000XXXX--------XXXX0000000000000000000000000000000000000000000000000000000
00000000000000000000000000000000000000000000000000000000XXXX--------XXXX0000000000000000000000000000000000000000000000000000000
00000000000000000000000000000000000000000000000000000000XXXX--------XXXX0000000000000000000000000000000000000000000000000000000
0000000000000000----------------------------------------XXXX--------XXXX0000000000000000000000000000000000000000000000000000000
0000000000000000----------------------------------------XXXX--------XXXX0000000000000000000000000000000000000000000000000000000
0000000000000000----------------------------------------XXXX--------XXXX0000000000000000000000000000000000000000000000000000000
0000000000000000----------------------------------------XXXX--------XXXX0000000000000000000000000000000000000000000000000000000
--------X-------S-------------------S-------------------XXXX--------XXXX0000000000000000000000000000000000000000000000000000000
-------X--T-----S-------------------S-------------------XXXX--------XXXX0000000000000000000000000000000000000000000000000000000
----------------S-------------------S-------------------XXXX--------XXXX0000000000000000000000000000000000000000000000000000000
----------------S-------------------S-------------------XXXX--------XXXX0000000000000000000000000000000000000000000000000000000
-----TTTTT------S-------------------S-------------------XXXX--------XXXX0000000000000000000000000000000000000000000000000000000
----------------S------------X------S-------------------XXXXTTTT----XXXX0000000000000000000000000000000000000000000000000000000
----------------S-----------XX------S-----E-------------X-----------XXXX0000000000000000000000000000000000000000000000000000000
---TTTT--TTTT---S--------XXXXXXXX---S----<>-------------X-----------XXXX0000000000000000000000000000000000000000000000000000000
----------------S--------XXXXXXX----S----[]-------------XXXXXXXXXXXXXXXX0000000000000000000000000000000000000000000000000000000
----------------S--------XXXXXXXX---S----[]-------------TTTTXXXXXXXX--DX0000000000000000000000000000000000000000000000000000000
---XXXX--TTT----S--------XXXXXXXXXXXS----[]---------------TTTTTTTT----DX0000000000000000000000000000000000000000000000000000000
--TTXXX---XXXX--XXXXXXXXXXXXXXXXXXXXXXXXXXXXXXXXXXXXXXXX---------TTTTTTT0000000000000000000000000000000000000000000000000000000
----XXXX--XXXX--000000000000000000000000000000000000000000000000000000000000000000000000000000000000000000000000000000000000000
----XXXX--XXXX--000000000000000000000000000000000000000000000000000000000000000000000000000000000000000000000000000000000000000
----XXXX--XXXX--000000000000000000000000000000000000000000000000000000000000000000000000000000000000000000000000000000000000000
XTTTTTTTT---XXXX000000000000000000000000000000000000000000000000000000000000000000000000000000000000000000000000000000000000000
XXXX--------XXXX000000000000000000000000000000000000000000000000000000000000000000000000000000000000000000000000000000000000000
TTTTXXXXXXXX--XX000000000000000000000000000000000000000000000000000000000000000000000000000000000000000000000000000000000000000
--TTTTTTTT----DX000000000000000000000000000000000000000000000000000000000000000000000000000000000000000000000000000000000000000
---------TTTTTTT000000000000000000000000000000000000000000000000000000000000000000000000000000000000000000000000000000000000000
X-----XXXXXXXX-X000000000000000000000000000000000000000000000000000000000000000000000000000000000000000000000000000000000000000
X-----XX-------X000000000000000000000000000000000000000000000000000000000000000000000000000000000000000000000000000000000000000
X-----DX-------X000000000000000000000000000000000000000000000000000000000000000000000000000000000000000000000000000000000000000
X---XXXXXXXX---X000000000000000000000000000000000000000000000000000000000000000000000000000000000000000000000000000000000000000
XXXXXXXXXXXXXXXX000000000000000000000000000000000000000000000000000000000000000000000000000000000000000000000000000000000000000
XXXX-------XXXXX000000000000000000000000000000000000000000000000000000000000000000000000000000000000000000000000000000000000000
XXXX-----XXXX---000000000000000000000000000000000000000000000000000000000000000000000000000000000000000000000000000000000000000
XXXX--------XXXX000000000000000000000000000000000000000000000000000000000000000000000000000000000000000000000000000000000000000
XXXX--------XXXX000000000000000000000000000000000000000000000000000000000000000000000000000000000000000000000000000000000000000
XXXX--------XXXX000000000000000000000000000000000000000000000000000000000000000000000000000000000000000000000000000000000000000
X------------DXX000000000000000000000000000000000000000000000000000000000000000000000000000000000000000000000000000000000000000
X------------DXX000000000000000000000000000000000000000000000000000000000000000000000000000000000000000000000000000000000000000
X---T--XXXXXXXXX000000000000000000000000000000000000000000000000000000000000000000000000000000000000000000000000000000000000000
X---X--------XXX000000000000000000000000000000000000000000000000000000000000000000000000000000000000000000000000000000000000000
X-------------XX000000000000000000000000000000000000000000000000000000000000000000000000000000000000000000000000000000000000000
X-------------XX000000000000000000000000000000000000000000000000000000000000000000000000000000000000000000000000000000000000000
XXXX----------XX000000000000000000000000000000000000000000000000000000000000000000000000000000000000000000000000000000000000000
TTTTXXXXXXXX--XX000000000000000000000000000000000000000000000000000000000000000000000000000000000000000000000000000000000000000
--TTTTTTTT----DX000000000000000000000000000000000000000000000000000000000000000000000000000000000000000000000000000000000000000
---------TTTTTTT000000000000000000000000000000000000000000000000000000000000000000000000000000000000000000000000000000000000000
X-TX-XXXXXXX--XX000000000000000000000000000000000000000000000000000000000000000000000000000000000000000000000000000000000000000
X--X-----------X000000000000000000000000000000000000000000000000000000000000000000000000000000000000000000000000000000000000000
X--X----------XX000000000000000000000000000000000000000000000000000000000000000000000000000000000000000000000000000000000000000
X-TX-----XXXX-XX000000000000000000000000000000000000000000000000000000000000000000000000000000000000000000000000000000000000000
X--X----------XX000000000000000000000000000000000000000000000000000000000000000000000000000000000000000000000000000000000000000
X--XX---------XX000000000000000000000000000000000000000000000000000000000000000000000000000000000000000000000000000000000000000
X-XXXXXXXX----XX000000000000000000000000000000000000000000000000000000000000000000000000000000000000000000000000000000000000000
X-------------XX000000000000000000000000000000000000000000000000000000000000000000000000000000000000000000000000000000000000000
X-------------DX000000000000000000000000000000000000000000000000000000000000000000000000000000000000000000000000000000000000000
X-------------DX000000000000000000000000000000000000000000000000000000000000000000000000000000000000000000000000000000000000000
X------XXXXXXXXX000000000000000000000000000000000000000000000000000000000000000000000000000000000000000000000000000000000000000
X-------XXXXXXXX000000000000000000000000000000000000000000000000000000000000000000000000000000000000000000000000000000000000000
X-----------XXXX000000000000000000000000000000000000000000000000000000000000000000000000000000000000000000000000000000000000000
X-------------XX000000000000000000000000000000000000000000000000000000000000000000000000000000000000000000000000000000000000000
X-------------XX000000000000000000000000000000000000000000000000000000000000000000000000000000000000000000000000000000000000000
X------------XXX000000000000000000000000000000000000000000000000000000000000000000000000000000000000000000000000000000000000000
XXXXX---------DX000000000000000000000000000000000000000000000000000000000000000000000000000000000000000000000000000000000000000
TTTTXXXXXXXX--DX000000000000000000000000000000000000000000000000000000000000000000000000000000000000000000000000000000000000000
--TTTTTTTT----DX000000000000000000000000000000000000000000000000000000000000000000000000000000000000000000000000000000000000000
---------TTTTTTT000000000000000000000000000000000000000000000000000000000000000000000000000000000000000000000000000000000000000
----------------000000000000000000000000000000000000000000000000000000000000000000000000000000000000000000000000000000000000000
--TTTTTTTT------000000000000000000000000000000000000000000000000000000000000000000000000000000000000000000000000000000000000000
----------------000000000000000000000000000000000000000000000000000000000000000000000000000000000000000000000000000000000000000
----------------000000000000000000000000000000000000000000000000000000000000000000000000000000000000000000000000000000000000000
----X-----------000000000000000000000000000000000000000000000000000000000000000000000000000000000000000000000000000000000000000
----------------000000000000000000000000000000000000000000000000000000000000000000000000000000000000000000000000000000000000000
----------------000000000000000000000000000000000000000000000000000000000000000000000000000000000000000000000000000000000000000
XXXXXXX---------000000000000000000000000000000000000000000000000000000000000000000000000000000000000000000000000000000000000000
----------------000000000000000000000000000000000000000000000000000000000000000000000000000000000000000000000000000000000000000
------TTTT------000000000000000000000000000000000000000000000000000000000000000000000000000000000000000000000000000000000000000
----------------000000000000000000000000000000000000000000000000000000000000000000000000000000000000000000000000000000000000000
---------TTT----000000000000000000000000000000000000000000000000000000000000000000000000000000000000000000000000000000000000000
----------------000000000000000000000000000000000000000000000000000000000000000000000000000000000000000000000000000000000000000
X-----------TTTT000000000000000000000000000000000000000000000000000000000000000000000000000000000000000000000000000000000000000
X--------------X000000000000000000000000000000000000000000000000000000000000000000000000000000000000000000000000000000000000000
X--------------X000000000000000000000000000000000000000000000000000000000000000000000000000000000000000000000000000000000000000
XXXXXXXXXXXX---X000000000000000000000000000000000000000000000000000000000000000000000000000000000000000000000000000000000000000
TTTTXXXXXXXX--DX000000000000000000000000000000000000000000000000000000000000000000000000000000000000000000000000000000000000000
--TTTTTTTT----DX000000000000000000000000000000000000000000000000000000000000000000000000000000000000000000000000000000000000000
---------TTTTTTT000000000000000000000000000000000000000000000000000000000000000000000000000000000000000000000000000000000000000