0000000000000000000000000000000000000000000000000000000000000000000000000000XD-------------X
0000000000000000000000000000000000000000000000000000000000000000000000000000X--TTTTTT-------
0000000000000000000000000000000000000000000000000000000000000000000000000000----------------
0000000000000000000000000000000000000000000000000000000000000000000000000000----------------
0000000000000000000000000000000000000000000000000000000000000000000000000000XXXXXXX---------
0000000000000000000000000000000000000000000000000000000000000000000000000000----------------
0000000000000000000000000000000000000000000000000000000000000000000000000000------TTTT------
0000000000000000000000000000000000000000000000000000000000000000000000000000----------------
0000000000000000000000000000000000000000000000000000000000000000000000000000---------TTT----
0000000000000000000000000000000000000000000000000000000000000000000000000000----------------
0000000000000000000000000000000000000000000000000000000000000000000000000000X-----------TTTT
0000000000000000000000000000000000000000000000000000000000000000000000000000X--------------X
0000000000000000000000000000000000000000000000000000000000000000000000000000X--------------X
0000000000000000000000000000000000000000000000000000000000000000000000000000XXXXXXXXX------X
0000000000000000000000000000000000000000000000000000000000000000000000000000XX-------------X
0000000000000000000000000000000000000000000000000000000000000000000000000000XX-------TTTT-TT
0000000000000000000000000000000000000000000000000000000000000000000000000000XD-------------X
0000000000000000000000000000000000000000000000000000000000000000000000000000XD-------------X
0000000000000000000000000000000000000000000000000000000000000000000000000000XXXXX---XXXXXXXX
0000000000000000000000000000000000000000000000000000000000000000000000000000XXXXXXXXXXXXXXXX
0000000000000000000000000000000000000000000000000000000000000000000000000000XX------------XX
0000000000000000000000000000000000000000000000000000000000000000000000000000XXXXXXXX------XX
0000000000000000000000000000000000000000000000000000000000000000000000000000XX-----TTTT---XX
0000000000000000000000000000000000000000000000000000000000000000000000000000XX------------XX
0000000000000000000000000000000000000000000000000000000000000000000000000000XXX----------XXX
0000000000000000000000000000000000000000000000000000000000000000000000000000XXXX----------DX
0000000000000000000000000000000000000000000000000000000000000000000000000000XX------------DX
0000000000000000000000000000000000000000000000000000000000000000000000000000XXXX--------XXXX
0000000000000000000000000000000000000000000000000000000000000000000000000000XXXXXX------XXXX
0000000000000000000000000000000000000000000000000000000000000000000000000000XXXX--------XXXX
0000000000000000000000000000000000000000000000000000000000000000000000000000XXXX--------XXXX
0000000000000000000000000000000000000000000000000000000000000000000000000000XX----TTTTTTTTXX
0000000000000000000000000000000000000000000000000000000000000000000000000000XX------------XX
0000000000000000000000000000000000000000000000000000000000000000000000000000XX------------XX
0000000000000000000000000000000000000000000000000000000000000000000000000000XXXXXXXX------XX
0000000000000000000000000000000000000000000000000000000000000000000000000000XX-----XXXX---XX
0000000000000000000000000000000000000000000000000000000000000000000000000000XD------------XX
0000000000000000000000000000000000000000000000000000000000000000000000000000XD------------XX
0000000000000000000000000000000000000000000000000000000000000000000000000000XXXXX---XXXXXXXX
0000000000000000000000000000000000000000000000000000000000000000000000000000XXXXXXXXXXXXXXXX
0000000000000000000000000000000000000000000000000000000000000000000000000000XXXXXXXX----XXXX
0000000000000000000000000000000000000000000000000000000000000000000000000000----------------
0000000000000000000000000000000000000000000000000000000000000000000000000000----------------
0000000000000000000000000000000000000000000000000000000000000000000000000000--------XXXX----
000000000000000000000000000000000000------------------------------------------------XXXX----
000000000000000000000000000000000000----------------------------------------------XXXXXX----
00000000000000000000TTT---------------------------------------------------------------------
00000000000000000000-----------------------------------------------------------XXXX---------
00000000000000000000----------------S-------------------S----------------------XX-----------
00000000000000000000-TTTT-----------S-------------------S-------------------XXXXXXXXXXXX--XX
00000000000000000000----------------S-------------------S-------------------XXXXXXXXXXXX---X
00000000000000000000----------------S------------X------S-------------------XXXXXXXXXXXX---X
00000000000000000000-----X----------S------------XX-----S-------------------XXXX----------XX
00000000000000000000----------------S-----------XXX-----S-------------------XXXX-----------X
00000000000000000000-----E----------S----------XXXX---E-S-------------------XXXX-----------X
00000000000000000000----TTT---------S--------XXXXXX--<>-S---------------o---XX-------TTTT-TT
00000000000000000000----------------S------XXXXXXXX--[]-S-------------------XD-------------X
00000000000000000000------XXXX------S-----XXXXXXXXX--[]-S-------------------XD-------------X
00000000000000000000----------------S----XXXXXXXXXX--[]-S-----------------E-XXXXX---XXXXXXXX
00000000000000000000----XXXX--------XXXXXXXXXXXXXXXXXXXXXXXXXXXXXXXXXXXXXXXXXXXXXXXXXXXXXXXX
00000000000000000000----------------00000000000000000000000000000000000000000000000000000000
00000000000000000000XXXX----------XX00000000000000000000000000000000000000000000000000000000
00000000000000000000XD-------------X00000000000000000000000000000000000000000000000000000000
00000000000000000000XD-------------X00000000000000000000000000000000000000000000000000000000
00000000000000000000XXXXX---XXXXXXXX00000000000000000000000000000000000000000000000000000000
00000000000000000000XXXXXXXXXXXXXXXX00000000000000000000000000000000000000000000000000000000
00000000000000000000XXXX------XXXX--00000000000000000000000000000000000000000000000000000000
00000000000000000000XXXX------XXXX--00000000000000000000000000000000000000000000000000000000
00000000000000000000XXXX------XXXX--00000000000000000000000000000000000000000000000000000000
00000000000000000000XXXX------XXXX--00000000000000000000000000000000000000000000000000000000
00000000000000000000XXXX------XXXX--00000000000000000000000000000000000000000000000000000000
00000000000000000000XXXX------XXXX--00000000000000000000000000000000000000000000000000000000
00000000000000000000XXXX------XXXX--00000000000000000000000000000000000000000000000000000000
00000000000000000000XXXX------XXXX--00000000000000000000000000000000000000000000000000000000
00000000000000000000XXXXE-EXXXXXXX--00000000000000000000000000000000000000000000000000000000
00000000000000000000XXXX------XXXX--00000000000000000000000000000000000000000000000000000000
00000000000000000000XXXX-------XXXX-00000000000000000000000000000000000000000000000000000000
00000000000000000000XXXX---------XXX00000000000000000000000000000000000000000000000000000000
00000000000000000000XX--TTTTTTTT--XX00000000000000000000000000000000000000000000000000000000
00000000000000000000XX----------XXXX00000000000000000000000000000000000000000000000000000000
00000000000000000000XX-------------X00000000000000000000000000000000000000000000000000000000
00000000000000000000XX-----XXXX---TX00000000000000000000000000000000000000000000000000000000
00000000000000000000XD-------------X00000000000000000000000000000000000000000000000000000000
00000000000000000000XD-------------X00000000000000000000000000000000000000000000000000000000
00000000000000000000XXXXX---XXXXXXXX00000000000000000000000000000000000000000000000000000000
00000000000000000000XXXXXXXXXXXXXXXX00000000000000000000000000000000000000000000000000000000
00000000000000000000--------XXXX----00000000000000000000000000000000000000000000000000000000
00000000000000000000-------XXXX-----00000000000000000000000000000000000000000000000000000000
00000000000000000000---------XXXX---00000000000000000000000000000000000000000000000000000000
00000000000000000000----------XX----00000000000000000000000000000000000000000000000000000000
00000000000000000000----------XXXX--00000000000000000000000000000000000000000000000000000000
00000000000000000000-----------XXXX-00000000000000000000000000000000000000000000000000000000
00000000000000000000------------XX--00000000000000000000000000000000000000000000000000000000
00000000000000000000----------XXXX--00000000000000000000000000000000000000000000000000000000
00000000000000000000----------------00000000000000000000000000000000000000000000000000000000
00000000000000000000----------------00000000000000000000000000000000000000000000000000000000
00000000000000000000--XX------------00000000000000000000000000000000000000000000000000000000
00000000000000000000---XXXXX--------00000000000000000000000000000000000000000000000000000000
00000000000000000000---X------------00000000000000000000000000000000000000000000000000000000
00000000000000000000XXXX----------XX00000000000000000000000000000000000000000000000000000000
00000000000000000000XXXXXXXX------XX00000000000000000000000000000000000000000000000000000000
00000000000000000000XX----XXXXX---XX00000000000000000000000000000000000000000000000000000000
00000000000000000000XD------------XX00000000000000000000000000000000000000000000000000000000
00000000000000000000XD------------XX00000000000000000000000000000000000000000000000000000000
00000000000000000000XXXXX---XXXXXXXX00000000000000000000000000000000000000000000000000000000
00000000000000000000XXXXXXXXXXXXXXXX00000000000000000000000000000000000000000000000000000000
00000000000000000000-----------XX---00000000000000000000000000000000000000000000000000000000
00000000000000000000------------XX--00000000000000000000000000000000000000000000000000000000
00000000000000000000---------XXXXX--00000000000000000000000000000000000000000000000000000000
00000000000000000000----------XX----00000000000000000000000000000000000000000000000000000000
------------------------------XX----00000000000000000000000000000000000000000000000000000000
------------------------------XXXX--00000000000000000000000000000000000000000000000000000000
-------------------------------XXXX-00000000000000000000000000000000000000000000000000000000
--------------------------------XX--00000000000000000000000000000000000000000000000000000000
S-----------------------------XXXX--00000000000000000000000000000000000000000000000000000000
S-----------------------------------00000000000000000000000000000000000000000000000000000000
S-------------------------XXXX------00000000000000000000000000000000000000000000000000000000
S------------------------E----------00000000000000000000000000000000000000000000000000000000
S-----------------------TT----------00000000000000000000000000000000000000000000000000000000
S-----------------------------------00000000000000000000000000000000000000000000000000000000
S-----------------------------------00000000000000000000000000000000000000000000000000000000
S-----E-------------XX------TTTT--XX00000000000000000000000000000000000000000000000000000000
S-------------------XD------------XX00000000000000000000000000000000000000000000000000000000
S-------------------XD------------XX00000000000000000000000000000000000000000000000000000000
S-------------E-----XXXXX---XXXXXXXX00000000000000000000000000000000000000000000000000000000
XXXXXXXXXXXXXXXXXXXXXXXXXXXXXXXXXXXX00000000000000000000000000000000000000000000000000000000
00000000000000000000000000000000000000000000000000000000000000000000000000000000000000000000