00000000000000000000000000000000000000000000000000000000000000000000000000000000000000000000000000000000000000000000000000000000--------------------000000000000000
00000000000000000000000000000000000000000000000000000000000000000000000000000000000000000000000000000000000000000000000000000000--------------------000000000000000
00000000000000000000000000000000000000000000000000000000000000000000000000000000000000000000000000000000000000000000000000000000--------------------000000000000000
00000000000000000000000000000000000000000000000000000000000000000000000000000000000000000000000000000000000000000000000000000000--------------------000000000000000
00000000000000000000000000000000000000000000000000000000000000000000000000000000000000000000000000000000000000000000000000000000--------------------000000000000000
00000000000000000000000000000000000000000000000000000000000000000000000000000000000000000000000000000000000000000000000000000000--------------------000000000000000
00000000000000000000000000000000000000000000000000000000000000000000000000000000000000000000000000000000000000000000000000000000--------------------000000000000000
00000000000000000000000000000000000000000000000000000000000000000000000000000000000000000000000000000000000000000000000000000000--------------------000000000000000
00000000000000000000000000000000000000000000000000000000000000000000000000000000000000000000000000000000000000000000000000000000--------------------000000000000000
00000000000000000000000000000000000000000000000000000000000000000000000000000000000000000000000000000000000000000000000000000000--------------------000000000000000
00000000000000000000000000000000000000000000000000000000000000000000000000000000000000000000000000000000000000000000000000000000----------S---------000000000000000
00000000000000000000000000000000000000000000000000000000000000000000000000000000000000000000000000000000000000000000000000000000------ESS?S---------000000000000000
00000000000000000000000000000000000000000000000000000000000000000000000000000000000000000000000000000000000000000000000000000000--------------------000000000000000
00000000000000000000000000000000000000000000000000000000000000000000000000000000000000000000000000000000000000000000000000000000--------------------000000000000000
00000000000000000000000000000000000000000000000000000000000000000000000000000000000000000000000000000000000000000000000000000000-------------------E000000000000000
0000000000000000000000000000000000000000000000000000000000000000000000000000000000000000000000000000000000000000----------------XXXXXXXXXXXXXXXXXXXX000000000000000
0000000000000000000000000000000000000000000000000000000000000000000000000000000000000000000000000000000000000000---TTTT---------00000000000000000000000000000000000
0000000000000000000000000000000000000000000000000000000000000000000000000000000000000000000000000000000000000000----------------00000000000000000000000000000000000
0000000000000000000000000000000000000000000000000000000000000000000000000000000000000000000000000000000000000000----------------00000000000000000000000000000000000
0000000000000000000000000000000000000000000000000000000000000000000000000000000000000000000000000000000000000000TTTTTTTT----TTTT00000000000000000000000000000000000
0000000000000000000000000000000000000000000000000000000000000000000000000000000000000000000000000000000000000000----------------00000000000000000000000000000000000
0000000000000000000000000000000000000000000000000000000000000000000000000000000000000000000000000000000000000000----------------00000000000000000000000000000000000
0000000000000000000000000000000000000000000000000000000000000000000000000000000000000000000000000000000000000000XTTTTTTTT----XXX00000000000000000000000000000000000
0000000000000000000000000000000000000000000000000000000000000000000000000000000000000000000000000000000000000000X------------XXX00000000000000000000000000000000000
0000000000000000000000000000000000000000000000000000000000000000000000000000000000000000000000000000000000000000X----------XXXXX00000000000000000000000000000000000
0000000000000000000000000000000000000000000000000000000000000000000000000000000000000000000000000000000000000000X------XXXXXXXXX00000000000000000000000000000000000
0000000000000000000000000000000000000000000000000000000000000000000000000000000000000000000000000000000000000000X-----XX-------X00000000000000000000000000000000000
0000000000000000000000000000000000000000000000000000000000000000000000000000000000000000000000000000000000000000X-----DX-------X00000000000000000000000000000000000
0000000000000000000000000000000000000000000000000000000000000000000000000000000000000000000000000000000000000000X---XXXXXXXX---X00000000000000000000000000000000000
0000000000000000000000000000000000000000000000000000000000000000000000000000000000000000000000000000000000000000X-------XXXXXXXX00000000000000000000000000000000000
0000000000000000000000000000000000000000000000000000000000000000000000000000000000000000000000000000000000000000X-----------XXXX00000000000000000000000000000000000
0000000000000000000000000000000000000000000000000000000000000000000000000000000000000000000000000000000000000000X-------------XX00000000000000000000000000000000000
0000000000000000000000000000000000000000000000000000000000000000000000000000000000000000000000000000000000000000XD------------XX00000000000000000000000000000000000
0000000000000000000000000000000000000000000000000000000000000000000000000000000000000000000000000000000000000000XXXXX-------XXXX00000000000000000000000000000000000
0000000000000000000000000000000000000000000000000000000000000000000000000000000000000000000000000000000000000000XXXXXXXXXXXXXXXX00000000000000000000000000000000000
0000000000000000000000000000000000000000000000000000000000000000000000000000000000000000000000000000000000000000XX-----------XXX00000000000000000000000000000000000
0000000000000000000000000000000000000000000000000000000000000000000000000000000000000000000000000000000000000000XX-----------XXX00000000000000000000000000000000000
0000000000000000000000000000000000000000000000000000000000000000000000000000000000000000000000000000000000000000XX-----------XXX00000000000000000000000000000000000
0000000000000000000000000000000000000000000000000000000000000000000000000000000000000000000000000000000000000000XX-----------XXX00000000000000000000000000000000000
0000000000000000000000000000000000000000000000000000------------------------------------------------------------XX-----------XXX00000000000000000000000000000000000
0000000000000000000000000000000000000000000000000000------------------------------------------------------------XX-----------XXX00000000000000000000000000000000000
0000000000000000000000000000000000000000000000000000------------------------------------------------------------XX-----------XXX00000000000000000000000000000000000
0000000000000000000000000000000000000000000000000000------------------------------------------------------------XX-----------XXX00000000000000000000000000000000000
0000000000000000000000000000000000000000000000000000------------------------------------------------------------XX-----------XXX00000000000000000000000000000000000
0000000000000000000000000000000000000000000000000000------------------------------------------------------------XX-----------XXX00000000000000000000000000000000000
0000000000000000000000000000000000000000000000000000------------------------------------------------------------XX-----------XXX00000000000000000000000000000000000
0000000000000000000000000000000000000000000000000000------------------------------------------------------------XX-----------XXX00000000000000000000000000000000000
0000000000000000000000000000000000000000000000000000------------------------------------------------------------XX-----------XXX00000000000000000000000000000000000
0000000000000000000000000000000000000000000000000000------------------------------------------------------------XX-----------XXX00000000000000000000000000000000000
0000000000000000000000000000000000000000000000000000------------------------------------------------------------XX-----------XXX00000000000000000000000000000000000
0000000000000000000000000000000000000000000000000000----------------S-------------------------------------------XX-----------XXX00000000000000000000000000000000000
0000000000000000000000000000000000000000000000000000------------------------------------------------------------XD-----------XXX00000000000000000000000000000000000
0000000000000000000000000000000000000000000000000000------------------------------------------------------------XD-----------XXX00000000000000000000000000000000000
0000000000000000000000000000000000000000000000000000------------E--E-E------E--------------X-----E--------------XXXXX-------XXXX00000000000000000000000000000000000
000000000000000000000000000000000000XXXX------XXXX--XXXXXXXXXXXXXXXXXXXXXXXXXXXXXXXXXXXXXXXXXXXXXXXXXXXXXXXXXXXXXXXXXXXXXXXXXXXX00000000000000000000000000000000000
000000000000000000000000000000000000XXXX------XXXX--000000000000000000000000000000000000000000000000000000000000000000000000000000000000000000000000000000000000000
000000000000000000000000000000000000XXXX------XXXX--000000000000000000000000000000000000000000000000000000000000000000000000000000000000000000000000000000000000000
000000000000000000000000000000000000XXXX------XXXX--000000000000000000000000000000000000000000000000000000000000000000000000000000000000000000000000000000000000000
000000000000000000000000000000000000XXXX------XXXX--000000000000000000000000000000000000000000000000000000000000000000000000000000000000000000000000000000000000000
000000000000000000000000000000000000XXXX------XXXX--000000000000000000000000000000000000000000000000000000000000000000000000000000000000000000000000000000000000000
000000000000000000000000000000000000XXXX------XXXX--000000000000000000000000000000000000000000000000000000000000000000000000000000000000000000000000000000000000000
000000000000000000000000000000000000XXXXE-EXXXXXXX--000000000000000000000000000000000000000000000000000000000000000000000000000000000000000000000000000000000000000
000000000000000000000000000000000000XXXX------XXXX--000000000000000000000000000000000000000000000000000000000000000000000000000000000000000000000000000000000000000
000000000000000000000000000000000000XX-----------XXX000000000000000000000000000000000000000000000000000000000000000000000000000000000000000000000000000000000000000
000000000000000000000000000000000000XX--TT-------XXX000000000000000000000000000000000000000000000000000000000000000000000000000000000000000000000000000000000000000
000000000000000000000000000000000000XX-----------XXX000000000000000000000000000000000000000000000000000000000000000000000000000000000000000000000000000000000000000
000000000000000000000000000000000000XX-----------XXX000000000000000000000000000000000000000000000000000000000000000000000000000000000000000000000000000000000000000
000000000000000000000000000000000000XX-----------XXX000000000000000000000000000000000000000000000000000000000000000000000000000000000000000000000000000000000000000
000000000000000000000000000000000000XX-----------XXX000000000000000000000000000000000000000000000000000000000000000000000000000000000000000000000000000000000000000
000000000000000000000000000000000000XX-----------XXX000000000000000000000000000000000000000000000000000000000000000000000000000000000000000000000000000000000000000
000000000000000000000000000000000000XX-----------XXX000000000000000000000000000000000000000000000000000000000000000000000000000000000000000000000000000000000000000
000000000000000000000000000000000000XD-----------XXX000000000000000000000000000000000000000000000000000000000000000000000000000000000000000000000000000000000000000
000000000000000000000000000000000000XXXXX-------XXXX000000000000000000000000000000000000000000000000000000000000000000000000000000000000000000000000000000000000000
000000000000000000000000000000000000XXXXXXXXXXXXXXXX000000000000000000000000000000000000000000000000000000000000000000000000000000000000000000000000000000000000000
000000000000000000000000000000000000-XXXX------XXXX-000000000000000000000000000000000000000000000000000000000000000000000000000000000000000000000000000000000000000
000000000000000000000000000000000000-XXXXXXXE--XXXX-000000000000000000000000000000000000000000000000000000000000000000000000000000000000000000000000000000000000000
000000000000000000000000000000000000XX----------XXXX000000000000000000000000000000000000000000000000000000000000000000000000000000000000000000000000000000000000000
000000000000000000000000000000000000XX--------------000000000000000000000000000000000000000000000000000000000000000000000000000000000000000000000000000000000000000
000000000000000000000000000000000000XX--------------000000000000000000000000000000000000000000000000000000000000000000000000000000000000000000000000000000000000000
000000000000000000000000000000000000----------------000000000000000000000000000000000000000000000000000000000000000000000000000000000000000000000000000000000000000
000000000000000000000000000000000000---TTTT---------000000000000000000000000000000000000000000000000000000000000000000000000000000000000000000000000000000000000000
000000000000000000000000000000000000----------TTT---000000000000000000000000000000000000000000000000000000000000000000000000000000000000000000000000000000000000000
0000000000000000------------------------------------000000000000000000000000000000000000000000000000000000000000000000000000000000000000000000000000000000000000000
0000000000000000--------------------X-----TTTT----XX000000000000000000000000000000000000000000000000000000000000000000000000000000000000000000000000000000000000000
0000000000000000--------------------X------------XXX000000000000000000000000000000000000000000000000000000000000000000000000000000000000000000000000000000000000000
0000000000000000--------------------X-------------XX000000000000000000000000000000000000000000000000000000000000000000000000000000000000000000000000000000000000000
0000000000000000--------------------X-------------XX000000000000000000000000000000000000000000000000000000000000000000000000000000000000000000000000000000000000000
0000000000000000--------------------XXXX----------XX000000000000000000000000000000000000000000000000000000000000000000000000000000000000000000000000000000000000000
0000000000000000--------------------XXXXXXXX------XX000000000000000000000000000000000000000000000000000000000000000000000000000000000000000000000000000000000000000
0000000000000000--------------------XX----XXXXX---XX000000000000000000000000000000000000000000000000000000000000000000000000000000000000000000000000000000000000000
0000000000000000--------------------XD------------XX000000000000000000000000000000000000000000000000000000000000000000000000000000000000000000000000000000000000000
0000000000000000--------------------XD------------XX000000000000000000000000000000000000000000000000000000000000000000000000000000000000000000000000000000000000000
0000000000000000-----E--------------XXXXX-------XXXX000000000000000000000000000000000000000000000000000000000000000000000000000000000000000000000000000000000000000
0000000000000000----<>--E---------SSXXXXXXXXXXXXXXXX000000000000000000000000000000000000000000000000000000000000000000000000000000000000000000000000000000000000000
0000000000000000----[]-<>-----------0000000000000000000000000000000000000000000000000000000000000000000000000000000000000000000000000000000000000000000000000000000
0000000000000000----[]-[]-----------0000000000000000000000000000000000000000000000000000000000000000000000000000000000000000000000000000000000000000000000000000000
0000000000000000----[]-[]-----------0000000000000000000000000000000000000000000000000000000000000000000000000000000000000000000000000000000000000000000000000000000
---------XXXXX--XXXXXXXXXXXXXXXXXXXX0000000000000000000000000000000000000000000000000000000000000000000000000000000000000000000000000000000000000000000000000000000
---------XX-----000000000000000000000000000000000000000000000000000000000000000000000000000000000000000000000000000000000000000000000000000000000000000000000000000
------XXXXX-----000000000000000000000000000000000000000000000000000000000000000000000000000000000000000000000000000000000000000000000000000000000000000000000000000
------XX--------000000000000000000000000000000000000000000000000000000000000000000000000000000000000000000000000000000000000000000000000000000000000000000000000000
---XXXXX--------000000000000000000000000000000000000000000000000000000000000000000000000000000000000000000000000000000000000000000000000000000000000000000000000000
---XX-----------000000000000000000000000000000000000000000000000000000000000000000000000000000000000000000000000000000000000000000000000000000000000000000000000000
XXXX----------XX000000000000000000000000000000000000000000000000000000000000000000000000000000000000000000000000000000000000000000000000000000000000000000000000000
XXXX----------DX000000000000000000000000000000000000000000000000000000000000000000000000000000000000000000000000000000000000000000000000000000000000000000000000000
XXXX----------DX000000000000000000000000000000000000000000000000000000000000000000000000000000000000000000000000000000000000000000000000000000000000000000000000000
XXXX----XXXXXXXX000000000000000000000000000000000000000000000000000000000000000000000000000000000000000000000000000000000000000000000000000000000000000000000000000
---X-X----------000000000000000000000000000000000000000000000000000000000000000000000000000000000000000000000000000000000000000000000000000000000000000000000000000
---X------------000000000000000000000000000000000000000000000000000000000000000000000000000000000000000000000000000000000000000000000000000000000000000000000000000
XXX-----------XX000000000000000000000000000000000000000000000000000000000000000000000000000000000000000000000000000000000000000000000000000000000000000000000000000
XXXXXXXXXX----XX000000000000000000000000000000000000000000000000000000000000000000000000000000000000000000000000000000000000000000000000000000000000000000000000000
XX------------XX000000000000000000000000000000000000000000000000000000000000000000000000000000000000000000000000000000000000000000000000000000000000000000000000000
XX------------XX000000000000000000000000000000000000000000000000000000000000000000000000000000000000000000000000000000000000000000000000000000000000000000000000000
XX----XXXXXXXXXX000000000000000000000000000000000000000000000000000000000000000000000000000000000000000000000000000000000000000000000000000000000000000000000000000
XD------------XX000000000000000000000000000000000000000000000000000000000000000000000000000000000000000000000000000000000000000000000000000000000000000000000000000
XXXXX-------XXXX000000000000000000000000000000000000000000000000000000000000000000000000000000000000000000000000000000000000000000000000000000000000000000000000000
XXXXXXXXXXXXXXXX000000000000000000000000000000000000000000000000000000000000000000000000000000000000000000000000000000000000000000000000000000000000000000000000000