000000000000000000000000000000000000000000000000000000000000000000000000000000000000000000000000000000000000----------------------------------------000000000000000
000000000000000000000000000000000000000000000000000000000000000000000000000000000000000000000000000000000000----------------------------------------000000000000000
000000000000000000000000000000000000000000000000000000000000000000000000000000000000000000000000000000000000----------------------------------------000000000000000
000000000000000000000000000000000000000000000000000000000000000000000000000000000000000000000000000000000000----------------------------------------000000000000000
000000000000000000000000000000000000000000000000000000000000000000000000000000000000000000000000000000000000----------------------------------------000000000000000
000000000000000000000000000000000000000000000000000000000000000000000000000000000000000000000000000000000000----------------------------------------000000000000000
000000000000000000000000000000000000000000000000000000000000000000000000000000000000000000000000000000000000----------------------------------------000000000000000
000000000000000000000000000000000000000000000000000000000000000000000000000000000000000000000000000000000000----------------------------------------000000000000000
000000000000000000000000000000000000000000000000000000000000000000000000000000000000000000000000000000000000----------------------------------------000000000000000
000000000000000000000000000000000000000000000000000000000000000000000000000000000000000000000000000000000000----------------------------------------000000000000000
000000000000000000000000000000000000000000000000000000000000000000000000000000000000000000000000000000000000---------------------------------------E000000000000000
000000000000000000000000000000000000000000000000000000000000000000000000000000000000000000000000000000000000---XX---------------------------------<>000000000000000
000000000000000000000000000000000000000000000000000000000000000000000000000000000000000000000000000000000000--------------------------------------[]000000000000000
000000000000000000000000000000000000000000000000000000000000000000000000000000000000000000000000000000000000--------------------------------------[]000000000000000
00000000000000000000000000000000000000000000000000000000000000000000000000000000000000000000--------------------------E--------------E------------[]000000000000000
00000000000000000000000000000000000000000000000000000000000000000000000000000000000000000000----------------XXXXXXXXXXXXXXXXXXXXXXXXXXXXXXXXXXXXXXXX000000000000000
00000000000000000000000000000000000000000000000000000000000000000000000000000000000000000000XX------TTTTTTXX0000000000000000000000000000000000000000000000000000000
00000000000000000000000000000000000000000000000000000000000000000000000000000000000000000000XX------------XX0000000000000000000000000000000000000000000000000000000
00000000000000000000000000000000000000000000000000000000000000000000000000000000000000000000XX------------XX0000000000000000000000000000000000000000000000000000000
00000000000000000000000000000000000000000000000000000000000000000000000000000000000000000000XXXX--------XXXX0000000000000000000000000000000000000000000000000000000
00000000000000000000000000000000000000000000000000000000000000000000000000000000000000000000XXXXXX------XXXX0000000000000000000000000000000000000000000000000000000
00000000000000000000000000000000000000000000000000000000000000000000000000000000000000000000XXXX--------XXXX0000000000000000000000000000000000000000000000000000000
00000000000000000000000000000000000000000000000000000000000000000000000000000000000000000000XXXX--------XXXX0000000000000000000000000000000000000000000000000000000
00000000000000000000000000000000000000000000000000000000000000000000000000000000000000000000XX----TTTTTTTTXX0000000000000000000000000000000000000000000000000000000
00000000000000000000000000000000000000000000000000000000000000000000000000000000000000000000XX------------XX0000000000000000000000000000000000000000000000000000000
00000000000000000000000000000000000000000000000000000000000000000000000000000000000000000000XX------------XX0000000000000000000000000000000000000000000000000000000
00000000000000000000000000000000000000000000000000000000000000000000000000000000000000000000XX-----XXXX---XX0000000000000000000000000000000000000000000000000000000
00000000000000000000000000000000000000000000000000000000000000000000000000000000000000000000XX------------XX0000000000000000000000000000000000000000000000000000000
00000000000000000000000000000000000000000000000000000000000000000000000000000000000000000000XX------------XX0000000000000000000000000000000000000000000000000000000
00000000000000000000000000000000000000000000000000000000000000000000000000000000000000000000XX-----------XXX0000000000000000000000000000000000000000000000000000000
00000000000000000000000000000000000000000000000000000000000000000000000000000000000000000000XD-----------XXX0000000000000000000000000000000000000000000000000000000
00000000000000000000000000000000000000000000000000000000000000000000000000000000000000000000XD-----------XXX0000000000000000000000000000000000000000000000000000000
00000000000000000000000000000000000000000000000000000000000000000000000000000000000000000000XXXXX-------XXXX0000000000000000000000000000000000000000000000000000000
00000000000000000000000000000000000000000000000000000000000000000000000000000000000000000000XXXXXXXXXXXXXXXX0000000000000000000000000000000000000000000000000000000
00000000000000000000000000000000000000000000000000000000000000000000000000000000000000000000XXXX------XXXX--0000000000000000000000000000000000000000000000000000000
00000000000000000000000000000000000000000000000000000000000000000000000000000000000000000000XXXX------XXXX--0000000000000000000000000000000000000000000000000000000
00000000000000000000000000000000000000000000000000000000000000000000000000000000000000000000XXXX------XXXX--0000000000000000000000000000000000000000000000000000000
00000000000000000000000000000000000000000000000000000000000000000000000000000000000000000000XXXX------XXXX--0000000000000000000000000000000000000000000000000000000
00000000000000000000000000000000000000000000000000000000000000000000000000000000000000000000XXXX------XXXX--0000000000000000000000000000000000000000000000000000000
00000000000000000000000000000000000000000000000000000000000000000000000000000000000000000000XXXX------XXXX--0000000000000000000000000000000000000000000000000000000
00000000000000000000000000000000000000000000000000000000000000000000000000000000000000000000XXXX------XXXX--0000000000000000000000000000000000000000000000000000000
00000000000000000000000000000000000000000000000000000000000000000000000000000000000000000000XXXX------XXXX--0000000000000000000000000000000000000000000000000000000
00000000000000000000000000000000000000000000000000000000000000000000000000000000000000000000XXXX------XXXX--0000000000000000000000000000000000000000000000000000000
00000000000000000000000000000000000000000000000000000000000000000000000000000000000000000000XXXX------XXXX--0000000000000000000000000000000000000000000000000000000
00000000000000000000000000000000000000000000000000000000000000000000000000000000000000000000XXXXE-EXXXXX----0000000000000000000000000000000000000000000000000000000
00000000000000000000000000000000000000000000000000000000000000000000000000000000000000000000XXXX-----XXXX---0000000000000000000000000000000000000000000000000000000
00000000000000000000000000000000000000000000000000000000000000000000000000000000000000000000XX----------XXXX0000000000000000000000000000000000000000000000000000000
00000000000000000000000000000000000000000000000000000000000000000000000000000000000000000000XX----------XXXX0000000000000000000000000000000000000000000000000000000
00000000000000000000000000000000000000000000000000000000000000000000000000000000000000000000XX----XXXXXXXXXX0000000000000000000000000000000000000000000000000000000
00000000000000000000000000000000000000000000000000000000000000000000000000000000000000000000XX-----------XXX0000000000000000000000000000000000000000000000000000000
00000000000000000000000000000000000000000000000000000000000000000000000000000000000000000000XD-----------XXX0000000000000000000000000000000000000000000000000000000
00000000000000000000000000000000000000000000000000000000000000000000000000000000000000000000XD-----------XXX0000000000000000000000000000000000000000000000000000000
00000000000000000000000000000000000000000000000000000000000000000000000000000000000000000000XXXXX-------XXXX0000000000000000000000000000000000000000000000000000000
00000000000000000000000000000000000000000000000000000000000000000000000000000000000000000000XXXXXXXXXXXXXXXX0000000000000000000000000000000000000000000000000000000
00000000000000000000000000000000000000000000000000000000000000000000000000000000000000000000XXXX--------XXXX0000000000000000000000000000000000000000000000000000000
00000000000000000000000000000000000000000000000000000000000000000000000000000000000000000000XXXX--------XXXX0000000000000000000000000000000000000000000000000000000
00000000000000000000000000000000000000000000000000000000000000000000000000000000000000000000XXXX--------XXXX0000000000000000000000000000000000000000000000000000000
00000000000000000000000000000000000000000000000000000000000000000000000000000000000000000000XXXX--------XXXX0000000000000000000000000000000000000000000000000000000
000000000000000000000000000000000000000000000000000000000000000000000000--------------------XTTTTTTTT---XXXX0000000000000000000000000000000000000000000000000000000
000000000000000000000000000000000000000000000000000000000000000000000000--------------------XXXX--------XXXX0000000000000000000000000000000000000000000000000000000
000000000000000000000000000000000000000000000000000000000000000000000000--------------------XXXX--------XXXX0000000000000000000000000000000000000000000000000000000
000000000000000000000000000000000000000000000000000000000000000000000000--------------------XXXX-----TTTTXXX0000000000000000000000000000000000000000000000000000000
000000000000000000000000000000000000000000000000000000000000000000000000--------------------XXXX--------XXXX0000000000000000000000000000000000000000000000000000000
000000000000000000000000000000000000000000000000000000000000000000000000--------------------XXXX--------XXXX0000000000000000000000000000000000000000000000000000000
000000000000000000000000000000000000000000000000000000000000000000000000--------------------XXXXXX------XXXX0000000000000000000000000000000000000000000000000000000
000000000000000000000000000000000000000000000000000000000000000000000000--------------------XXXX--------XXXX0000000000000000000000000000000000000000000000000000000
000000000000000000000000000000000000000000000000000000000000000000000000--------------------XXXX--------XXXX0000000000000000000000000000000000000000000000000000000
000000000000000000000000000000000000000000000000000000000000000000000000--------------------XX----TTTTTTTTXX0000000000000000000000000000000000000000000000000000000
000000000000000000000000000000000000000000000000000000000000000000000000--------------------XX------------XX0000000000000000000000000000000000000000000000000000000
000000000000000000000000000000000000000000000000000000000000000000000000--------------------XX-----------XXX0000000000000000000000000000000000000000000000000000000
000000000000000000000000000000000000000000000000000000000000000000000000--------------------XD-----------XXX0000000000000000000000000000000000000000000000000000000
000000000000000000000000000000000000000000000000000000000000000000000000--------------------XD-----------XXX0000000000000000000000000000000000000000000000000000000
00000000000000000000000000000000000000000000000000000000--------TTTT---------E--------------XXXXX-------XXXX0000000000000000000000000000000000000000000000000000000
00000000000000000000000000000000000000000000000000000000----------------XXXXXXXXXXXXXXXXXXXXXXXXXXXXXXXXXXXX0000000000000000000000000000000000000000000000000000000
00000000000000000000000000000000000000000000000000000000--TTTTTTTT------0000000000000000000000000000000000000000000000000000000000000000000000000000000000000000000
00000000000000000000000000000000000000000000000000000000----------------0000000000000000000000000000000000000000000000000000000000000000000000000000000000000000000
00000000000000000000000000000000000000000000000000000000----------------0000000000000000000000000000000000000000000000000000000000000000000000000000000000000000000
0000000000000000--------------------------------------------X-----------0000000000000000000000000000000000000000000000000000000000000000000000000000000000000000000
0000000000000000--------------------------------------------------------0000000000000000000000000000000000000000000000000000000000000000000000000000000000000000000
0000000000000000--------------------------------------------------------0000000000000000000000000000000000000000000000000000000000000000000000000000000000000000000
0000000000000000----------------------------------------TTTT------------0000000000000000000000000000000000000000000000000000000000000000000000000000000000000000000
0000000000000000--------------------------------------------------------0000000000000000000000000000000000000000000000000000000000000000000000000000000000000000000
0000000000000000--------------------------------------------------------0000000000000000000000000000000000000000000000000000000000000000000000000000000000000000000
0000000000000000--------------------------------------------XXXXX-------0000000000000000000000000000000000000000000000000000000000000000000000000000000000000000000
0000000000000000--------------------------------------------------------0000000000000000000000000000000000000000000000000000000000000000000000000000000000000000000
0000000000000000----------------------------------------XXXX----------XX0000000000000000000000000000000000000000000000000000000000000000000000000000000000000000000
0000000000000000----------------------------------------XXXX----------XX0000000000000000000000000000000000000000000000000000000000000000000000000000000000000000000
0000000000000000---------E-------E----------E-----------XX--XXXX------XX0000000000000000000000000000000000000000000000000000000000000000000000000000000000000000000
0000000000000000--------<>------<>---------<>--------E--XD------------XX0000000000000000000000000000000000000000000000000000000000000000000000000000000000000000000
0000000000000000--------[]------[]---------[]-------<>--XD------------XX0000000000000000000000000000000000000000000000000000000000000000000000000000000000000000000
0000000000000000--------[]------[]---------[]-------[]--XXXXX-------XXXX0000000000000000000000000000000000000000000000000000000000000000000000000000000000000000000
0000000000000000------E-[]------[]-------E-[]-------[]EEXXXXXXXXXXXXXXXX0000000000000000000000000000000000000000000000000000000000000000000000000000000000000000000
XXXX------XXXX--XXXXXXXXXXXXXXXXXXXXXXXXXXXXXXXXXXXXXXXX00000000000000000000000000000000000000000000000000000000000000000000000000000000000000000000000000000000000
XXXX------XXXX--000000000000000000000000000000000000000000000000000000000000000000000000000000000000000000000000000000000000000000000000000000000000000000000000000
XXXX------XXXX--000000000000000000000000000000000000000000000000000000000000000000000000000000000000000000000000000000000000000000000000000000000000000000000000000
XXXX------XXXX--000000000000000000000000000000000000000000000000000000000000000000000000000000000000000000000000000000000000000000000000000000000000000000000000000
XXXX------XXXX--000000000000000000000000000000000000000000000000000000000000000000000000000000000000000000000000000000000000000000000000000000000000000000000000000
XXXX------XXXX--000000000000000000000000000000000000000000000000000000000000000000000000000000000000000000000000000000000000000000000000000000000000000000000000000
XXXXE-EXXXXXXX--000000000000000000000000000000000000000000000000000000000000000000000000000000000000000000000000000000000000000000000000000000000000000000000000000
XXXX------XXXX--000000000000000000000000000000000000000000000000000000000000000000000000000000000000000000000000000000000000000000000000000000000000000000000000000
XX-----------XXX000000000000000000000000000000000000000000000000000000000000000000000000000000000000000000000000000000000000000000000000000000000000000000000000000
XX--TT-------XXX000000000000000000000000000000000000000000000000000000000000000000000000000000000000000000000000000000000000000000000000000000000000000000000000000
XX-----------XXX000000000000000000000000000000000000000000000000000000000000000000000000000000000000000000000000000000000000000000000000000000000000000000000000000
XX-----------XXX000000000000000000000000000000000000000000000000000000000000000000000000000000000000000000000000000000000000000000000000000000000000000000000000000
XX-----------XXX000000000000000000000000000000000000000000000000000000000000000000000000000000000000000000000000000000000000000000000000000000000000000000000000000
XX-----------XXX000000000000000000000000000000000000000000000000000000000000000000000000000000000000000000000000000000000000000000000000000000000000000000000000000
XX-----------XXX000000000000000000000000000000000000000000000000000000000000000000000000000000000000000000000000000000000000000000000000000000000000000000000000000
XX-----------XXX000000000000000000000000000000000000000000000000000000000000000000000000000000000000000000000000000000000000000000000000000000000000000000000000000
XD-----------XXX000000000000000000000000000000000000000000000000000000000000000000000000000000000000000000000000000000000000000000000000000000000000000000000000000
XD-----------XXX000000000000000000000000000000000000000000000000000000000000000000000000000000000000000000000000000000000000000000000000000000000000000000000000000
XXXXX-------XXXX000000000000000000000000000000000000000000000000000000000000000000000000000000000000000000000000000000000000000000000000000000000000000000000000000
XXXXXXXXXXXXXXXX000000000000000000000000000000000000000000000000000000000000000000000000000000000000000000000000000000000000000000000000000000000000000000000000000