00000000000000000000000000000000000000000000000000000000000000000000000000000000000000000000000000000000000000000000------------------------------------------------------------000000000000000
00000000000000000000000000000000000000000000000000000000000000000000000000000000000000000000000000000000000000000000------------------------------------------------------------000000000000000
00000000000000000000000000000000000000000000000000000000000000000000000000000000000000000000000000000000000000000000------------------------------------------------------------000000000000000
00000000000000000000000000000000000000000000000000000000000000000000000000000000000000000000000000000000000000000000------------------------------------------------------------000000000000000
0000000000000000000000000000000000000000000000000000000000000000000000000000000000000000000000000000---------X------S-------------------S-------------------S-------------------000000000000000
0000000000000000000000000000000000000000000000000000000000000000000000000000000000000000000000000000---------X------S-------------------S-------------------S-------------------000000000000000
0000000000000000000000000000000000000000000000000000000000000000000000000000000000000000000000000000---------X------S-------------------S-------------------S-------------------000000000000000
0000000000000000000000000000000000000000000000000000000000000000000000000000000000000000000000000000-----E---X---E--S-------------------S-------------------S-------------------000000000000000
0000000000000000000000000000000000000000000000000000000000000000000000000000000000000000000000000000MMMMMMMMMMMMMMMMS-------------------S-------------------S-------------------000000000000000
0000000000000000000000000000000000000000000000000000000000000000000000000000000000000000000000000000----------------S-------------------S-------------------S-------------------000000000000000
0000000000000000000000000000000000000000000000000000000000000000000000000000000000000000000000000000----------------S----------------X--S-E-----------------S-------------------000000000000000
0000000000000000000000000000000000000000000000000000000000000000000000000000000000000000000000000000MMMMMMMMMMMMMMMMS-----------------X-S-------------------S-------------------000000000000000
0000000000000000000000000000000000000000000000000000000000000000000000000000000000000000000000000000----------------S-------------------S-------------------S-------------------000000000000000
0000000000000000000000000000000000000000000000000000000000000000000000000000000000000000000000000000----------------S-------------------S-------------------S-------------------000000000000000
0000000000000000000000000000000000000000000000000000000000000000000000000000000000000000000000000000---X------------S--E----------------S-----------E-------S-------------------000000000000000
0000000000000000000000000000000000000000000000000000000000000000000000000000000000000000000000000000---XXXXX--------XXXXXXXXXXXXXXXXXXXXXXXXXXXXXXXXXXXXXXXXXXXXXXXXXXXXXXXXXXXX000000000000000
0000000000000000000000000000000000000000000000000000000000000000000000000000000000000000000000000000---X------------000000000000000000000000000000000000000000000000000000000000000000000000000
0000000000000000000000000000000000000000000000000000000000000000000000000000000000000000000000000000XXXX----------XX000000000000000000000000000000000000000000000000000000000000000000000000000
0000000000000000000000000000000000000000000000000000000000000000000000000000000000000000000000000000XXXXXXXX------XX000000000000000000000000000000000000000000000000000000000000000000000000000
0000000000000000000000000000000000000000000000000000000000000000000000000000000000000000000000000000XX----XXXXX---XX000000000000000000000000000000000000000000000000000000000000000000000000000
0000000000000000000000000000000000000000000000000000000000000000000000000000000000000000000000000000XD------------XX000000000000000000000000000000000000000000000000000000000000000000000000000
0000000000000000000000000000000000000000000000000000000000000000000000000000000000000000000000000000XD------------XX000000000000000000000000000000000000000000000000000000000000000000000000000
0000000000000000000000000000000000000000000000000000000000000000000000000000000000000000000000000000XXXXX-------XXXX000000000000000000000000000000000000000000000000000000000000000000000000000
0000000000000000000000000000000000000000000000000000000000000000000000000000000000000000000000000000XXXXXXXXXXXXXXXX000000000000000000000000000000000000000000000000000000000000000000000000000
0000000000000000000000000000000000000000000000000000000000000000000000000000000000000000000000000000XXXX------XXXX--000000000000000000000000000000000000000000000000000000000000000000000000000
0000000000000000000000000000000000000000000000000000000000000000000000000000000000000000000000000000XXXX------XXXX--000000000000000000000000000000000000000000000000000000000000000000000000000
0000000000000000000000000000000000000000000000000000000000000000000000000000000000000000000000000000XXXX------XXXX--000000000000000000000000000000000000000000000000000000000000000000000000000
0000000000000000000000000000000000000000000000000000000000000000000000000000000000000000000000000000XXXX------XXXX--000000000000000000000000000000000000000000000000000000000000000000000000000
0000000000000000000000000000000000000000000000000000000000000000000000000000000000000000000000000000XXXX------XXXX--000000000000000000000000000000000000000000000000000000000000000000000000000
0000000000000000000000000000000000000000000000000000000000000000000000000000000000000000000000000000XXXX------XXXX--000000000000000000000000000000000000000000000000000000000000000000000000000
0000000000000000000000000000000000000000000000000000000000000000000000000000000000000000000000000000XXXX------XXXX--000000000000000000000000000000000000000000000000000000000000000000000000000
0000000000000000000000000000000000000000000000000000000000000000000000000000000000000000000000000000XXXX------XXXX--000000000000000000000000000000000000000000000000000000000000000000000000000
----------------------------------------------------------------------------------------------------XXXX------XXXX--000000000000000000000000000000000000000000000000000000000000000000000000000
----------------------------------------------------------------------------------------------------XXXX------XXXX--000000000000000000000000000000000000000000000000000000000000000000000000000
----------------------------------------------------------------------------------------------------XXXXE-EXXXXXXX--000000000000000000000000000000000000000000000000000000000000000000000000000
----------------------------------------------------------------------------------------------------XXXX------XXXX--000000000000000000000000000000000000000000000000000000000000000000000000000
S-------------------S-------------------S-------------------S-------------------S-------------------XX-----------XXX000000000000000000000000000000000000000000000000000000000000000000000000000
S-------------------S-------------------S-------------------S-------------------S-------------------XX--TT-------XXX000000000000000000000000000000000000000000000000000000000000000000000000000
S-------------------S-------------------S-------------------S-------------------S-------------------XX-----------XXX000000000000000000000000000000000000000000000000000000000000000000000000000
S-------------------S-------------------S-------------------S-------------------S-------------------XX-----------XXX000000000000000000000000000000000000000000000000000000000000000000000000000
S-------------------S-------------------S-------------------S-------------------S-------------------XD-----------XXX000000000000000000000000000000000000000000000000000000000000000000000000000
S-------------------S-------------------S-------------------S-------------------S-------------------XD-----------XXX000000000000000000000000000000000000000000000000000000000000000000000000000
S-------------------S-------------------S-------------------S--------E----------S-------------------XXXXX-------XXXX000000000000000000000000000000000000000000000000000000000000000000000000000
S----S--------------S-------E-----------S-------------------S-------<>----------S----------------ESSXXXXXXXXXXXXXXXX000000000000000000000000000000000000000000000000000000000000000000000000000
S-------------E-----S------<>-----------S-------------------S-------[]----------S-------------------0000000000000000000000000000000000000000000000000000000000000000000000000000000000000000000
S---E---------------S------[]-----------S-------------------S-------[]----------S-------------------0000000000000000000000000000000000000000000000000000000000000000000000000000000000000000000
S-------------------S--E---[]-----------S------------E------S-------[]----------S--------E--------E-0000000000000000000000000000000000000000000000000000000000000000000000000000000000000000000
XXXXXXXXXXXXXXXXXXXXXXXXXXXXXXXXXXXXXXXXXXXXXXXXXXXXXXXXXXXXXXXXXXXXXXXXXXXXXXXXXXXXXXXXXXXXXXXXXXXX0000000000000000000000000000000000000000000000000000000000000000000000000000000000000000000
00000000000000000000000000000000000000000000000000000000000000000000000000000000000000000000000000000000000000000000000000000000000000000000000000000000000000000000000000000000000000000000000