0000000000000000000000000000000000000000000000000000000000000000000000000000000000000000000000000000000000000000XXXX------XXXX--
0000000000000000000000000000000000000000000000000000000000000000000000000000000000000000000000000000000000000000XXXX------XXXX--
0000000000000000000000000000000000000000000000000000000000000000000000000000000000000000000000000000000000000000XXXX------XXXX--
0000000000000000000000000000000000000000000000000000000000000000000000000000000000000000000000000000000000000000XXXX------XXXX--
0000000000000000000000000000000000000000000000000000000000000000000000000000000000000000000000000000000000000000XXXX------XXXX--
0000000000000000000000000000000000000000000000000000000000000000000000000000000000000000000000000000000000000000XXXX------XXXX--
0000000000000000000000000000000000000000000000000000000000000000000000000000000000000000000000000000000000000000XXXX------XXXX--
0000000000000000000000000000000000000000000000000000000000000000000000000000000000000000000000000000000000000000XXXX------XXXX--
0000000000000000000000000000000000000000000000000000000000000000000000000000000000000000000000000000000000000000XXXX------XXXX--
0000000000000000000000000000000000000000000000000000000000000000000000000000000000000000000000000000000000000000XXXX--XXXXXXXX--
0000000000000000000000000000000000000000000000000000000000000000000000000000000000000000000000000000000000000000XXXX--------XXXX
0000000000000000000000000000000000000000000000000000000000000000000000000000000000000000000000000000000000000000XXXX--------XXXX
0000000000000000000000000000000000000000000000000000000000000000000000000000000000000000000000000000000000000000XXXX--------XXXX
0000000000000000000000000000000000000000000000000000000000000000000000000000000000000000000000000000000000000000XXXXXXX-----XXXX
0000000000000000000000000000000000000000000000000000000000000000000000000000000000000000000000000000000000000000XXXX--------XXXX
0000000000000000000000000000000000000000000000000000000000000000000000000000000000000000000000000000000000000000XX------------XX
0000000000000000000000000000000000000000000000000000000000000000000000000000000000000000000000000000000000000000XX-----XXXX---XX
0000000000000000000000000000000000000000000000000000000000000000000000000000000000000000000000000000000000000000XD------------XX
0000000000000000000000000000000000000000000000000000000000000000000000000000000000000000000000000000000000000000XXXXX-------XXXX
0000000000000000000000000000000000000000000000000000000000000000000000000000000000000000000000000000000000000000XXXXXXXXXXXXXXXX
0000000000000000000000000000000000000000000000000000000000000000000000000000000000000000000000000000000000000000XX------------DX
0000000000000000000000000000000000000000000000000000000000000000000000000000000000000000000000000000000000000000XX-----XXXX---DX
0000000000000000000000000000000000000000000000000000000000000000000000000000000000000000000000000000000000000000XXXX--------XXXX
0000000000000000000000000000000000000000000000000000000000000000000000000000000000000000000000000000000000000000XXXX--------XXXX
0000000000000000000000000000000000000000000000000000000000000000000000000000000000000000000000000000000000000000XXXX--------XXXX
0000000000000000000000000000000000000000000000000000000000000000000000000000000000000000000000000000000000000000XXXX--------XXXX
0000000000000000000000000000000000000000000000000000000000000000000000000000000000000000000000000000000000000000XXXX--------XXXX
0000000000000000000000000000000000000000000000000000000000000000000000000000000000000000000000000000000000000000XXXX--------XXXX
0000000000000000000000000000000000000000000000000000000000000000000000000000000000000000000000000000000000000000XXXXXX------XXXX
0000000000000000000000000000000000000000000000000000000000000000000000000000000000000000000000000000000000000000XXXX--------XXXX
0000000000000000000000000000000000000000000000000000000000000000000000000000000000000000000000000000000000000000XXXX--------XXXX
0000000000000000000000000000000000000000000000000000000000000000000000000000000000000000000000000000000000000000XX----TTTTTTTTXX
0000000000000000000000000000000000000000000000000000000000000000000000000000000000000000000000000000000000000000XX------------XX
0000000000000000000000000000000000000000000000000000000000000000000000000000000000000000000000000000000000000000XX------------XX
0000000000000000000000000000000000000000000000000000000000000000000000000000000000000000000000000000000000000000XXXXXXXX------XX
0000000000000000000000000000000000000000000000000000000000000000000000000000000000000000000000000000000000000000XX----XXXXX---XX
0000000000000000000000000000000000000000000000000000000000000000000000000000000000000000000000000000000000000000XD------------XX
0000000000000000000000000000000000000000000000000000000000000000000000000000000000000000000000000000000000000000XD------------XX
0000000000000000000000000000000000000000000000000000000000000000000000000000000000000000000000000000000000000000XXXXX-------XXXX
0000000000000000000000000000000000000000000000000000000000000000000000000000000000000000000000000000000000000000XXXXXXXXXXXXXXXX
0000000000000000000000000000000000000000000000000000000000000000000000000000000000000000000000000000000000000000XXXX--------XXXX
0000000000000000000000000000000000000000000000000000000000000000000000000000000000000000000000000000000000000000XXXXXXX-----XXXX
0000000000000000000000000000000000000000000000000000000000000000000000000000000000000000000000000000000000000000XXXX--------XXXX
0000000000000000000000000000000000000000000000000000000000000000000000000000000000000000000000000000000000000000XX------------XX
0000000000000000000000000000000000000000000000000000000000000000000000000000000000000000000000000000000000000000XX-----XXXX---DX
0000000000000000000000000000000000000000000000000000000000000000000000000000000000000000000000000000000000000000XX------------DX
0000000000000000000000000000000000000000000000000000000000000000000000000000000000000000000000000000000000000000XXXX--------XXXX
0000000000000000000000000000000000000000000000000000000000000000000000000000000000000000000000000000000000000000XXXXXX------XXXX
0000000000000000000000000000000000000000000000000000000000000000000000000000000000000000000000000000000000000000XXXX--------XXXX
0000000000000000000000000000000000000000000000000000000000000000000000000000000000000000000000000000000000000000XXXX--------XXXX
0000000000000000000000000000000000000000000000000000000000000000000000000000000000000000000000000000000000000000XX----TTTTTTTTXX
0000000000000000000000000000000000000000000000000000000000000000000000000000000000000000000000000000000000000000XX------------XX
0000000000000000000000000000000000000000000000000000000000000000000000000000000000000000000000000000000000000000XX------------XX
0000000000000000000000000000000000000000000000000000000000000000000000000000000000000000000000000000000000000000XX------XXXX--XX
0000000000000000000000000000000000000000000000000000000000000000000000000000000000000000000000000000000000000000XX------------XX
0000000000000000000000000000000000000000000000000000000000000000000000000000000000000000000000000000000000000000XX-----------XXX
0000000000000000000000000000000000000000000000000000000000000000000000000000000000000000000000000000000000000000XD-----------XXX
0000000000000000000000000000000000000000000000000000000000000000000000000000000000000000000000000000000000000000XD-----------XXX
0000000000000000000000000000000000000000000000000000000000000000000000000000000000000000000000000000000000000000XXXXX-------XXXX
0000000000000000000000000000000000000000000000000000000000000000000000000000000000000000000000000000000000000000XXXXXXXXXXXXXXXX
0000000000000000000000000000000000000000000000000000000000000000000000000000000000000000000000000000000000000000----------------
0000000000000000000000000000000000000000000000000000000000000000000000000000000000000000000000000000000000000000---TTTT---------
0000000000000000000000000000000000000000000000000000000000000000000000000000000000000000000000000000000000000000---X------------
0000000000000000000000000000000000000000000000000000000000000000000000000000000000000000000000000000000000000000----------------
00000000000000000000000000000000000000000000000000000000000000000000000000000000000000000000-----------------------------TTT----
00000000000000000000000000000000000000000000000000000000000000000000000000000000000000000000------------------------------------
00000000000000000000000000000000000000000000000000000000000000000000000000000000000000000000------------------------------------
00000000000000000000000000000000000000000000000000000000000000000000000000000000000000000000--------------------X--TTTT------XXX
00000000000000000000000000000000000000000000000000000000000000000000000000000000000000000000--------------------X-----------XXXX
00000000000000000000000000000000000000000000000000000000000000000000000000000000000000000000--------------------X------------XXX
00000000000000000000000000000000000000000000000000000000000000000000000000000000000000000000--------------------X-------------XX
00000000000000000000000000000000000000000000000000000000000000000000000000000000000000000000--------------------XXXX----------XX
00000000000000000000000000000000000000000000000000000000000000000000000000000000000000000000--------------------XXXXXXXX------XX
00000000000000000000000000000000000000000000000000000000000000000000000000000000000000000000--------------------XX-----XXXX---XX
00000000000000000000000000000000000000000000000000000000000000000000000000000000000000000000-----------------X--XX------------XX
00000000000000000000000000000000000000000000000000000000000000000000000000000000000000000000----------------XXX-XX-----------XXX
00000000000000000000000000000000000000000000000000000000000000000000000000000000000000000000------E---E----XXXX-XD-----------XXX
00000000000000000000000000000000000000000000000000000000000000000000000000000000000000000000-----<>--<>---XXXXX-XD-----------XXX
00000000000000000000000000000000000000000000000000000000000000000000000000000000000000000000-----[]--[]--XXXXXX-XXXXX-------XXXX
0000000000000000000000000000000000000000000000000000000000000000000000000000XD-------------XXXXXXXXXXXXXXXXXXXXXXXXXXXXXXXXXXXXX
0000000000000000000000000000000000000000000000000000000000000000000000000000X--TTTTTT-------000000000000000000000000000000000000
0000000000000000000000000000000000000000000000000000000000000000000000000000----------------000000000000000000000000000000000000
0000000000000000000000000000000000000000000000000000000000000000000000000000----------------000000000000000000000000000000000000
00000000000000000000000000000000000000000000000000000000------------------------------------000000000000000000000000000000000000
00000000000000000000000000000000000000000000000000000000--------------------------TTTT------000000000000000000000000000000000000
00000000000000000000000000000000000000000000000000000000---------------------------X---X----000000000000000000000000000000000000
00000000000000000000000000000000000000000000000000000000---------------------------X---X----000000000000000000000000000000000000
00000000000000000000000000000000000000000000000000000000-------------------------X------XX--000000000000000000000000000000000000
00000000000000000000000000000000000000000000000000000000----------------------X-----X---X---000000000000000000000000000000000000
00000000000000000000000000000000000000000000000000000000--------------------TTX--X--X--X----000000000000000000000000000000000000
00000000000000000000000000000000000000000000000000000000------------------------------------000000000000000000000000000000000000
00000000000000000000000000000000000000000000000000000000------------------------------------000000000000000000000000000000000000
00000000000000000000000000000000000000000000000000000000------------------------XXXX--------000000000000000000000000000000000000
00000000000000000000000000000000000000000000000000000000-----E------------------------------000000000000000000000000000000000000
00000000000000000000000000000000000000000000000000000000----<>----SSSS------XXXX----------XX000000000000000000000000000000000000
00000000000000000000000000000000000000000000000000000000----[]--------------XXE-----------XX000000000000000000000000000000000000
00000000000000000000000000000000000000000000000000000000----[]--------------XD------------XX000000000000000000000000000000000000
00000000000000000000000000000000000000000000000000000000----[]--------------XXXXX-------XXXX000000000000000000000000000000000000
0000000000000000000000000000000000000000----------------XXXXXXXXXXXXXXXXXXXXXXXXXXXXXXXXXXXX000000000000000000000000000000000000
0000000000000000000000000000000000000000---XXXX---------000000000000000000000000000000000000000000000000000000000000000000000000
0000000000000000000000000000000000000000----------------000000000000000000000000000000000000000000000000000000000000000000000000
0000000000000000000000000000000000000000----------------000000000000000000000000000000000000000000000000000000000000000000000000
0000000000000000000000000000000000000000------------X---000000000000000000000000000000000000000000000000000000000000000000000000
0000000000000000000000000000000000000000----------------000000000000000000000000000000000000000000000000000000000000000000000000
0000000000000000000000000000000000000000----------------000000000000000000000000000000000000000000000000000000000000000000000000
0000000000000000000000000000000000000000------TTTT------000000000000000000000000000000000000000000000000000000000000000000000000
--------------------------------------------------------000000000000000000000000000000000000000000000000000000000000000000000000
-------------------------------------------TTTT---------000000000000000000000000000000000000000000000000000000000000000000000000
--------------------------------------------------------000000000000000000000000000000000000000000000000000000000000000000000000
----------------------------------------------XXXX------000000000000000000000000000000000000000000000000000000000000000000000000
----------------------------------------------XX--------000000000000000000000000000000000000000000000000000000000000000000000000
-------------------------------------------XXXXX--------000000000000000000000000000000000000000000000000000000000000000000000000
-------------------------------------------XX-----------000000000000000000000000000000000000000000000000000000000000000000000000
----------------------------------------XXXXXXXXXXX---XX000000000000000000000000000000000000000000000000000000000000000000000000
----------------------------------------XD------------XX000000000000000000000000000000000000000000000000000000000000000000000000
----------------------------------------XD------------XX000000000000000000000000000000000000000000000000000000000000000000000000
----------------------------------------XXXXX-------XXXX000000000000000000000000000000000000000000000000000000000000000000000000
---E-----------------------------------XXXXXXXXXXXXXXXXX000000000000000000000000000000000000000000000000000000000000000000000000
--<>-------------------------E--------XX0000000000000000000000000000000000000000000000000000000000000000000000000000000000000000
--[]------------------------<>-------XXX0000000000000000000000000000000000000000000000000000000000000000000000000000000000000000
--[]-E-EE-EE----------------[]------XXXX0000000000000000000000000000000000000000000000000000000000000000000000000000000000000000
XXXXXXXXXXXXXXXXXXXXXXXXXXXXXXXXXXXXXXXX0000000000000000000000000000000000000000000000000000000000000000000000000000000000000000
00000000000000000000000000000000000000000000000000000000000000000000000000000000000000000000000000000000000000000000000000000000