00000000000000000000000000000000000000000000000000000000000000000000000000000000000000000000000000000000000000000000XXXX--------XXXX
00000000000000000000000000000000000000000000000000000000000000000000000000000000000000000000000000000000000000000000XXXX--------XXXX
00000000000000000000000000000000000000000000000000000000000000000000000000000000000000000000000000000000000000000000XXXX--------XXXX
00000000000000000000000000000000000000000000000000000000000000000000000000000000000000000000000000000000000000000000XTTTTTTTT---XXXX
00000000000000000000000000000000000000000000000000000000000000000000000000000000000000000000000000000000000000000000XXXX--------XXXX
00000000000000000000000000000000000000000000000000000000000000000000000000000000000000000000000000000000000000000000XXXX--------XXXX
00000000000000000000000000000000000000000000000000000000000000000000000000000000000000000000000000000000000000000000XXXX-----TTTTXXX
00000000000000000000000000000000000000000000000000000000000000000000000000000000000000000000000000000000000000000000XXXX--------XXXX
00000000000000000000000000000000000000000000000000000000000000000000000000000000000000000000000000000000000000000000XXXX-T------XXXX
00000000000000000000000000000000000000000000000000000000000000000000000000000000000000000000000000000000000000000000X-----------XXXX
00000000000000000000000000000000000000000000000000000000000000000000000000000000000000000000000000000000000000000000X-----------XXXX
00000000000000000000000000000000000000000000000000000000000000000000000000000000000000000000000000000000000000000000X---TT--XXXXXXXX
00000000000000000000000000000000000000000000000000000000000000000000000000000000000000000000000000000000000000000000X-------------XX
00000000000000000000000000000000000000000000000000000000000000000000000000000000000000000000000000000000000000000000X-------------XX
00000000000000000000000000000000000000000000000000000000000000000000000000000000000000000000000000000000000000000000X------------XXX
00000000000000000000000000000000000000000000000000000000000000000000000000000000000000000000000000000000000000000000XXXXXXXXXXXXXXXX
00000000000000000000000000000000000000000000000000000000000000000000000000000000000000000000000000000000000000000000X-------------XX
00000000000000000000000000000000000000000000000000000000000000000000000000000000000000000000000000000000000000000000XD------------XX
00000000000000000000000000000000000000000000000000000000000000000000000000000000000000000000000000000000000000000000XXXXX-------XXXX
00000000000000000000000000000000000000000000000000000000000000000000000000000000000000000000000000000000000000000000XXXXXXXXXXXXXXXX
00000000000000000000000000000000000000000000000000000000000000000000000000000000000000000000000000000000000000000000X--X-----------X
00000000000000000000000000000000000000000000000000000000000000000000000000000000000000000000000000000000000000000000X-TX-----XXXX--X
00000000000000000000000000000000000000000000000000000000000000000000000000000000000000000000000000000000000000000000X--X-----------X
00000000000000000000000000000000000000000000000000000000000000000000000000000000000000000000000000000000000000000000X----XX-------XX
00000000000000000000000000000000000000000000000000000000000000000000000000000000000000000000000000000000000000000000X--X-XXXXXXXX-XX
00000000000000000000000000000000000000000000000000000000000000000000000000000000000000000000000000000000000000000000X--X----------XX
00000000000000000000000000000000000000000000000000000000000000000000000000000000000000000000000000000000000000000000X-TX----------XX
00000000000000000000000000000000000000000000000000000000000000000000000000000000000000000000000000000000000000000000X--X-----XXXX-XX
00000000000000000000000000000000000000000000000000000000000000000000000000000000000000000000000000000000000000000000X--X----------XX
00000000000000000000000000000000000000000000000000000000000000000000000000000000000000000000000000000000000000000000X--X----------XX
00000000000000000000000000000000000000000000000000000000000000000000000000000000000000000000000000000000000000000000XXXXXXXX------XX
00000000000000000000000000000000000000000000000000000000000000000000000000000000000000000000000000000000000000000000XXXXXXXXXX----XX
00000000000000000000000000000000000000000000000000000000000000000000000000000000000000000000000000000000000000000000XX------------XX
00000000000000000000000000000000000000000000000000000000000000000000000000000000000000000000000000000000000000000000XX------------XX
00000000000000000000000000000000000000000000000000000000000000000000000000000000000000000000000000000000000000000000XXXXXXXX------XX
00000000000000000000000000000000000000000000000000000000000000000000000000000000000000000000000000000000000000000000XX----XXXXX---XX
00000000000000000000000000000000000000000000000000000000000000000000000000000000000000000000000000000000000000000000XD------------XX
00000000000000000000000000000000000000000000000000000000000000000000000000000000000000000000000000000000000000000000XD------------XX
00000000000000000000000000000000000000000000000000000000000000000000000000000000000000000000000000000000000000000000XXXXX-------XXXX
00000000000000000000000000000000000000000000000000000000000000000000000000000000000000000000000000000000000000000000XXXXXXXXXXXXXXXX
00000000000000000000000000000000000000000000000000000000000000000000000000000000000000000000000000000000000000000000---TTTT---------
00000000000000000000000000000000000000000000000000000000000000000000000000000000000000000000000000000000000000000000----------------
00000000000000000000000000000000000000000000000000000000000000000000000000000000000000000000000000000000000000000000--------TTTT----
00000000000000000000000000000000000000000000000000000000000000000000000000000000000000000000000000000000000000000000----------------
00000000000000000000000000000000000000000000000000000000000000000000000000000000000000000000000000000000000000000000--TTTT----------
00000000000000000000000000000000000000000000000000000000000000000000000000000000000000000000000000000000000000000000----------------
00000000000000000000000000000000000000000000000000000000000000000000000000000000000000000000000000000000000000000000----------------
00000000000000000000000000000000000000000000000000000000000000000000000000000000000000000000000000000000000000000000XMMMMMMMMMMMMMMM
0000000000000000000000000000000000000000000000000000000000000000000000000000--------------------------------------------------------
0000000000000000000000000000000000000000000000000000000000000000000000000000--------------------------------------------E--------E--
0000000000000000000000000000000000000000000000000000000000000000000000000000----------------------------------------MMMMMMMMMMMMMMMM
0000000000000000000000000000000000000000000000000000000000000000000000000000--------------------------------------------------------
0000000000000000000000000000000000000000000000000000000000000000000000000000-------------------------------------------XXXX---------
0000000000000000000000000000000000000000000000000000000000000000000000000000-------------------------------------------XXXXX--------
0000000000000000000000000000000000000000000000000000000000000000000000000000----------------oooo-----------------------XX-----------
0000000000000000000000000000000000000000000000000000000000000000000000000000----------------XXXX--------------------XX----XXXXX---XX
0000000000000000000000000000000000000000000000000000000000000000000000000000----------------------------------------XD------------XX
0000000000000000000000000000000000000000000000000000000000000000000000000000----------------------------------------XD------------XX
0000000000000000000000000000000000000000000000000000000000000000000000000000----------------------------------------XXXXX-------XXXX
0000000000000000000000000000000000000000000000000000000000000000000000000000--------SXXXXXXXXXXX-----------------SQQXXXXXXXXXXXXXXXX
0000000000000000000000000000000000000000000000000000000000000000000000000000----------------------------------------0000000000000000
0000000000000000000000000000000000000000000000000000000000000000000000000000----------------------------------------0000000000000000
0000000000000000000000000000000000000000000000000000000000000000000000000000--------E-------------------------------0000000000000000
000000000000000000000000000000000000000000000000000000000000XXXXXXX-----XXXXXXXXXXXXXX----------XXXXXXXXXXXXXXXXXXXX0000000000000000
000000000000000000000000000000000000000000000000000000000000XXXX------T-XXXX00000000000000000000000000000000000000000000000000000000
000000000000000000000000000000000000000000000000000000000000XX----------XXXX00000000000000000000000000000000000000000000000000000000
000000000000000000000000000000000000000000000000000000000000XX----------XXXX00000000000000000000000000000000000000000000000000000000
000000000000000000000000000000000000000000000000000000000000XX----TTXXXXXXXX00000000000000000000000000000000000000000000000000000000
000000000000000000000000000000000000000000000000000000000000XX--------------00000000000000000000000000000000000000000000000000000000
000000000000000000000000000000000000000000000000000000000000XX--------------00000000000000000000000000000000000000000000000000000000
000000000000000000000000000000000000000000000000000000000000XXTTTT----------00000000000000000000000000000000000000000000000000000000
000000000000000000000000000000000000000000000000000000000000--------XXXX----00000000000000000000000000000000000000000000000000000000
000000000000000000000000000000000000000000000000000000000000--------XXXX----00000000000000000000000000000000000000000000000000000000
000000000000000000000000000000000000000000000000000000000000--------XXXX----00000000000000000000000000000000000000000000000000000000
000000000000000000000000000000000000000000000000000000000000------XXXXXX----00000000000000000000000000000000000000000000000000000000
000000000000000000000000000000000000000000000000000000000000----------------00000000000000000000000000000000000000000000000000000000
000000000000000000000000000000000000000000000000000000000000----XXXX--------00000000000000000000000000000000000000000000000000000000
000000000000000000000000000000000000000000000000000000000000----------------00000000000000000000000000000000000000000000000000000000
000000000000000000000000000000000000000000000000000000000000XXX-----------XX00000000000000000000000000000000000000000000000000000000
000000000000000000000000000000000000000000000000000000000000XD------------XX00000000000000000000000000000000000000000000000000000000
000000000000000000000000000000000000000000000000000000000000XD------------XX00000000000000000000000000000000000000000000000000000000
000000000000000000000000000000000000000000000000000000000000XXXXX-------XXXX00000000000000000000000000000000000000000000000000000000
000000000000000000000000000000000000000000000000000000000000XXXXXXXXXXXXXXXX00000000000000000000000000000000000000000000000000000000
000000000000000000000000000000000000000000000000000000000000XXXX------XXXX--00000000000000000000000000000000000000000000000000000000
000000000000000000000000000000000000000000000000000000000000XXXX------XXXX--00000000000000000000000000000000000000000000000000000000
000000000000000000000000000000000000000000000000000000000000XXXX------XXXX--00000000000000000000000000000000000000000000000000000000
000000000000000000000000000000000000000000000000000000000000XXXX------XXXX--00000000000000000000000000000000000000000000000000000000
000000000000000000000000000000000000000000000000000000000000XXXX------XXXX--00000000000000000000000000000000000000000000000000000000
000000000000000000000000000000000000000000000000000000000000XXXX------XXXX--00000000000000000000000000000000000000000000000000000000
------------------------------------------------------------XXXX------XXXX--00000000000000000000000000000000000000000000000000000000
------------------------------------------------------------XXXX------XXXX--00000000000000000000000000000000000000000000000000000000
------------------------------------------------------------XXXX------XXXX--00000000000000000000000000000000000000000000000000000000
------------------------------------------------------------XXXX------XXXX--00000000000000000000000000000000000000000000000000000000
------------------------------------------------------------XXXX------XXXX--00000000000000000000000000000000000000000000000000000000
------------------------------------------------------------XXXX------XXXX--00000000000000000000000000000000000000000000000000000000
---------------------------------------------------------------XXXX---XXXX--00000000000000000000000000000000000000000000000000000000
---------------------------------------------------------------X--TT--XXXX--00000000000000000000000000000000000000000000000000000000
------------------------------------------------------------XXXXXXXX------XX00000000000000000000000000000000000000000000000000000000
------------------------------------------------------------XXXXXXXXXXX---XX00000000000000000000000000000000000000000000000000000000
-------------E----------X-----------------------------------XD------------XX00000000000000000000000000000000000000000000000000000000
------------<>-----S---SX-----------------------------------XD------------XX00000000000000000000000000000000000000000000000000000000
------------[]----------------------------------------------XXXXX-------XXXX00000000000000000000000000000000000000000000000000000000
------------[]---------------------------------------------XXXXXXXXXXXXXXXXX00000000000000000000000000000000000000000000000000000000
------------[]-----------------E---------------E-----XXXXXXX000000000000000000000000000000000000000000000000000000000000000000000000
XXXXXXXXXXXXXXXXXXXXXXXXXXXXXXXXXXXXXXXXXXXXXXXXXXXXXXXXXXXX000000000000000000000000000000000000000000000000000000000000000000000000
000000000000000000000000000000000000000000000000000000000000000000000000000000000000000000000000000000000000000000000000000000000000