00000000000000000000000000000000000000000000000000000000000000000000000000000000000000000000000000000000000000000000000000000000000000000000000000000000XXXX--------XXXX
00000000000000000000000000000000000000000000000000000000000000000000000000000000000000000000000000000000000000000000000000000000000000000000000000000000XXXX--------XXXX
00000000000000000000000000000000000000000000000000000000000000000000000000000000000000000000000000000000000000000000000000000000000000000000000000000000XXXX--------XXXX
00000000000000000000000000000000000000000000000000000000000000000000000000000000000000000000000000000000000000000000000000000000000000000000000000000000XXXX--------XXXX
0000000000000000000000000000000000000000000000000000----------------------------------------------------------------------------------------------------XXXX--------XXXX
0000000000000000000000000000000000000000000000000000----------------------------------------------------------------------------------------------------XXXX--------XXXX
0000000000000000000000000000000000000000000000000000----------------------------------------------------------------------------------------------------XXXX--------XXXX
0000000000000000000000000000000000000000000000000000----------------------------------------------------------------------------------------------------XXXX---------XXX
000000000000000000000000000000000000XXXX---------XXXS-------------------S-------------------S-------------------S-------------------S-------------------XX------------XX
000000000000000000000000000000000000XXXX---------XXXS-------------------S-------------------S-------------------S-------------------S-------------------XX------XXXX--XX
000000000000000000000000000000000000XXXX---XXXXXXXXXS-------------------S-------------------S-------------------S-------------------S-------------------XX------------XX
000000000000000000000000000000000000XXXX--XXXXXXXXXXS-------------------S-------------------S-------------------S-------------------S-------------------XXXX--------XXXX
000000000000000000000000000000000000XXXX--------XXXXS-------------------S-------------------S-------------------S-------------------S-------------------XXXXXXX-----XXXX
000000000000000000000000000000000000XXXX--------XXXXS-------------------S-------------------S-------------------S-------------------S-------------------XXXX--------XXXX
000000000000000000000000000000000000XXXX--------XXXXS------E----E-------S-------------------S-------------------S-------------------S-------------------XX----------XXXX
000000000000000000000000000000000000XXXX--------XXXXS-----<>---<>-------S-------------------S-------------------S--------E----------S------------oo-----XX-------TTTT-T-
000000000000000000000000000000000000XXTTTT------XXXXS-----[]---[]-------S-------------------S----E--------------S-------<>----------S-------------------XD-------------X
000000000000000000000000000000000000XXXX--------XXXXS-----[]---[]-------S-------------------S-------------------S-------[]----------S-------------------XD-------------X
000000000000000000000000000000000000XXXX--------XXXXS-----[]--E[]-------S----------E--------S-------------------S-------[]----------S-------E------E----XXXXX---XXXXXXXX
000000000000000000000000000000000000XXXX--------XXXXXXXXXXXXXXXXXXXXXXXXXXXXXXXXXXXXXXXXXXXXXXXXXXXXXXXXXXXXXXXXXXXXXXXXXXXXXXXXXXXXXXXXXXXXXXXXXXXXXXXXXXXXXXXXXXXXXXXX
000000000000000000000000000000000000XXXXXXX-----XXXX00000000000000000000000000000000000000000000000000000000000000000000000000000000000000000000000000000000000000000000
000000000000000000000000000000000000XXXX--------XXXX00000000000000000000000000000000000000000000000000000000000000000000000000000000000000000000000000000000000000000000
000000000000000000000000000000000000XX----------XXXX00000000000000000000000000000000000000000000000000000000000000000000000000000000000000000000000000000000000000000000
000000000000000000000000000000000000XX-------TTTT-T-00000000000000000000000000000000000000000000000000000000000000000000000000000000000000000000000000000000000000000000
000000000000000000000000000000000000XD-------------X00000000000000000000000000000000000000000000000000000000000000000000000000000000000000000000000000000000000000000000
000000000000000000000000000000000000XD-------------X00000000000000000000000000000000000000000000000000000000000000000000000000000000000000000000000000000000000000000000
000000000000000000000000000000000000XXXXX---XXXXXXXX00000000000000000000000000000000000000000000000000000000000000000000000000000000000000000000000000000000000000000000
000000000000000000000000000000000000XXXXXXXXXXXXXXXX00000000000000000000000000000000000000000000000000000000000000000000000000000000000000000000000000000000000000000000
000000000000000000000000000000000000XXXX------XXXX--00000000000000000000000000000000000000000000000000000000000000000000000000000000000000000000000000000000000000000000
000000000000000000000000000000000000XXXX------XXXX--00000000000000000000000000000000000000000000000000000000000000000000000000000000000000000000000000000000000000000000
000000000000000000000000000000000000XXXX------XXXX--00000000000000000000000000000000000000000000000000000000000000000000000000000000000000000000000000000000000000000000
000000000000000000000000000000000000XXXX------XXXX--00000000000000000000000000000000000000000000000000000000000000000000000000000000000000000000000000000000000000000000
0000000000000000--------------------XXXX------XXXX--00000000000000000000000000000000000000000000000000000000000000000000000000000000000000000000000000000000000000000000
0000000000000000--------------------XXXX------XXXX--00000000000000000000000000000000000000000000000000000000000000000000000000000000000000000000000000000000000000000000
0000000000000000--------------------XXXX------XXXX--00000000000000000000000000000000000000000000000000000000000000000000000000000000000000000000000000000000000000000000
0000000000000000--------------------XXXX------XXXX--00000000000000000000000000000000000000000000000000000000000000000000000000000000000000000000000000000000000000000000
----------------S-------------------XXXX------XXXX--00000000000000000000000000000000000000000000000000000000000000000000000000000000000000000000000000000000000000000000
-------TTTT-----S-------------------XXXX------XXXX--00000000000000000000000000000000000000000000000000000000000000000000000000000000000000000000000000000000000000000000
----------------S-------------------XXXX------XXXX--00000000000000000000000000000000000000000000000000000000000000000000000000000000000000000000000000000000000000000000
----------------S-------------------XXXX------XXXX--00000000000000000000000000000000000000000000000000000000000000000000000000000000000000000000000000000000000000000000
XX------TTTTTTXXS-------------------XXXXE-EXXXXXXX--00000000000000000000000000000000000000000000000000000000000000000000000000000000000000000000000000000000000000000000
XX------------XXS-------------------XXXX------XXXX--00000000000000000000000000000000000000000000000000000000000000000000000000000000000000000000000000000000000000000000
XX------------XXS-------------------XX-----------XXX00000000000000000000000000000000000000000000000000000000000000000000000000000000000000000000000000000000000000000000
XXXX--------XXXXS--------------S----XX-----------XXX00000000000000000000000000000000000000000000000000000000000000000000000000000000000000000000000000000000000000000000
XXXX--------XXXXS-------------------XD-----------XXX00000000000000000000000000000000000000000000000000000000000000000000000000000000000000000000000000000000000000000000
XXXX--------XXXXS-------------------XD---------XXXXX00000000000000000000000000000000000000000000000000000000000000000000000000000000000000000000000000000000000000000000
XXXX--------XXXXS-------------------XXXXX---XXXXXXXX00000000000000000000000000000000000000000000000000000000000000000000000000000000000000000000000000000000000000000000
XXXX--------XXXXXXXXXXXXXXXXXXXXXXXXXXXXXXXXXXXXXXXX00000000000000000000000000000000000000000000000000000000000000000000000000000000000000000000000000000000000000000000
XXXXXXX-----XXXX00000000000000000000000000000000000000000000000000000000000000000000000000000000000000000000000000000000000000000000000000000000000000000000000000000000
XXXX--------XXXX00000000000000000000000000000000000000000000000000000000000000000000000000000000000000000000000000000000000000000000000000000000000000000000000000000000
XX----------XXXX00000000000000000000000000000000000000000000000000000000000000000000000000000000000000000000000000000000000000000000000000000000000000000000000000000000
XX-------TTTT-T-00000000000000000000000000000000000000000000000000000000000000000000000000000000000000000000000000000000000000000000000000000000000000000000000000000000
XD-------------X00000000000000000000000000000000000000000000000000000000000000000000000000000000000000000000000000000000000000000000000000000000000000000000000000000000
XD-------------X00000000000000000000000000000000000000000000000000000000000000000000000000000000000000000000000000000000000000000000000000000000000000000000000000000000
XXXXX---XXXXXXXX00000000000000000000000000000000000000000000000000000000000000000000000000000000000000000000000000000000000000000000000000000000000000000000000000000000
XXXXXXXXXXXXXXXX00000000000000000000000000000000000000000000000000000000000000000000000000000000000000000000000000000000000000000000000000000000000000000000000000000000