00000000000000000000000000000000000000000000000000000000----------------
00000000000000000000000000000000000000000000000000000000--TTTTTTTT------
00000000000000000000000000000000000000000000000000000000----------------
00000000000000000000000000000000000000000000000000000000----------------
00000000000000000000000000000000000000000000000000000000TTTT------------
00000000000000000000000000000000000000000000000000000000----------------
00000000000000000000000000000000000000000000000000000000----------------
00000000000000000000000000000000000000000000000000000000------TTT-------
00000000000000000000000000000000000000000000000000000000----------T-----
00000000000000000000000000000000000000000000000000000000----------------
00000000000000000000000000000000000000000000000000000000----------------
00000000000000000000000000000000000000000000000000000000XX------TTTTTTXX
00000000000000000000000000000000000000000000000000000000XX------------XX
00000000000000000000000000000000000000000000000000000000XX------------XX
00000000000000000000000000000000000000000000000000000000XXXXXXXX------XX
00000000000000000000000000000000000000000000000000000000XX----XXXXX---XX
00000000000000000000000000000000000000000000000000000000XD------------XX
00000000000000000000000000000000000000000000000000000000XD------------XX
00000000000000000000000000000000000000000000000000000000XXXXX-------XXXX
00000000000000000000000000000000000000000000000000000000XXXXXXXXXXXXXXXX
00000000000000000000000000000000000000000000000000000000XXXX--------XXXX
00000000000000000000000000000000000000000000000000000000XXXXXXX-----XXXX
00000000000000000000000000000000000000000000000000000000XXXX--------XXXX
00000000000000000000000000000000000000000000000000000000XXXX--------XXXX
00000000000000000000000000000000000000000000000000000000XX-----TTTT--XXX
00000000000000000000000000000000000000000000000000000000XXXX--------XXXX
00000000000000000000000000000000000000000000000000000000XXXX--------XXXX
00000000000000000000000000000000000000000000000000000000XXXX--------XXXX
00000000000000000000000000000000000000000000000000000000XXXX--------XXXX
00000000000000000000000000000000000000000000000000000000XXXX--------XXXX
00000000000000000000000000000000000000000000000000000000XXXXXXX-----XXXX
00000000000000000000000000000000000000000000000000000000XX----------XXXX
00000000000000000000000000000000000000000000000000000000XX------XXXXXXXX
00000000000000000000000000000000000000000000000000000000XX----------XXXX
00000000000000000000000000000000000000000000000000000000XXXX--------XXXX
00000000000000000000000000000000000000000000000000000000XX------XXXXXXXX
00000000000000000000000000000000000000000000000000000000XD------------XX
00000000000000000000000000000000000000000000000000000000XD------------XX
00000000000000000000000000000000000000000000000000000000XXXXX-------XXXX
00000000000000000000000000000000000000000000000000000000XXXXXXXXXXXXXXXX
00000000000000000000000000000000000000000000000000000000XXXX--------XXXX
00000000000000000000000000000000000000000000000000000000XTTTT-------DXXX
00000000000000000000000000000000000000000000000000000000XXXX--------XXXX
00000000000000000000000000000000000000000000000000000000XXXX--------XXXX
0000000000000000----------------------------------------XXXXXXX-----XXXX
0000000000000000----------------------------------------XXXX--------XXXX
0000000000000000----------------------------------------XX------------XX
0000000000000000----------------------------------------XX-----XXXX---DX
0000000000000000----------------------------------------XX------------DX
0000000000000000----------------------------------------XXXX--------XXXX
0000000000000000----------------------------------------XXXXXX------XXXX
0000000000000000----------------------------------------XXXX--------XXXX
0000000000000000----------------------------------------XXXX--------XXXX
0000000000000000----------------------------------------XX----TTTTTTTTXX
0000000000000000---------------------------E------------XX------------XX
0000000000000000--------------------------<>------------XX------------XX
0000000000000000--------------------------[]------------XX-----XXXXXXXXX
0000000000000000--------------------------[]------------XD------------XX
--------------------------E---X-----------[]---EE-------XXXXX-------XXXX
----------------XXXXXXXXXXXXXXXXXXXXXXXXXXXXXXXXXXXXXXXXXXXXXXXXXXXXXXXX
-----T---TT-----00000000000000000000000000000000000000000000000000000000
----------------00000000000000000000000000000000000000000000000000000000
----------------00000000000000000000000000000000000000000000000000000000
--------TTTT----00000000000000000000000000000000000000000000000000000000
----------------00000000000000000000000000000000000000000000000000000000
--TTTTTTTT------00000000000000000000000000000000000000000000000000000000
----------------00000000000000000000000000000000000000000000000000000000
----------------00000000000000000000000000000000000000000000000000000000
---X------------00000000000000000000000000000000000000000000000000000000
--XXXXX---------00000000000000000000000000000000000000000000000000000000
---X------------00000000000000000000000000000000000000000000000000000000
XXXX----------XX00000000000000000000000000000000000000000000000000000000
XXXXXXXX------XX00000000000000000000000000000000000000000000000000000000
XX----XXXXX---XX00000000000000000000000000000000000000000000000000000000
XD------------XX00000000000000000000000000000000000000000000000000000000
XD------------XX00000000000000000000000000000000000000000000000000000000
XXXXX-------XXXX00000000000000000000000000000000000000000000000000000000
XXXXXXXXXXXXXXXX00000000000000000000000000000000000000000000000000000000
XXXX------XXXX--00000000000000000000000000000000000000000000000000000000
XXXX------XXXX--00000000000000000000000000000000000000000000000000000000
XXXX------XXXX--00000000000000000000000000000000000000000000000000000000
XXXX------XXXX--00000000000000000000000000000000000000000000000000000000
XXXX--XXXXXXXX--00000000000000000000000000000000000000000000000000000000
XXXX--------XXXX00000000000000000000000000000000000000000000000000000000
XXXX--------XXXX00000000000000000000000000000000000000000000000000000000
XXXX--------XXXX00000000000000000000000000000000000000000000000000000000
XXXX--------XXXX00000000000000000000000000000000000000000000000000000000
XXXX--------XXXX00000000000000000000000000000000000000000000000000000000
XXXXXX------XXXX00000000000000000000000000000000000000000000000000000000
XXXX--------XXXX00000000000000000000000000000000000000000000000000000000
XXXX--------XXXX00000000000000000000000000000000000000000000000000000000
XX----TTTTTTTTXX00000000000000000000000000000000000000000000000000000000
XX------------XX00000000000000000000000000000000000000000000000000000000
XX------------XX00000000000000000000000000000000000000000000000000000000
XX-----XXXXXXXXX00000000000000000000000000000000000000000000000000000000
XD------------XX00000000000000000000000000000000000000000000000000000000
XXXXX-------XXXX00000000000000000000000000000000000000000000000000000000
XXXXXXXXXXXXXXXX00000000000000000000000000000000000000000000000000000000
XXXX--XXXXXXXX--00000000000000000000000000000000000000000000000000000000
XXXX--------XXXX00000000000000000000000000000000000000000000000000000000
XXXX--------XXXX00000000000000000000000000000000000000000000000000000000
XXXX--------XXXX00000000000000000000000000000000000000000000000000000000
XXXX--------XXXX00000000000000000000000000000000000000000000000000000000
XXXX--------XXXX00000000000000000000000000000000000000000000000000000000
XXXX--------XXXX00000000000000000000000000000000000000000000000000000000
XXXX--------XXXX00000000000000000000000000000000000000000000000000000000
XXXXXX------XXXX00000000000000000000000000000000000000000000000000000000
XXXX--------XXXX00000000000000000000000000000000000000000000000000000000
XXXX--------XXXX00000000000000000000000000000000000000000000000000000000
XX----TTTTTTTTXX00000000000000000000000000000000000000000000000000000000
XX------------XX00000000000000000000000000000000000000000000000000000000
XX------------XX00000000000000000000000000000000000000000000000000000000
XXXXXXXX------XX00000000000000000000000000000000000000000000000000000000
XX----XXXXX---XX00000000000000000000000000000000000000000000000000000000
XD------------XX00000000000000000000000000000000000000000000000000000000
XD------------XX00000000000000000000000000000000000000000000000000000000
XXXXX-------XXXX00000000000000000000000000000000000000000000000000000000
XXXXXXXXXXXXXXXX00000000000000000000000000000000000000000000000000000000
--E--------E----00000000000000000000000000000000000000000000000000000000
MMMMMMMMMMMMMMMM00000000000000000000000000000000000000000000000000000000
--------------X-00000000000000000000000000000000000000000000000000000000
----------------00000000000000000000000000000000000000000000000000000000
----------------00000000000000000000000000000000000000000000000000000000
--X--X---X---X--00000000000000000000000000000000000000000000000000000000
--X--X---X---X--00000000000000000000000000000000000000000000000000000000
--X--X--X--X----00000000000000000000000000000000000000000000000000000000
--X--X--X--X----00000000000000000000000000000000000000000000000000000000
TTX--X--X--X----00000000000000000000000000000000000000000000000000000000
----------------00000000000000000000000000000000000000000000000000000000
----------------00000000000000000000000000000000000000000000000000000000
----XXXX--------00000000000000000000000000000000000000000000000000000000
----------------00000000000000000000000000000000000000000000000000000000
XXXX----------XX00000000000000000000000000000000000000000000000000000000
XX----X-------XX00000000000000000000000000000000000000000000000000000000
XD------------XX00000000000000000000000000000000000000000000000000000000
XD------------XX00000000000000000000000000000000000000000000000000000000
XXXXX-------XXXX00000000000000000000000000000000000000000000000000000000
XXXXXXXXXXXXXXXX00000000000000000000000000000000000000000000000000000000
MMMMMMMMMMMMMMMM00000000000000000000000000000000000000000000000000000000
----------------00000000000000000000000000000000000000000000000000000000
-----------XXXX-00000000000000000000000000000000000000000000000000000000
----XXXXX-------00000000000000000000000000000000000000000000000000000000
----------------00000000000000000000000000000000000000000000000000000000
XXXX----------XX00000000000000000000000000000000000000000000000000000000
XXXX----------XX00000000000000000000000000000000000000000000000000000000
XXXX----------DX00000000000000000000000000000000000000000000000000000000
XXXX----------DX00000000000000000000000000000000000000000000000000000000
XXXX----XXXXXXXX00000000000000000000000000000000000000000000000000000000
---X-X----------00000000000000000000000000000000000000000000000000000000
---X------------00000000000000000000000000000000000000000000000000000000
XXXXXXXX------XX00000000000000000000000000000000000000000000000000000000
XXXXXXXXXXXX--XX00000000000000000000000000000000000000000000000000000000
XX------------XX00000000000000000000000000000000000000000000000000000000
XX-----------XXX00000000000000000000000000000000000000000000000000000000
XD-----------XXX00000000000000000000000000000000000000000000000000000000
XD-----------XXX00000000000000000000000000000000000000000000000000000000
XXXXX-------XXXX00000000000000000000000000000000000000000000000000000000
XXXXXXXXXXXXXXXX00000000000000000000000000000000000000000000000000000000