000000000000000000000000000000000000000000000000000000000000000000000000----------------
000000000000000000000000000000000000000000000000000000000000000000000000-----T---TT-----
000000000000000000000000000000000000000000000000000000000000000000000000----------------
000000000000000000000000000000000000000000000000000000000000000000000000----------------
000000000000000000000000000000000000000000000000000000000000000000000000------TTTT------
000000000000000000000000000000000000000000000000000000000000000000000000----------------
000000000000000000000000000000000000000000000000000000000000000000000000---------TTTT---
000000000000000000000000000000000000000000000000000000000000000000000000----------------
000000000000000000000000000000000000000000000000000000000000000000000000XXXX--------XXXX
000000000000000000000000000000000000000000000000000000000000000000000000----------------
000000000000000000000000000000000000000000000000000000000000000000000000---XXXX---------
000000000000000000000000000000000000000000000000000000000000000000000000--XXXXX---------
000000000000000000000000000000000000000000000000000000000000000000000000---X------------
000000000000000000000000000000000000000000000000000000000000000000000000XXXX----------XX
000000000000000000000000000000000000000000000000000000000000000000000000XXXXXXXX------XX
000000000000000000000000000000000000000000000000000000000000000000000000XX----XXXXX---XX
000000000000000000000000000000000000000000000000000000000000000000000000XD------------XX
000000000000000000000000000000000000000000000000000000000000000000000000XD------------XX
000000000000000000000000000000000000000000000000000000000000000000000000XXXXX---XXXXXXXX
000000000000000000000000000000000000000000000000000000000000000000000000XXXXXXXXXXXXXXXX
000000000000000000000000000000000000000000000000000000000000000000000000XXXXXX------XXXX
000000000000000000000000000000000000000000000000000000000000000000000000XXXX--------XXXX
000000000000000000000000000000000000000000000000000000000000000000000000XXXX--------XXXX
000000000000000000000000000000000000000000000000000000000000000000000000XX----TTTTTTTTXX
000000000000000000000000000000000000000000000000000000000000000000000000XX------------XX
000000000000000000000000000000000000000000000000000000000000000000000000XX------------XX
000000000000000000000000000000000000000000000000000000000000000000000000XXXXXX----XXXXXX
000000000000000000000000000000000000000000000000000000000000000000000000XX------------XX
000000000000000000000000000000000000000000000000000000000000000000000000XX------------XX
000000000000000000000000000000000000000000000000000000000000000000000000XXXX-----------X
000000000000000000000000000000000000000000000000000000000000000000000000XXXX-----------X
000000000000000000000000000000000000000000000000000000000000000000000000XXXX-----------X
000000000000000000000000000000000000000000000000000000000000000000000000XXXX----XXXX---X
000000000000000000000000000000000000000000000000000000000000000000000000TTTT----XXXXX--X
000000000000000000000000000000000000000000000000000000000000000000000000----XXXX----XXXX
000000000000000000000000000000000000000000000000000000000000000000000000XXXXXXXXXXXXXXXX
000000000000000000000000000000000000000000000000000000000000000000000000XD-------------X
000000000000000000000000000000000000000000000000000000000000000000000000XD-------------X
000000000000000000000000000000000000000000000000000000000000000000000000XXXXX---XXXXXXXX
000000000000000000000000000000000000000000000000000000000000000000000000XXXXXXXXXXXXXXXX
000000000000000000000000000000000000000000000000000000000000000000000000XXXX--------XXXX
000000000000000000000000000000000000000000000000000000000000000000000000XXXX--------XXXX
000000000000000000000000000000000000000000000000000000000000000000000000XXXX--------XXXX
000000000000000000000000000000000000000000000000000000000000000000000000XXTTTT------XXXX
0000000000000000000000000000000000000000000000000000--------------------XXXX--------DXXX
0000000000000000000000000000000000000000000000000000--------------------XXXX--------DXXX
0000000000000000000000000000000000000000000000000000--------------------XXXX----XXXXXXXX
0000000000000000000000000000000000000000000000000000--------------------XXXX--------XXXX
000000000000000000000000000000000000XX------------XXS-------------------XXXX--------XXXX
000000000000000000000000000000000000XX-----XXXX---DXS-------------------XXXX--------XXXX
000000000000000000000000000000000000XX------------DXS-------------------XXXX--------XXXX
000000000000000000000000000000000000XXXX--------XXXXS---------SS--------XXXX--------XXXX
000000000000000000000000000000000000XXXX--------XXXXS-------------------XXXXXXX-----XXXX
000000000000000000000000000000000000XXXX--------XXXXS-------------------XXXX--------XXXX
000000000000000000000000000000000000XXXX--XXXXXXXXXXS-------------------XX----------XXXX
000000000000000000000000000000000000XXXX--------XXXXS-------ESSS--------XX-------TTTT-T-
000000000000000000000000000000000000XXXX--------XXXXS-------------------XD-------------X
000000000000000000000000000000000000XXXX--------XXXXS-------------------XD-------------X
000000000000000000000000000000000000XXXX--------XXXXS-------------------XXXXX---XXXXXXXX
000000000000000000000000000000000000XXXX--------XXXXXXXXXXXXXXXXXXXXXXXXXXXXXXXXXXXXXXXX
000000000000000000000000000000000000XXTTTT------XXXX000000000000000000000000000000000000
000000000000000000000000000000000000XXXX--------XXXX000000000000000000000000000000000000
000000000000000000000000000000000000XX----------XXXX000000000000000000000000000000000000
000000000000000000000000000000000000XX-------TTTT-T-000000000000000000000000000000000000
000000000000000000000000000000000000XD-------------X000000000000000000000000000000000000
000000000000000000000000000000000000XD-------------X000000000000000000000000000000000000
000000000000000000000000000000000000XXXXX---XXXXXXXX000000000000000000000000000000000000
000000000000000000000000000000000000XXXXXXXXXXXXXXXX000000000000000000000000000000000000
000000000000000000000000000000000000--TTTTTTTT------000000000000000000000000000000000000
000000000000000000000000000000000000----------------000000000000000000000000000000000000
000000000000000000000000000000000000----------------000000000000000000000000000000000000
000000000000000000000000000000000000----------T-----000000000000000000000000000000000000
0000000000000000------------------------------------000000000000000000000000000000000000
0000000000000000------------------------------------000000000000000000000000000000000000
0000000000000000-------------------------X---X---X--000000000000000000000000000000000000
---------XXXX-------------------------X--X---X---X--000000000000000000000000000000000000
----------------S-------E-------------X--X---X---X--000000000000000000000000000000000000
XXXX------XXXXXXS---------------------X--X--X--X----000000000000000000000000000000000000
----------XX----S---------------------X--X--X--X----000000000000000000000000000000000000
---------XXXX---S-------X--X-o------TTX--X--X--X----000000000000000000000000000000000000
------XXXXXX----S--------XX-XX----------------------000000000000000000000000000000000000
----------------S-----------------------------------000000000000000000000000000000000000
---XXXX---------S-----------------------XXXX--------000000000000000000000000000000000000
----------------S-------------------XXXXXXXXXXXXXXXX000000000000000000000000000000000000
----------------S-------------------XD-------------X000000000000000000000000000000000000
XXXXXXX---------S-------------------XD-------------X000000000000000000000000000000000000
XX--------------S---E---------------XXXXX---XXXXXXXX000000000000000000000000000000000000
XXXXXXXX--------XXXXXXXXXXXXXXXXXXXXXXXXXXXXXXXXXXXX000000000000000000000000000000000000
XXXX------------000000000000000000000000000000000000000000000000000000000000000000000000
XX-------------X000000000000000000000000000000000000000000000000000000000000000000000000
XX-------TTTT-TT000000000000000000000000000000000000000000000000000000000000000000000000
XD-------------X000000000000000000000000000000000000000000000000000000000000000000000000
XD-------------X000000000000000000000000000000000000000000000000000000000000000000000000
XXXXX---XXXXXXXX000000000000000000000000000000000000000000000000000000000000000000000000
XXXXXXXXXXXXXXXX000000000000000000000000000000000000000000000000000000000000000000000000
XXXX------XXXX--000000000000000000000000000000000000000000000000000000000000000000000000
XXXX------XXXX--000000000000000000000000000000000000000000000000000000000000000000000000
XXXX------XXXX--000000000000000000000000000000000000000000000000000000000000000000000000
XXXX------XXXX--000000000000000000000000000000000000000000000000000000000000000000000000
XXXX------XXXX--000000000000000000000000000000000000000000000000000000000000000000000000
XXXX------XXXX--000000000000000000000000000000000000000000000000000000000000000000000000
XXXX------XXXX--000000000000000000000000000000000000000000000000000000000000000000000000
XXXX------XXXX--000000000000000000000000000000000000000000000000000000000000000000000000
XXXX------XXXX--000000000000000000000000000000000000000000000000000000000000000000000000
XXXX------XXXX--000000000000000000000000000000000000000000000000000000000000000000000000
XXXXE-EXXXXXXX--000000000000000000000000000000000000000000000000000000000000000000000000
XXXX------XXXX--000000000000000000000000000000000000000000000000000000000000000000000000
XX-----------XXX000000000000000000000000000000000000000000000000000000000000000000000000
XX--TT-------XXX000000000000000000000000000000000000000000000000000000000000000000000000
XX-----------XXX000000000000000000000000000000000000000000000000000000000000000000000000
XX-----------XXX000000000000000000000000000000000000000000000000000000000000000000000000
XD-----------XXX000000000000000000000000000000000000000000000000000000000000000000000000
XD---------XXXXX000000000000000000000000000000000000000000000000000000000000000000000000
XXXXX---XXXXXXXX000000000000000000000000000000000000000000000000000000000000000000000000
XXXXXXXXXXXXXXXX000000000000000000000000000000000000000000000000000000000000000000000000
XXXX--------XXXX000000000000000000000000000000000000000000000000000000000000000000000000
XXXX--------XXXX000000000000000000000000000000000000000000000000000000000000000000000000
XXXX--XXXXXXXXXX000000000000000000000000000000000000000000000000000000000000000000000000
XXXX--------XXXX000000000000000000000000000000000000000000000000000000000000000000000000
XXXX--------XXXX000000000000000000000000000000000000000000000000000000000000000000000000
XXXX--------XXXX000000000000000000000000000000000000000000000000000000000000000000000000
XXXXXX------XXXX000000000000000000000000000000000000000000000000000000000000000000000000
XXXX--------XXXX000000000000000000000000000000000000000000000000000000000000000000000000
XXXX--------XXXX000000000000000000000000000000000000000000000000000000000000000000000000
XX----TTTTTTTTXX000000000000000000000000000000000000000000000000000000000000000000000000
XX------------XX000000000000000000000000000000000000000000000000000000000000000000000000
XX------------XX000000000000000000000000000000000000000000000000000000000000000000000000
XXXX----------XX000000000000000000000000000000000000000000000000000000000000000000000000
XXXX-----------X000000000000000000000000000000000000000000000000000000000000000000000000
XXXX-----------X000000000000000000000000000000000000000000000000000000000000000000000000
XX-------TTTT-TT000000000000000000000000000000000000000000000000000000000000000000000000
XD-------------X000000000000000000000000000000000000000000000000000000000000000000000000
XD-------------X000000000000000000000000000000000000000000000000000000000000000000000000
XXXXX---XXXXXXXX000000000000000000000000000000000000000000000000000000000000000000000000
XXXXXXXXXXXXXXXX000000000000000000000000000000000000000000000000000000000000000000000000