000000000000000000000000000000000000XX----------XXXX
000000000000000000000000000000000000XX----------XXXX
000000000000000000000000000000000000XXXXXXXXXXXXXXXX
000000000000000000000000000000000000XXXX-----------X
000000000000000000000000000000000000XXXX-----------X
000000000000000000000000000000000000XXXXXXXXXXXX---X
000000000000000000000000000000000000XXXXXXXXXXX----X
000000000000000000000000000000000000XXXX-----------X
000000000000000000000000000000000000XX-------------X
000000000000000000000000000000000000XX----------T--X
000000000000000000000000000000000000XX-------------X
000000000000000000000000000000000000X--------------X
000000000000000000000000000000000000XXXXXXXXX------X
000000000000000000000000000000000000XX-------------X
000000000000000000000000000000000000XX--------TTTTTT
000000000000000000000000000000000000XD-------------X
000000000000000000000000000000000000XD-------------X
000000000000000000000000000000000000TTTTXXXXXXXX--DX
000000000000000000000000000000000000--TTTTTTTT-----X
000000000000000000000000000000000000---------TTTTTTT
000000000000000000000000000000000000----------------
000000000000000000000000000000000000XX------TTTTTTXX
000000000000000000000000000000000000XX------------XX
000000000000000000000000000000000000XX------------XX
000000000000000000000000000000000000XXXX--------XXXX
000000000000000000000000000000000000XXXX--------XXXX
000000000000000000000000000000000000XXXXTT------XXXX
000000000000000000000000000000000000X-----------DXXX
000000000000000000000000000000000000X-----------DXXX
000000000000000000000000000000000000X--TT--XXXXXXXXX
000000000000000000000000000000000000X--------------X
000000000000000000000000000000000000X--------------X
000000000000000000000000000000000000XXXXXXXXX------X
000000000000000000000000000000000000XX-------------X
000000000000000000000000000000000000XX--------TTTTTT
000000000000000000000000000000000000XD-------------X
000000000000000000000000000000000000XD-------------X
000000000000000000000000000000000000TTTTXXXXXXXX--DX
000000000000000000000000000000000000--TTTTTTTT-----X
000000000000000000000000000000000000---------TTTTTTT
000000000000000000000000000000000000XXXX---------XXX
000000000000000000000000000000000000XXXXXXXXXXXX----
000000000000000000000000000000000000XXXXXXXXXXXXXXXX
000000000000000000000000000000000000X-------------XX
0000000000000000--------------------X-------------XX
0000000000000000--------------------X------------X-X
0000000000000000----------------------------------X-
----------------------------------------------------
----------------S-----------------------------------
TTTT--TTTT--TTTTS------------------------TTTTT------
----------------S-----------------------------------
----------------S-----------------------------------
----XXXXX-------S----------------------------TTTT---
----------------S-----------------------------------
XXXX----------XXS-----------------E-XXXX---------XXX
XXXX----------XXS-------E--------<>-XD-------------X
X-------------DXS----------------[]-XD-------------X
X-------------DXS----------------[]-TTTTXXXXXXXX---X
X------XXXXXXXXXS----------------[]---TTTTTTTT-----X
XXXXXXXXX------XXXXXXXXXXXXXXXXXXXXX---------TTTTTTT
XX-------------X000000000000000000000000000000000000
XX--------TTTTTT000000000000000000000000000000000000
XD-------------X000000000000000000000000000000000000
XD-------------X000000000000000000000000000000000000
TTTTXXXXXXXX--DX000000000000000000000000000000000000
--TTTTTTTT-----X000000000000000000000000000000000000
---------TTTTTTT000000000000000000000000000000000000
XXXX--------XXXX000000000000000000000000000000000000
XXXX--------XXXX000000000000000000000000000000000000
XXXX--------XXXX000000000000000000000000000000000000
XXXX--------XXXX000000000000000000000000000000000000
XXXXXX------XXXX000000000000000000000000000000000000
XXXX--------XXXX000000000000000000000000000000000000
XXXX--------XXXX000000000000000000000000000000000000
XX----TTTTTTTTXX000000000000000000000000000000000000
XX------------XX000000000000000000000000000000000000
XX------------XX000000000000000000000000000000000000
XX------------XX000000000000000000000000000000000000
XXXX----------XX000000000000000000000000000000000000
XXXX-----------X000000000000000000000000000000000000
XXXX-----------X000000000000000000000000000000000000
XX-------TTTT-TT000000000000000000000000000000000000
XD-------------X000000000000000000000000000000000000
XD-------------X000000000000000000000000000000000000
TTTTXXXXXXXX---X000000000000000000000000000000000000
--TTTTTTTT-----X000000000000000000000000000000000000
---------TTTTTTT000000000000000000000000000000000000
----------------000000000000000000000000000000000000
MMMMMMMMMMMMMMMM000000000000000000000000000000000000
----------------000000000000000000000000000000000000
----------------000000000000000000000000000000000000
MMMMMMMMMMMMMMMM000000000000000000000000000000000000
----------------000000000000000000000000000000000000
----------------000000000000000000000000000000000000
-------TT-------000000000000000000000000000000000000
----------------000000000000000000000000000000000000
----------------000000000000000000000000000000000000
--TTTTTTTT------000000000000000000000000000000000000
---------TTTTTTT000000000000000000000000000000000000
XXXX------------000000000000000000000000000000000000
XX-------------X000000000000000000000000000000000000
XX--------TTTTTT000000000000000000000000000000000000
XD-------------X000000000000000000000000000000000000
XD-------------X000000000000000000000000000000000000
TTTTXXXXXXXX--DX000000000000000000000000000000000000
--TTTTTTTT-----X000000000000000000000000000000000000
---------TTTTTTT000000000000000000000000000000000000
XXXX------XXXX--000000000000000000000000000000000000
XXXX------XXXX--000000000000000000000000000000000000
XXXX------XXXX--000000000000000000000000000000000000
XXXX------XXXX--000000000000000000000000000000000000
XXXX------XXXX--000000000000000000000000000000000000
XXXX------XXXX--000000000000000000000000000000000000
XXXX------XXXX--000000000000000000000000000000000000
XXXX------XXXX--000000000000000000000000000000000000
XXXX-----XXXX---000000000000000000000000000000000000
XX----------XXXX000000000000000000000000000000000000
XX----------XXXX000000000000000000000000000000000000
XXXX--------XXXX000000000000000000000000000000000000
XXXX------------000000000000000000000000000000000000
XX-------------X000000000000000000000000000000000000
XX-------TTTT-TT000000000000000000000000000000000000
XD-------------X000000000000000000000000000000000000
XD-------------X000000000000000000000000000000000000
TTTTXXXXXXXX---X000000000000000000000000000000000000
--TTTTTTTT-----X000000000000000000000000000000000000
---------TTTTTTT000000000000000000000000000000000000
---X------------000000000000000000000000000000000000
---XXXXX--------000000000000000000000000000000000000
---X------------000000000000000000000000000000000000
XXXX----------XX000000000000000000000000000000000000
XXXXXXXX------XX000000000000000000000000000000000000
XX----XXXXX---XX000000000000000000000000000000000000
XD------------XX000000000000000000000000000000000000
XD------------XX000000000000000000000000000000000000
XXXXXXXXXXXX----000000000000000000000000000000000000
XXXXXXXXXXX----X000000000000000000000000000000000000
X-------T---TTTT000000000000000000000000000000000000
----------------000000000000000000000000000000000000
----------------000000000000000000000000000000000000
----X-----------000000000000000000000000000000000000
XXXXXXXXXXXXXXXX000000000000000000000000000000000000
XD-------------X000000000000000000000000000000000000
XD-------------X000000000000000000000000000000000000
TTTTXXXXXXXX---X000000000000000000000000000000000000
--TTTTTTTT-----X000000000000000000000000000000000000
---------TTTTTTT000000000000000000000000000000000000
---------XXXX---000000000000000000000000000000000000
----------------000000000000000000000000000000000000
XXXX--------XXXX000000000000000000000000000000000000
----------------000000000000000000000000000000000000
-------TTTTTT---000000000000000000000000000000000000
------XXXX--X---000000000000000000000000000000000000
----------------000000000000000000000000000000000000
---------TTTT---000000000000000000000000000000000000
----------------000000000000000000000000000000000000
X--T--------TTTT000000000000000000000000000000000000
X--------------X000000000000000000000000000000000000
X--------------X000000000000000000000000000000000000
XXXXXXXXX------X000000000000000000000000000000000000
XX-------------X000000000000000000000000000000000000
XX--------TTTTTT000000000000000000000000000000000000
XD-------------X000000000000000000000000000000000000
XD-------------X000000000000000000000000000000000000
TTTTXXXXXXXX--DX000000000000000000000000000000000000
--TTTTTTTT-----X000000000000000000000000000000000000
---------TTTTTTT000000000000000000000000000000000000