000000000000000000000000000000000000000000000000000000000000000000000000XXXX---------XXX
000000000000000000000000000000000000000000000000000000000000000000000000XXXX---------XXX
000000000000000000000000000000000000000000000000000000000000000000000000XXXX---------XXX
000000000000000000000000000000000000000000000000000000000000000000000000XXXX---------XXX
000000000000000000000000000000000000000000000000000000000000000000000000XXXX---------XXX
000000000000000000000000000000000000000000000000000000000000000000000000XXXX---------XXX
000000000000000000000000000000000000000000000000000000000000000000000000XXXX---------XXX
000000000000000000000000000000000000000000000000000000000000000000000000XXXX---------XXX
000000000000000000000000000000000000000000000000000000000000000000000000XXXX---------XXX
000000000000000000000000000000000000000000000000000000000000000000000000XXXX---------XXX
000000000000000000000000000000000000000000000000000000000000000000000000X------------DXX
000000000000000000000000000000000000000000000000000000000000000000000000X------------DXX
000000000000000000000000000000000000000000000000000000000000000000000000X----------XXXXX
000000000000000000000000000000000000000000000000000000000000000000000000X-----------XXXX
000000000000000000000000000000000000000000000000000000000000000000000000X-------------XX
000000000000000000000000000000000000000000000000000000000000000000000000X-------------XX
000000000000000000000000000000000000000000000000000000000000000000000000XXXX----------XX
000000000000000000000000000000000000000000000000000000000000000000000000TTTTXXXXXXXX--XX
000000000000000000000000000000000000000000000000000000000000000000000000--TTTTTTTT----DX
000000000000000000000000000000000000000000000000000000000000000000000000---------TTTTTTT
000000000000000000000000000000000000000000000000000000000000000000000000----------------
000000000000000000000000000000000000000000000000000000000000000000000000----------------
000000000000000000000000000000000000000000000000000000000000000000000000TTTT------TTTTTT
000000000000000000000000000000000000000000000000000000000000000000000000X---------------
000000000000000000000000000000000000000000000000000000000000000000000000X---------------
000000000000000000000000000000000000000000000000000000000000000000000000X--TTTTTTTT-----
000000000000000000000000000000000000000000000000000000000000000000000000----------------
000000000000000000000000000000000000000000000000000000000000000000000000----------------
000000000000000000000000000000000000000000000000000000000000000000000000XXXX------------
000000000000000000000000000000000000000000000000000000000000000000000000----------------
000000000000000000000000000000000000000000000000000000000000000000000000--TTTTTTTT------
000000000000000000000000000000000000000000000000000000000000000000000000----------------
000000000000000000000000000000000000000000000000000000000000000000000000----------------
000000000000000000000000000000000000000000000000000000000000000000000000-----X----------
000000000000000000000000000000000000000000000000000000000000000000000000-----X----------
000000000000000000000000000000000000000000000000000000000000000000000000----------------
000000000000000000000000000000000000000000000000000000000000000000000000XXXX----------XX
000000000000000000000000000000000000000000000000000000000000000000000000TTTTXXXXXXXX--XX
000000000000000000000000000000000000000000000000000000000000000000000000--TTTTTTTT----DX
000000000000000000000000000000000000000000000000000000000000000000000000---------TTTTTTT
000000000000000000000000000000000000000000000000000000000000000000000000-XXXXX----XXXX--
000000000000000000000000000000000000000000000000000000000000000000000000-----------XXXX-
000000000000000000000000000000000000000000000000000000000000000000000000------------XX--
000000000000000000000000000000000000000000000000000000000000000000000000----------XXXX--
000000000000000000000000000000000000000000000000000000000000000000000000----------------
000000000000000000000000000000000000000000000000000000000000000000000000----------------
000000000000000000000000000000000000000000000000000000000000000000000000MMMMMMMMMMMMXMMM
000000000000000000000000000000000000000000000000000000000000000000000000----------------
000000000000000000000000000000000000000000000000000000000000000000000000X-------------XX
000000000000000000000000000000000000000000000000000000000000000000000000X------------XXX
000000000000000000000000000000000000000000000000000000000000000000000000X------XXXXXXXXX
000000000000000000000000000000000000000000000000000000000000000000000000X---XXXX-------X
000000000000000000000000000000000000000000000000000000000000000000000000X-----XXXXXXXXXX
000000000000000000000000000000000000000000000000000000000000000000000000X-----------XXXX
000000000000000000000000000000000000000000000000000000000000000000000000X-------------XX
000000000000000000000000000000000000000000000000000000000000000000000000X-------------XX
000000000000000000000000000000000000000000000000000000000000000000000000XXXXXXXXXXXX--DX
000000000000000000000000000000000000000000000000000000000000000000000000TTTTXXXXXXXX--DX
000000000000000000000000000000000000000000000000000000000000000000000000--TTTTTTTT----DX
000000000000000000000000000000000000000000000000000000000000000000000000---------TTTTTTT
000000000000000000000000000000000000000000000000000000000000000000000000----------------
000000000000000000000000000000000000000000000000000000000000000000000000---XXXX---------
000000000000000000000000000000000000000000000000000000000000000000000000----------------
000000000000000000000000000000000000000000000000000000000000000000000000----------------
000000000000000000000000000000000000000000000000000000000000000000000000----------------
000000000000000000000000000000000000000000000000000000000000000000000000TTTTTTTT--------
000000000000000000000000000000000000000000000000000000000000000000000000X---------------
000000000000000000000000000000000000000000000000000000000000000000000000X---------------
000000000000000000000000000000000000000000000000000000000000000000000000X-------TTTT----
000000000000000000000000000000000000000000000000000000000000000000000000X---------------
000000000000000000000000000000000000000000000000000000000000000000000000X---------------
000000000000000000000000000000000000000000000000000000000000000000000000X--TT-----------
000000000000000000000000000000000000000000000000000000000000000000000000X---------------
000000000000000000000000000000000000000000000000000000000000000000000000X-------TTTT----
000000000000000000000000000000000000000000000000000000000000000000000000X---------------
000000000000000000000000000000000000000000000000000000000000000000000000X---------------
000000000000000000000000000000000000000000000000000000000000000000000000XXXXXXXXXXXX----
000000000000000000000000000000000000000000000000000000000000000000000000TTTTXXXXXXXX--DX
000000000000000000000000000000000000000000000000000000000000000000000000--TTTTTTTT----DX
000000000000000000000000000000000000000000000000000000000000000000000000---------TTTTTTT
000000000000000000000000000000000000000000000000000000000000000000000000XXXX------XXXX--
000000000000000000000000000000000000000000000000000000000000000000000000XXXX------XXXX--
000000000000000000000000000000000000000000000000000000000000000000000000XXXX------XXXX--
000000000000000000000000000000000000000000000000000000000000000000000000XXXX------XXXX--
0000000000000000000000000000000000000000000000000000--------------------XXXX------XXXX--
0000000000000000000000000000000000000000000000000000--------------------XXXX------XXXX--
0000000000000000000000000000000000000000000000000000--------------------XXXX------XXXX--
0000000000000000000000000000000000000000000000000000--------------------XXXX------XXXX--
0000000000000000000000000000000000000000000000000000--------------------XXXX------XXXX--
0000000000000000000000000000000000000000000000000000--------------------XXXXTTTT--XXXX--
0000000000000000000000000000000000000000000000000000--------------------X-----------XXXX
0000000000000000000000000000000000000000000000000000--------------------X------------DXX
0000000000000000000000000000000000000000000000000000--------------------X----------XXXXX
0000000000000000000000000000000000000000000000000000--------------------X-----------XXXX
0000000000000000000000000000000000000000000000000000--------------------X-------------XX
0000000000000000000000000000000000000000000000000000--------------oSS---X-------------XX
0000000000000000000000000000000000000000000000000000--------------------X-----XXXXXXXXXX
0000000000000000000000000000000000000000000000000000--------------------TTTTXXXXXXXX--XX
0000000000000000000000000000000000000000000000000000------E---------------TTTTTTTT----DX
000000000000000000000000000000000000------TTTTTTTTTTXXXXXXXXXXXXXXXXXXXX---------TTTTTTT
000000000000000000000000000000000000---DXXX--TTT----000000000000000000000000000000000000
000000000000000000000000000000000000---XXXX---XXXX--000000000000000000000000000000000000
000000000000000000000000000000000000-TTTXXX---XXXX--000000000000000000000000000000000000
0000000000000000-----------------------XXXXX--XXXX--000000000000000000000000000000000000
0000000000000000------------------------XXXX--XXXX--000000000000000000000000000000000000
0000000000000000------------------------XXXX--XXXX--000000000000000000000000000000000000
0000000000000000------------------------XXXX-TTTTTTT000000000000000000000000000000000000
0000000000000000------------------------XXXX--XXXX--000000000000000000000000000000000000
0000000000000000------------------------XXXX--XXXX--000000000000000000000000000000000000
0000000000000000------------------------------XXXX--000000000000000000000000000000000000
0000000000000000--------------------X---TTTTTT--XXXX000000000000000000000000000000000000
0000000000000000--------------------X-----------XXXX000000000000000000000000000000000000
0000000000000000--------------------X------------XXX000000000000000000000000000000000000
0000000000000000--------------------X-------------XX000000000000000000000000000000000000
0000000000000000--------------------X-------------XX000000000000000000000000000000000000
0000000000000000--------------------XXXX----------XX000000000000000000000000000000000000
-------TT---------------------------TTTTXXXXXXXX--XX000000000000000000000000000000000000
--------------------------------E-----TTTTTTTT----DX000000000000000000000000000000000000
----------------XXXXXXXXXXXXXXXXXXXX---------TTTTTTT000000000000000000000000000000000000
------TTTT------000000000000000000000000000000000000000000000000000000000000000000000000
----------------000000000000000000000000000000000000000000000000000000000000000000000000
---TTTT---------000000000000000000000000000000000000000000000000000000000000000000000000
----------------000000000000000000000000000000000000000000000000000000000000000000000000
----------------000000000000000000000000000000000000000000000000000000000000000000000000
TTT-------TTTTTT000000000000000000000000000000000000000000000000000000000000000000000000
X---------------000000000000000000000000000000000000000000000000000000000000000000000000
X---------------000000000000000000000000000000000000000000000000000000000000000000000000
X-TTTTT---------000000000000000000000000000000000000000000000000000000000000000000000000
X---------------000000000000000000000000000000000000000000000000000000000000000000000000
XX--------------000000000000000000000000000000000000000000000000000000000000000000000000
XD--TTTT--------000000000000000000000000000000000000000000000000000000000000000000000000
XD--------------000000000000000000000000000000000000000000000000000000000000000000000000
XXXXXXXXXXXX----000000000000000000000000000000000000000000000000000000000000000000000000
TTTTXXXXXXXX--DX000000000000000000000000000000000000000000000000000000000000000000000000
--TTTTTTTT----DX000000000000000000000000000000000000000000000000000000000000000000000000
---------TTTTTTT000000000000000000000000000000000000000000000000000000000000000000000000
----------------000000000000000000000000000000000000000000000000000000000000000000000000
----------------000000000000000000000000000000000000000000000000000000000000000000000000
MMMMMMMMMMMMMMMM000000000000000000000000000000000000000000000000000000000000000000000000
----------------000000000000000000000000000000000000000000000000000000000000000000000000
----------------000000000000000000000000000000000000000000000000000000000000000000000000
----------------000000000000000000000000000000000000000000000000000000000000000000000000
---E---X---E----000000000000000000000000000000000000000000000000000000000000000000000000
MMMMMMMMMMMMMMMM000000000000000000000000000000000000000000000000000000000000000000000000
----------------000000000000000000000000000000000000000000000000000000000000000000000000
----------------000000000000000000000000000000000000000000000000000000000000000000000000
XMMMMMMMMMMMMMMM000000000000000000000000000000000000000000000000000000000000000000000000
----------------000000000000000000000000000000000000000000000000000000000000000000000000
---E--------E---000000000000000000000000000000000000000000000000000000000000000000000000
XMMMMMMMMMMMMMMX000000000000000000000000000000000000000000000000000000000000000000000000
X--------------X000000000000000000000000000000000000000000000000000000000000000000000000
X--------------X000000000000000000000000000000000000000000000000000000000000000000000000
XXXXXXXXXXXX---X000000000000000000000000000000000000000000000000000000000000000000000000
TTTTXXXXXXXX--DX000000000000000000000000000000000000000000000000000000000000000000000000
--TTTTTTTT----DX000000000000000000000000000000000000000000000000000000000000000000000000
---------TTTTTTT000000000000000000000000000000000000000000000000000000000000000000000000