000000000000000000000000000000000000X-------------DX
000000000000000000000000000000000000X------XXXXXXXXX
000000000000000000000000000000000000X--------------X
000000000000000000000000000000000000X--T--------TTTT
000000000000000000000000000000000000X--------------X
000000000000000000000000000000000000X--------------X
000000000000000000000000000000000000XXXXXXXXX------X
000000000000000000000000000000000000XXXX------------
000000000000000000000000000000000000XXXX------------
000000000000000000000000000000000000XXXX------------
000000000000000000000000000000000000XXXX------------
000000000000000000000000000000000000XXXX--TTTT------
000000000000000000000000000000000000XXXX------------
000000000000000000000000000000000000XX-------------X
000000000000000000000000000000000000XX--------TTTTTT
000000000000000000000000000000000000XD-------------X
000000000000000000000000000000000000XD-------------X
000000000000000000000000000000000000TTTTXXXXXXXX--DX
000000000000000000000000000000000000--TTTTTTTT-----X
000000000000000000000000000000000000---------TTTTTTT
000000000000000000000000000000000000----------------
000000000000000000000000000000000000XX-----------XXX
000000000000000000000000000000000000XXX-----------XX
000000000000000000000000000000000000XXXXXXXXXX----XX
000000000000000000000000000000000000XX------------XX
000000000000000000000000000000000000XX-----XXXX---XX
000000000000000000000000000000000000XX------------XX
000000000000000000000000000000000000XXXX--------XXXX
000000000000000000000000000000000000XXXX--------XXXX
000000000000000000000000000000000000XXXX--------XXXX
000000000000000000000000000000000000XXXX--------XXXX
000000000000000000000000000000000000XTTTTTTTT---XXXX
000000000000000000000000000000000000XXXX--------XXXX
000000000000000000000000000000000000XXXX--------XXXX
000000000000000000000000000000000000XX-------TTTTTTT
000000000000000000000000000000000000XD-------------X
000000000000000000000000000000000000XD-------------X
000000000000000000000000000000000000TTTTXXXXXXXX---X
000000000000000000000000000000000000--TTTTTTTT-----X
000000000000000000000000000000000000---------TTTTTTT
000000000000000000000000000000000000XX--------------
000000000000000000000000000000000000----------------
000000000000000000000000000000000000---TTTT--TTTT---
000000000000000000000000000000000000----------------
000000000000000000000000000000000000----------------
000000000000000000000000000000000000------TTTT------
000000000000000000000000000000000000----------------
000000000000000000000000000000000000---------TTT----
000000000000000000000000000000000000----------------
0000000000000000--------------------X-----------TTTT
0000000000000000--------------------X--------------X
0000000000000000--------------------X--------------X
0000000000000000--------------------XXXXXXXXX------X
XX----TTTTTTTTXXS-------------------XX-------------X
XX------------XXS-------------------XX--------TTTTTT
XX------------XXS-------------------XD-------------X
XXXXXX----XXXXXXS-------------------XD-------------X
XX------------XXS-------------------TTTTXXXXXXXX--DX
XX------------XXS---------------------TTTTTTTT-----X
XXXX--XXXXXXXXXXS-----------------SS---------TTTTTTT
XXXX--------XXXXS--------------S-ESS0000000000000000
XXXX--------XXXXS-------------------0000000000000000
XXXXXXX-----XXXXS-------------------0000000000000000
XXXX--------XXXXS--------E----------0000000000000000
XXXX--------XXXXXXXXXXXXXXXXXXXXXXXX0000000000000000
XXXX------------000000000000000000000000000000000000
XX-------------X000000000000000000000000000000000000
XX-------TTTT-TT000000000000000000000000000000000000
XD-------------X000000000000000000000000000000000000
XD-------------X000000000000000000000000000000000000
TTTTXXXXXXXX---X000000000000000000000000000000000000
--TTTTTTTT-----X000000000000000000000000000000000000
---------TTTTTTT000000000000000000000000000000000000
-----E----------000000000000000000000000000000000000
----TTT---------000000000000000000000000000000000000
----------------000000000000000000000000000000000000
------XXXX------000000000000000000000000000000000000
----------------000000000000000000000000000000000000
----TTTT--------000000000000000000000000000000000000
----------------000000000000000000000000000000000000
---------TTT----000000000000000000000000000000000000
----------------000000000000000000000000000000000000
X-----------TTTT000000000000000000000000000000000000
X--------------X000000000000000000000000000000000000
X--------------X000000000000000000000000000000000000
XXXXXXXXX------X000000000000000000000000000000000000
XX-------------X000000000000000000000000000000000000
XX-------TTTT-TT000000000000000000000000000000000000
XD-------------X000000000000000000000000000000000000
XD-------------X000000000000000000000000000000000000
TTTTXXXXXXXX---X000000000000000000000000000000000000
--TTTTTTTT-----X000000000000000000000000000000000000
---------TTTTTTT000000000000000000000000000000000000
------XX--------000000000000000000000000000000000000
---XXXXX--------000000000000000000000000000000000000
------XX--------000000000000000000000000000000000000
------XX--------000000000000000000000000000000000000
XXXXXXXX----XXXX000000000000000000000000000000000000
----------------000000000000000000000000000000000000
----------------000000000000000000000000000000000000
MMMMMMMMXMMMMMMM000000000000000000000000000000000000
----------------000000000000000000000000000000000000
-----------XXXX-000000000000000000000000000000000000
----XXXXX-------000000000000000000000000000000000000
----------------000000000000000000000000000000000000
XXXX----------XX000000000000000000000000000000000000
XXXXXXXX------XX000000000000000000000000000000000000
XX----XXXXX---XX000000000000000000000000000000000000
XD------------XX000000000000000000000000000000000000
XD------------XX000000000000000000000000000000000000
TTTTXXXXXXXX--XX000000000000000000000000000000000000
--TTTTTTTT-----X000000000000000000000000000000000000
---------TTTTTTT000000000000000000000000000000000000
XXXX------XXXX--000000000000000000000000000000000000
XXXX------XXXX--000000000000000000000000000000000000
XXXX------XXXX--000000000000000000000000000000000000
XXXX------XXXX--000000000000000000000000000000000000
XXXX------XXXX--000000000000000000000000000000000000
XXXX------XXXX--000000000000000000000000000000000000
XXXX------XXXX--000000000000000000000000000000000000
XXXX------XXXX--000000000000000000000000000000000000
XXXX------XXXX--000000000000000000000000000000000000
XXXX------XXXX--000000000000000000000000000000000000
XXXX-------XXXX-000000000000000000000000000000000000
XTTTTTTTT----XXX000000000000000000000000000000000000
XXXX--------XXXX000000000000000000000000000000000000
XX-----------XXX000000000000000000000000000000000000
XX--------TTTTTT000000000000000000000000000000000000
XD-------------X000000000000000000000000000000000000
XD-------------X000000000000000000000000000000000000
TTTTXXXXXXXX--DX000000000000000000000000000000000000
--TTTTTTTT-----X000000000000000000000000000000000000
---------TTTTTTT000000000000000000000000000000000000
XXXX--------XXXX000000000000000000000000000000000000
XXXX--------XXXX000000000000000000000000000000000000
XXXX--------XXXX000000000000000000000000000000000000
XXXX--------XXXX000000000000000000000000000000000000
XXXX--------XXXX000000000000000000000000000000000000
XXXX---------XXX000000000000000000000000000000000000
XX------TTTT--XX000000000000000000000000000000000000
XD------------XX000000000000000000000000000000000000
XD------------XX000000000000000000000000000000000000
X------XXXXXXXXX000000000000000000000000000000000000
XXXXXXXXXXXXXXXX000000000000000000000000000000000000
X--------------X000000000000000000000000000000000000
XXXXXXXXXX-----X000000000000000000000000000000000000
XX-------------X000000000000000000000000000000000000
XX--------TTTTTT000000000000000000000000000000000000
XD-------------X000000000000000000000000000000000000
XD-------------X000000000000000000000000000000000000
TTTTXXXXXXXX--DX000000000000000000000000000000000000
--TTTTTTTT-----X000000000000000000000000000000000000
---------TTTTTTT000000000000000000000000000000000000
XXXX--------XXXX000000000000000000000000000000000000
XXXXXXX-----XXXX000000000000000000000000000000000000
XXXX--------XXXX000000000000000000000000000000000000
XX------------XX000000000000000000000000000000000000
XX-----XXXX---XX000000000000000000000000000000000000
XX------------XX000000000000000000000000000000000000
XX------------XX000000000000000000000000000000000000
XXXX--------XXXX000000000000000000000000000000000000
XXXX--------XXXX000000000000000000000000000000000000
XXXX--------XXXX000000000000000000000000000000000000
XXXX--------XXXX000000000000000000000000000000000000
XXXX--------XXXX000000000000000000000000000000000000
XXXX------------000000000000000000000000000000000000
XX-------------X000000000000000000000000000000000000
XX--------TTTTTT000000000000000000000000000000000000
XD-------------X000000000000000000000000000000000000
XD-------------X000000000000000000000000000000000000
TTTTXXXXXXXX--DX000000000000000000000000000000000000
--TTTTTTTT-----X000000000000000000000000000000000000
---------TTTTTTT000000000000000000000000000000000000