00000000000000000000000000000000000000000000000000000000000000000000000000000000000000000000000000000000000000000000000000000000000000000000000000000000XXXX------XXXX--
00000000000000000000000000000000000000000000000000000000000000000000000000000000000000000000000000000000000000000000000000000000000000000000000000000000XXXX------XXXX--
00000000000000000000000000000000000000000000000000000000000000000000000000000000000000000000000000000000000000000000000000000000000000000000000000000000XXXX------XXXX--
00000000000000000000000000000000000000000000000000000000000000000000000000000000000000000000000000000000000000000000000000000000000000000000000000000000XXXX------XXXX--
00000000000000000000000000000000000000000000000000000000000000000000000000000000000000000000000000000000000000000000000000000000000000000000000000000000XXXX------XXXX--
00000000000000000000000000000000000000000000000000000000000000000000000000000000000000000000000000000000000000000000000000000000000000000000000000000000XXXX------XXXX--
00000000000000000000000000000000000000000000000000000000000000000000000000000000000000000000000000000000000000000000000000000000000000000000000000000000XXXX------XXXX--
00000000000000000000000000000000000000000000000000000000000000000000000000000000000000000000000000000000000000000000000000000000000000000000000000000000XXXX------XXXX--
00000000000000000000000000000000000000000000000000000000000000000000000000000000000000000000000000000000000000000000000000000000000000000000000000000000XXXX------XXXX--
00000000000000000000000000000000000000000000000000000000000000000000000000000000000000000000000000000000000000000000000000000000000000000000000000000000XXXXE-EXXXXXXX--
00000000000000000000000000000000000000000000000000000000000000000000000000000000000000000000000000000000000000000000000000000000000000000000000000000000XXXX------XXXX--
00000000000000000000000000000000000000000000000000000000000000000000000000000000000000000000000000000000000000000000000000000000000000000000000000000000XX-----------XXX
00000000000000000000000000000000000000000000000000000000000000000000000000000000000000000000000000000000000000000000000000000000000000000000000000000000XX--TT-------XXX
00000000000000000000000000000000000000000000000000000000000000000000000000000000000000000000000000000000000000000000000000000000000000000000000000000000XX-----------XXX
00000000000000000000000000000000000000000000000000000000000000000000000000000000000000000000000000000000000000000000000000000000000000000000000000000000XX-----------XXX
00000000000000000000000000000000000000000000000000000000000000000000000000000000000000000000------------------------------------------------------------XX-----------XXX
00000000000000000000000000000000000000000000000000000000000000000000000000000000000000000000------------------------------------------------------------XD-----------XXX
00000000000000000000000000000000000000000000000000000000000000000000000000000000000000000000------------------------------------------------------------XD-----------XXX
00000000000000000000000000000000000000000000000000000000000000000000000000000000000000000000------------------------------------------------------------XXXXX-------XXXX
00000000000000000000000000000000000000000000000000000000000000000000000000000000000000000000---------------------------------E-------------------------SXXXXXXXXXXXXXXXX
00000000000000000000000000000000000000000000000000000000000000000000000000000000000000000000------------------------------------------------------------0000000000000000
00000000000000000000000000000000000000000000000000000000000000000000000000000000000000000000------------------------------------------------------------0000000000000000
00000000000000000000000000000000000000000000000000000000000000000000000000000000000000000000------------------------------------------------------------0000000000000000
00000000000000000000000000000000000000000000000000000000000000000000000000000000000000000000------------------------------------------------------------0000000000000000
00000000000000000000000000000000000000000000000000000000000000000000000000000000000000000000------------------------------------------------------------0000000000000000
00000000000000000000000000000000000000000000000000000000000000000000000000000000000000000000---------------E--------------------------------------------0000000000000000
00000000000000000000000000000000000000000000000000000000000000000000000000000000000000000000--------S-----<>--------------------------------------------0000000000000000
00000000000000000000000000000000000000000000000000000000000000000000000000000000000000000000--------------[]-----------------------------------E--------0000000000000000
00000000000000000000000000000000000000000000000000000000000000000000000000000000000000000000--------------[]----------------------------------<>--------0000000000000000
00000000000000000000000000000000000000000000000000000000000000000000000000000000000000000000------------E-[]-----------------------------E----[]--------0000000000000000
0000000000000000000000000000000000000000000000000000000000000000000000000000XXXX-----TTTTXXXXXXXXXXXXXXXXXXXXXXXXXXXXXXXXXXXXXXXXXXXXXXXXXXXXXXXXXXXXXXX0000000000000000
0000000000000000000000000000000000000000000000000000000000000000000000000000XXXX--------XXXX0000000000000000000000000000000000000000000000000000000000000000000000000000
0000000000000000000000000000000000000000000000000000000000000000000000000000XXXX-T------XXXX0000000000000000000000000000000000000000000000000000000000000000000000000000
0000000000000000000000000000000000000000000000000000000000000000000000000000X-----------DXXX0000000000000000000000000000000000000000000000000000000000000000000000000000
0000000000000000000000000000000000000000000000000000000000000000000000000000X-----------DXXX0000000000000000000000000000000000000000000000000000000000000000000000000000
0000000000000000000000000000000000000000000000000000000000000000000000000000XXXXXX------XXXX0000000000000000000000000000000000000000000000000000000000000000000000000000
0000000000000000000000000000000000000000000000000000000000000000000000000000XXXXXXXE--XXXXXX0000000000000000000000000000000000000000000000000000000000000000000000000000
0000000000000000000000000000000000000000000000000000000000000000000000000000XXXX------XXXX--0000000000000000000000000000000000000000000000000000000000000000000000000000
0000000000000000------------------------------------------------------------X--TTTTTTTTTTTTT0000000000000000000000000000000000000000000000000000000000000000000000000000
0000000000000000------------------------------------------------------------XXXX------XXXX--0000000000000000000000000000000000000000000000000000000000000000000000000000
0000000000000000------------------------------------------------------------XXXX------XXXX--0000000000000000000000000000000000000000000000000000000000000000000000000000
0000000000000000------------------------------------------------------------XX----TTTTTTTTXX0000000000000000000000000000000000000000000000000000000000000000000000000000
0000000000000000------------------------------------------------------------XX------------XX0000000000000000000000000000000000000000000000000000000000000000000000000000
0000000000000000------------------------------------------------------------XX------------XX0000000000000000000000000000000000000000000000000000000000000000000000000000
0000000000000000------------------------------------------------------------XXXXXXXX------XX0000000000000000000000000000000000000000000000000000000000000000000000000000
0000000000000000------------------------------------------------------------XX----XXXXX---XX0000000000000000000000000000000000000000000000000000000000000000000000000000
0000000000000000------------------------------------------------------------XD------------XX0000000000000000000000000000000000000000000000000000000000000000000000000000
0000000000000000------------------------------------------------------------XD------------XX0000000000000000000000000000000000000000000000000000000000000000000000000000
0000000000000000--------------------------------------------------------E---XXXXX-------XXXX0000000000000000000000000000000000000000000000000000000000000000000000000000
0000000000000000------------------------------------S------------------<>--SXXXXXXXXXXXXXXXX0000000000000000000000000000000000000000000000000000000000000000000000000000
0000000000000000---------------------------X---------------------------[]---00000000000000000000000000000000000000000000000000000000000000000000000000000000000000000000
0000000000000000---------------------------X---------------------------[]---00000000000000000000000000000000000000000000000000000000000000000000000000000000000000000000
0000000000000000--------------E------------X---------------------------[]---00000000000000000000000000000000000000000000000000000000000000000000000000000000000000000000
XXXX------XXXX--XXXXXXXXXXXXXXXXXXXXXXXXXXXXXXXXXXXXXXXXXXXXXXXXXXXXXXXXXXXX00000000000000000000000000000000000000000000000000000000000000000000000000000000000000000000
XXXX------XXXX--00000000000000000000000000000000000000000000000000000000000000000000000000000000000000000000000000000000000000000000000000000000000000000000000000000000
XXXX------XXXX--00000000000000000000000000000000000000000000000000000000000000000000000000000000000000000000000000000000000000000000000000000000000000000000000000000000
XXXX------XXXX--00000000000000000000000000000000000000000000000000000000000000000000000000000000000000000000000000000000000000000000000000000000000000000000000000000000
XXXX------XXXX--00000000000000000000000000000000000000000000000000000000000000000000000000000000000000000000000000000000000000000000000000000000000000000000000000000000
XXXX------XXXX--00000000000000000000000000000000000000000000000000000000000000000000000000000000000000000000000000000000000000000000000000000000000000000000000000000000
XXXX------XXXX--00000000000000000000000000000000000000000000000000000000000000000000000000000000000000000000000000000000000000000000000000000000000000000000000000000000
XXXX------XXXX--00000000000000000000000000000000000000000000000000000000000000000000000000000000000000000000000000000000000000000000000000000000000000000000000000000000
XXXX-----XXXX---00000000000000000000000000000000000000000000000000000000000000000000000000000000000000000000000000000000000000000000000000000000000000000000000000000000
XXXXXXXXXXXX----00000000000000000000000000000000000000000000000000000000000000000000000000000000000000000000000000000000000000000000000000000000000000000000000000000000
XXXX------XXXXXX00000000000000000000000000000000000000000000000000000000000000000000000000000000000000000000000000000000000000000000000000000000000000000000000000000000
---X------------00000000000000000000000000000000000000000000000000000000000000000000000000000000000000000000000000000000000000000000000000000000000000000000000000000000
---X------------00000000000000000000000000000000000000000000000000000000000000000000000000000000000000000000000000000000000000000000000000000000000000000000000000000000
XXXXXXXX------XX00000000000000000000000000000000000000000000000000000000000000000000000000000000000000000000000000000000000000000000000000000000000000000000000000000000
XXXXXXXXXXXX--XX00000000000000000000000000000000000000000000000000000000000000000000000000000000000000000000000000000000000000000000000000000000000000000000000000000000
XX------------XX00000000000000000000000000000000000000000000000000000000000000000000000000000000000000000000000000000000000000000000000000000000000000000000000000000000
XX-----------XXX00000000000000000000000000000000000000000000000000000000000000000000000000000000000000000000000000000000000000000000000000000000000000000000000000000000
XD-----------XXX00000000000000000000000000000000000000000000000000000000000000000000000000000000000000000000000000000000000000000000000000000000000000000000000000000000
XXXXX-------XXXX00000000000000000000000000000000000000000000000000000000000000000000000000000000000000000000000000000000000000000000000000000000000000000000000000000000
XXXXXXXXXXXXXXXX00000000000000000000000000000000000000000000000000000000000000000000000000000000000000000000000000000000000000000000000000000000000000000000000000000000
-XXXX------XXXX-00000000000000000000000000000000000000000000000000000000000000000000000000000000000000000000000000000000000000000000000000000000000000000000000000000000
-XXXX----EXXXXX-00000000000000000000000000000000000000000000000000000000000000000000000000000000000000000000000000000000000000000000000000000000000000000000000000000000
XD----------XXXX00000000000000000000000000000000000000000000000000000000000000000000000000000000000000000000000000000000000000000000000000000000000000000000000000000000
XD----------XXXX00000000000000000000000000000000000000000000000000000000000000000000000000000000000000000000000000000000000000000000000000000000000000000000000000000000
XXXXXXXXE---XXXX00000000000000000000000000000000000000000000000000000000000000000000000000000000000000000000000000000000000000000000000000000000000000000000000000000000
XXXX------XXXXXX00000000000000000000000000000000000000000000000000000000000000000000000000000000000000000000000000000000000000000000000000000000000000000000000000000000
XXXX------XXXX--00000000000000000000000000000000000000000000000000000000000000000000000000000000000000000000000000000000000000000000000000000000000000000000000000000000
XXXXE-EXXXXXXX--00000000000000000000000000000000000000000000000000000000000000000000000000000000000000000000000000000000000000000000000000000000000000000000000000000000
XXXX------XXXX--00000000000000000000000000000000000000000000000000000000000000000000000000000000000000000000000000000000000000000000000000000000000000000000000000000000
XX-----------XXX00000000000000000000000000000000000000000000000000000000000000000000000000000000000000000000000000000000000000000000000000000000000000000000000000000000
XX--TT-------XXX00000000000000000000000000000000000000000000000000000000000000000000000000000000000000000000000000000000000000000000000000000000000000000000000000000000
XX-----------XXX00000000000000000000000000000000000000000000000000000000000000000000000000000000000000000000000000000000000000000000000000000000000000000000000000000000
XX-----------XXX00000000000000000000000000000000000000000000000000000000000000000000000000000000000000000000000000000000000000000000000000000000000000000000000000000000
XX-----------XXX00000000000000000000000000000000000000000000000000000000000000000000000000000000000000000000000000000000000000000000000000000000000000000000000000000000
XX-----------XXX00000000000000000000000000000000000000000000000000000000000000000000000000000000000000000000000000000000000000000000000000000000000000000000000000000000
XX-----------XXX00000000000000000000000000000000000000000000000000000000000000000000000000000000000000000000000000000000000000000000000000000000000000000000000000000000
XD-----------XXX00000000000000000000000000000000000000000000000000000000000000000000000000000000000000000000000000000000000000000000000000000000000000000000000000000000
XD-----------XXX00000000000000000000000000000000000000000000000000000000000000000000000000000000000000000000000000000000000000000000000000000000000000000000000000000000
XXXXX-------XXXX00000000000000000000000000000000000000000000000000000000000000000000000000000000000000000000000000000000000000000000000000000000000000000000000000000000
XXXXXXXXXXXXXXXX00000000000000000000000000000000000000000000000000000000000000000000000000000000000000000000000000000000000000000000000000000000000000000000000000000000